-------------------------------------------------------------------------------------------------------------------------------------------------------------
-------------------------------------------------------------------------------------------------------------------------------------------------------------
-------------------------------------------------------------------------------------------------------------------------------------------------------------
SSSSSSSSSSSSSSSSSSSSSSSSSSSSSSSSSSSSSSSSSSSSSSSSSSSSSSSSSSSSSSSSSSSSSSSSSSSSSSSS--SSSSSSSSSSSSSSSSSSSSSSSSSSSSSSSSSSSSSSSSSSSSSSSSSSSSSSSS-----------SSSSSSSS
SSSSSSSS--SSSS------S----------SS--SSSSSS--SSSSSS--SSSSSSS--SSSSSSSSS--SSSSSSSSS---SSSSSSSSSS--SSSS-----SSSS--------------------SS---------------------------
SSSSSSSS--SSSS------S----------SS--SSSSSS--SSSSSS--SSSSSSS--SSSSSSSSS--SSSSSSSSS---SSSSSSSSSS--SSSS-----SSSS--------------------SS---------------------------
-SS---SS---S----SS-----------SS--------SS---S--SS---S---SS---S-----SS---S------S----S------SS---S----SS---SS---------------------S----------SSS-------oooo---
-SS---SS---S----SS-----------SS--------SS---S--SS---S---SS---S-----SS---S------S----S------SS---S----SS---SS---------------------S---------------------------
-SS---SS---S----SS-----------SS--------SS---S--SS---S---SS---S-----SS---S------S----S------SS---S----SS---SS---------------------S--------------------SSSS-U-
oSSoooSS---SoU--SC-----------SS----ooooSS---SooSS---SoUoSS---SoUoooSS---SoUooooS----SoUooooSS---SoU--SC-ooSS---------------------S---------------SSSS-S--SoS-
SSSSSSSS---SSS--SS--S---##---SSSS--SSSSSS---SSSSS---SSSSSS---SSSSSSSS---SSSSSSSS----SSSSSSSSS---SSS--SS-SSSS--TT-----------------S------##-----------#S--SSS-
-----------------------###-----SS-----------------------------------------------------------------------------TT-----------SS----------###-----------#-------
----------------------####-----SS-----------------------------------------------------------------------------TT----TT-----SS---------####--SSS------#------F
---M-----------------#####----g--------------------------k------------------------------------g---------------TT----TT-----SS--------#####-----------#------#
XXXXXXXXXXXXXXXXXXXXXXXXXXXXXXXXXXXXXXXXXXXXXXXXXXXXXXXXXXXXXXXXXXXXXXXXXXXXXXXX--XXXXXXXXXXXXXXXXXXXXXXXXXXXXXXXXXXXXXXX--XX--XXXXXXXXXXX-------XXXXXXXXXXXX
XXXXXXXXXXXXXXXXXXXXXXXXXXXXXXXXXXXXXXXXXXXXXXXXXXXXXXXXXXXXXXXXXXXXXXXXXXXXXXXX--XXXXXXXXXXXXXXXXXXXXXXXXXXXXXXXXXXXXXXX--XX--XXXXXXXXXXX-------XXXXXXXXXXXX
