-------------------------------------------------------------------------------------------------------------------------------------------------------------
-------------------------------------------------------------------------------------------------------------------------------------------------------------
-------------------------------------------------------------------------------------------------------------------------------------------------------------
SSSSSSSSSSSSSSSSSSSSSSSSSSSSSSSSSSSSSSSSSSSSSSSSSSSSSSSSSSSSSSSSSSSSSSSSSSSSSSSS---SSSSSSSSSSSSSSSSSSSSSSSSSSSSSSSSSSSSSS-SSSSSSSSSSSSSSSSSSSSSSSSSSSSSSSSSSS
--SS--SSSSSS--SS----------------SS----SS--SSSSSS--SSSSSSSS--SSSSSSSSSSSSS--SSSSS---SSSSSS--SSSS---SSSSSS--SSSS-------------SS--SSSSSS-----SSS----------------
--SS--SSSSSS--SS----------------SS----SS--SSSSSS--SSSSSSSS--SSSSSSSSSSSSS--SSSSS---SSSSSS--SSSS---SSSSSS--SSSS-------------SS--SSSSSS-----SSS----------------
SS--------SS---S--------------SS----SS--------SS---S----SS---SSS--SS---SS---S-SS---S---SS---S----S----SS---S----SS--------S--------SS------------------------
SS--------SS---S--------------SS----SS--------SS---S----SS---SSS--SS---SS---S-SS---S---SS---S----S----SS---S----SS--------S--------SS------------------------
SS--------SS---S--------------SS----SS--------SS---S----SS---SSS--SS---SS---S-SS---S---SS---S----S----SS---S----SS-U------S--------SS------------------------
SS----ooooSS---S--------------SS----SS----ooooSS---SooooSS---SSSooSSoooSS---SoSS---SoooSS---SoU--SooooSS---SoU--SCoS------S----ooooSS--------------------C---
SSSS--SSSSSS---S---------##---SSSS--SSSS--SSSSSS---SSSSSSS---SSSSSSSSSSSS---SSSS---SSSSSS---SSS--SSSSSSS---SSS--SSSS------SSS--SSSSSS---##SSS------#-#-------
--SS--------------------###-----SS----SS-----------------------------------------------------------------------------------SS----------###-------#-#-#-#---#-
--SS-------------------####-----SS----SS-----------------------------------------------------------------------------------SS---------####-------#-#-#-#---#F
---M--------gg--------#####---g--------kk---------------kk--kg-g------ggggg-------------------g--gg-----------------T--------------gg#####-------r-#-#-#-E-##
XXXXXXXXXXXXXXXXXXXXXXXXXXXXXXXXXXXXXXXXXXXXXXXXXXXXXXXXXXXXXXXXXXXXXXXXXXXXXXXX---XXXXXXXXXXXXXXXXXXXXXXXXXXXXXXXXXXXXXX-XXXXXXXXXXXXXXXXXXX---XXXXXXXXXXXXX
XXXXXXXXXXXXXXXXXXXXXXXXXXXXXXXXXXXXXXXXXXXXXXXXXXXXXXXXXXXXXXXXXXXXXXXXXXXXXXXX---XXXXXXXXXXXXXXXXXXXXXXXXXXXXXXXXXXXXXX-XXXXXXXXXXXXXXXXXXX---XXXXXXXXXXXXX
