-------------------------------------------------------------------------------------------------------------------------------------------------------------
-------------------------------------------------------------------------------------------------------------------------------------------------------------
-------------------------------------------------------------------------------------------------------------------------------------------------------------
SSSSSSSSSSSSSSSSSSSSSSSSSSSSSSSSSSSSSSSSSSSSSSSSSSSSSSSSSSSSSSSSSSSSSSSSSSSSSSSSSSSSSSSSSSSSSSSSSSSSSSSSSSSSSSSSSSSSSSSSSSSSSSSSSSSSSSSSSS----SSSSSSSSSSSSSSS
SSSSSSSSS--SSSS-------------------SSSSSSS--SSSS---SSSSSSSSSSSS--SSSSSSSSSSSSSSSSSS--SSSSSSSSSS--SSSSSSSS--SSSS-----SS--SSSSSS--SSSS--------------------------
SSSSSSSSS--SSSS-------------------SSSSSSS--SSSS---SSSSSSSSSSSS--SSSSSSSSSSSSSSSSSS--SSSSSSSSSS--SSSSSSSS--SSSS-----SS--SSSSSS--SSSS--------------------------
-SS----SS---S---------------------S----SS---S----S----SSS---SS---S-----SS-SS----SS---S------SS---S----SS---S----SSS--------SS---S-----------SS---------------
-SS----SS---S---------------------S----SS---S----S----SSS---SS---S-----SS-SS----SS---S------SS---S----SS---S----SSS--------SS---S----------------------------
-SS----SS---S---------------------S----SS---S----S----SSS---SS---S-----SS-SS----SS---S------SS---S----SS---S----SSS--------SS---S----------------------------
oSSooooSS---SoU---------------C---SooooSS---SoU--SooooSSSoooSS---SoooooSSoSSooooSS---SoUooooSS---SooooSS---SoU--SCS----ooooSS---SoU----------------------C---
SSSSSSSSS---SSSQ--------#-#-------SSSSSSS---SSS--SSSSSSSSSSSSS---SSSSSSSSSSSSSSSSS---SSSSSSSSS---SSSSSSS---SSS--SSSSS--SSSSSS---SSS-----##---------#-#-------
----------------------#-#-#-#---#-S--------------------------------------------------------------------------------SS------------------###-------#-#-#-#---#-
--------------------#-#-#-#-#---#-S--------------------------------------------------------------------------------SS-----------------####--SS---#-#-#-#---#F
---M--------------#-#-#-#-#-#-E-#-S--------------------------------------------------------------------------------------------------#####-------#-#-#-#-E-##
XXXXXXXXXXXXXXXXXXXXXXXXXXXXXXXXXXXXXXXXXXXXXXXXXXXXXXXXXXXXXXXXXXXXXXXXXXXXXXXXXXXXXXXXXXXXXXXXXXXXXXXXXXXXXXXXXXXXXXXXXXXXXXXXXXXXXXXXXX-------XXXXXXXXXXXX
XXXXXXXXXXXXXXXXXXXXXXXXXXXXXXXXXXXXXXXXXXXXXXXXXXXXXXXXXXXXXXXXXXXXXXXXXXXXXXXXXXXXXXXXXXXXXXXXXXXXXXXXXXXXXXXXXXXXXXXXXXXXXXXXXXXXXXXXXX-------XXXXXXXXXXXX
