-------------------------------------------------------------------------------------------------------------------------------------------------------------
-------------------------------------------------------------------------------------------------------------------------------------------------------------
-------------------------------------------------------------------------------------------------------------------------------------------------------------
SSSSSSSSSSSSSSSSSSSSSSSSSSSSSSSSSSSSSSSSSSSSSSSSSSSSSSSSSSSSSSSSSSSSSSSSSSSSSSSS--SSSSSSSSSSSSSSSSSSSSSSSSSSSSSSSSSSSSSSSSSSSSSSSSSSSSSSSSSSSSSSSSSSSSSSSSSSS
SSSSS--SSSSSSS--SSSS------------SS--SSSSSSSSSSSS--SSSS----SSSS--SSSSSSSSSSSSSSS---SSSSSS--SSSS------SSS--SSSS------SSSSS--SS----SSS--SSSS--------------------
SSSSS--SSSSSSS--SSSS------------SS--SSSSSSSSSSSS--SSSS----SSSS--SSSSSSSSSSSSSSS---SSSSSS--SSSS------SSS--SSSS------SSSSS--SS----SSS--SSSS--------------------
---SS---S---SS---S-------------S--------S--SS-SS---S----SS--SS---S--SS---SSS-SS---S---SS---S----SS---SS---S----SS-----SS---------SS---S---------------oooo---
---SS---S---SS---S-------------S--------S--SS-SS---S----SS--SS---S--SS---SSS-SS---S---SS---S----SS---SS---S----SS-----SS---------SS---S----------------------
---SS---S---SS---S-------------S--------S--SS-SS---S----SS--SS---S--SS---SSS-SS---S---SS---S----SS---SS---S----SS-----SS---------SS---S---------------SSSS-U-
oooSS---SoUoSS---SoU----------CS----ooooSooSSoSS---SoU--SCooSS---SoUSSoooSSSoSS---SoUoSS---SoU--SC---SS---SoU--SC---ooSS--------oSS---SoU-------------S--SoS-
SSSSS---SSSSSS---SSS----#-#----SSS--SSSSSSSSSSSS---SSS--SSSSSS---SSSSSSSSSSgSSS---SSSSSS---SSS--SS--SSS---SSS--SS--SSSSS---S----SSS---SSS-------------S--SSS-
----------------------#-#-#-#---SS-------------------------------------------------------------------------------------------------------S-----------#-------
--------------------#-#-#-#-#---SS-------------------------------------------------------------------------------------------------------S----------##------F
---M---------g------#-#-#-#-#-E---------k---------------kk-----g--------ggg-------------------g------------------------------------------S---------###------#
XXXXXXXXXXXXXXXXXXXXXXXXXXXXXXXXXXXXXXXXXXXXXXXXXXXXXXXXXXXXXXXXXXXXXXXXXXXXXXXX--XXXXXXXXXXXXXXXXXXXXXXXXXXXXXXXXXXXXXXXXXX---XXXXXXXXXXX--XXXXXXXXXXXXXXXXX
XXXXXXXXXXXXXXXXXXXXXXXXXXXXXXXXXXXXXXXXXXXXXXXXXXXXXXXXXXXXXXXXXXXXXXXXXXXXXXXX--XXXXXXXXXXXXXXXXXXXXXXXXXXXXXXXXXXXXXXXXXX---XXXXXXXXXXX--XXXXXXXXXXXXXXXXX
