-------------------------------------------------------------------------------------------------------------------------------------------------------------
-------------------------------------------------------------------------------------------------------------------------------------------------------------
-------------------------------------------------------------------------------------------------------------------------------------------------------------
SSSSSSSSSSSSSSSSSSSSSSSSSSSSSSSSSSSSSSSSSSSSSSSSSSSSSSSSSSSSSSSSSSSSSSSSSSSSSSSS---SSSSSSSSSSSSSSSSSSSSSSSSSSSSSSSSSSSSSS-SSSSSSSSSSSSSSSS------SSSSSSSSSSSS-
--SS--SSSSSS--SSSS--------------SS--SSSSSS--SSSSSSSSS----SS--SSSSSS--SSSS-----SS---SSSSS--SSSSSSSS--SSSS----SS------SSSS------------------------SSSS---------
--SS--SSSSSS--SSSS--------------SS--SSSSSS--SSSSSSSSS----SS--SSSSSS--SSSS-----SS---SSSSS--SSSSSSSS--SSSS----SS------SSSS------------------------SSSS---------
SS--------SS---S--------------SS--------SS---SSS---SS--SS--------SS---S----SSS--------SS---S----SS---S----SS----SS--------------------------SSS--S----SS-----
SS--------SS---S--------------SS--------SS---SSS---SS--SS--------SS---S----SSS--------SS---S----SS---S----SS----SS-------------------------------S----SS-----
SS--------SS---S--------------SS--------SS---SSS---SS--SS--------SS---S----SSS--------SS---S----SS---S----SS----SS-------------------------------S----SS-----
SS----ooooSS---SoU------------SS----ooooSS---SSSoooSS--SS----ooooSS---SoU--SSS-----oooSS---SooooSS---SoU--SCoU--SC-------------------------------SoU--SC-----
SSSS--SSSSSS---SSS-----##-----SSSS--SSSSSS---SSSSSSSS--SSSS--SSSSSS---SSS--SSSSS---SSSSS---SSSSSSS---SSS--SSSS--SS--SSSS----------------##-------SSS--SS--##-
--SS------------------###-------SS-----------------------SS-------------------SS-------------------------------------------------------###---------------###-
--SS-----------------####-------SS-----------------------SS-------------------SS------------------------------------------------------####--SSS---------####F
---M--------gg------#####-----g--------kk---------------kk--kg-g------ggggg-------------------g--gg-----------------T--------------gg#####-------r------#####
XXXXXXXXXXXXXXXXXXXXXXXXXXXXXXXXXXXXXXXXXXXXXXXXXXXXXXXXXXXXXXXXXXXXXXXXXXXXXXXX---XXXXXXXXXXXXXXXXXXXXXXXXXXXXXXXXXXXXX---X--XXXXXXXXXXXX------XXXXXXXXXXXX-
XXXXXXXXXXXXXXXXXXXXXXXXXXXXXXXXXXXXXXXXXXXXXXXXXXXXXXXXXXXXXXXXXXXXXXXXXXXXXXXX---XXXXXXXXXXXXXXXXXXXXXXXXXXXXXXXXXXXXX---X--XXXXXXXXXXXX------XXXXXXXXXXXX-
