-------------------------------------------------------------------------------------------------------------------------------------------------------------
-------------------------------------------------------------------------------------------------------------------------------------------------------------
-------------------------------------------------------------------------------------------------------------------------------------------------------------
SSSSSSSSSSSSSSSSSSSSSSSSSSSSSSSSSSSSSSSSSSSSSSSSSSSSSSSSSSSSSSSSSSSSSSSSSSSSSSSS--SSSSSSSSSSSSSSSSSSSSSSSSSSSSSSSSSSSSSSSSSSSSSSSSSSSSSSSSSSSSSSSSSSSSSSSSSSS
--SS--SSSSSS-------------------SSSSSS--SS--SSSSSS--SSSS----SSSS--SSSS------SSSS---SSSSSSSSSSS--SSSS------SSSS------SS--SSSSSS--SSSS--------------------------
--SS--SSSSSS-------------------SSSSSS--SS--SSSSSS--SSSS----SSSS--SSSS------SSSS---SSSSSSSSSSS--SSSS------SSSS------SS--SSSSSS--SSSS--------------------------
SS--------SS-----------------------SSSS--------SS---S----SS--SS---S----SS-----------SS-SS--SS---S----SS---S----SSSS--------SS---S----------------------------
SS--------SS-----------------------SSSS--------SS---S----SS--SS---S----SS-----------SS-SS--SS---S----SS---S----SSSS--------SS---S----------------------------
SS--------SS-----------------------SSSS--------SS---S----SS--SS---S----SS-----------SS-SS--SS---S----SS---S----SSSS--------SS---S----------------------------
SS----ooooSS----------------C--ooooSSSS----ooooSS---SoU--SCooSS---SoU--SC---------ooSSoSSooSS---SoU--SC---SoU--SCSS----ooooSS---SoU----------------------C---
SSSS--SSSSSSQQ--------#-#------SSSSSSSSSS--SSSSSS---SSS--SSSSSS---SSS--SS--gSSS---SSSSSSSSSSS---SSS--SS---SSS--SSSSSS--SSSSSS---SSS-----##---------#-#-------
--SS----------------#-#-#-#---#--------SS--------------------------------------------------------------------------SS------------------###-------#-#-#-#---#-
--SS--------------#-#-#-#-#---#--------SS--------------------------------------------------------------------------SS-----------------####-----#-#-#-#-#---#F
---M---------g--#-#-#-#-#-#-E-#---------k---------------kk-----g--------ggg-------------------g--------------------------------------#####---#-#-#-#-#-#-E-##
XXXXXXXXXXXXXXXXXXXXXXXXXXXXXXXXXXXXXXXXXXXXXXXXXXXXXXXXXXXXXXXXXXXXXXXXXXXXXXX---XXXXXXXXXXXXXXXXXXXXXXXXXXXXXXXXXXXXXXXXXXXXXXXXXXXXXXXX-XXXXXXXXXXXXXXXXXX
XXXXXXXXXXXXXXXXXXXXXXXXXXXXXXXXXXXXXXXXXXXXXXXXXXXXXXXXXXXXXXXXXXXXXXXXXXXXXXX---XXXXXXXXXXXXXXXXXXXXXXXXXXXXXXXXXXXXXXXXXXXXXXXXXXXXXXXX-XXXXXXXXXXXXXXXXXX
