-------------------------------------------------------------------------------------------------------------------------------------------------------------
-------------------------------------------------------------------------------------------------------------------------------------------------------------
-------------------------------------------------------------------------------------------------------------------------------------------------------------
SSSSSSSSSSSSSSSSSSSSSSSSSSSSSSSSSSSSSSSSSSSSSSSSSSSSSSSSSSSSSSSSSSSSSSSSSSSSSSSSSSSSSSSSSSSSSSSSSSSSSSSSSSSSSSSSSSSSSSSSSSSSSSSSSSSSSSSSSSSSSSSSSSSSSSSSSSSSS
SSSSSSSSS--SSS------------------SS--SSSSSS--SSSSS--SSSSSS--SS-SSSSSS--SSSS-----SS--SSSSSS--SSSS-SS-SSSS--SSSS------------------S------SSSS-SSSS--SSSS------S-
SSSSSSSSS--SSS------------------SS--SSSSSS--SSSSS--SSSSSS--SS-SSSSSS--SSSS-----SS--SSSSSS--SSSS-SS-SSSS--SSSS------------------S------SSSS-SSSS--SSSS------S-
SSSS---SS---SS----------------SS--------SS---SSSS------SS---S-----SS---S----SSS--------SS---S---SS---SS---S-----------------------SS---------SS---S----SS----
SSSS---SS---SS----------------SS--------SS---SSSS------SS---S-----SS---S----SSS--------SS---S---SS---SS---S-----------------------SS---------SS---S----SS----
SSSS---SS---SS----------------SS--------SS---SSSS------SS---S-----SS---S----SSS--------SS---S---SS---SS---S-----------------------SS---------SS---S----SS----
SSSSoooSS---SS--------------C-SS----ooooSS--oSSSS--ooooSS---S-ooooSS---SoU--SCS----ooooSS---SoU-SS-ooSS---SoU---------------------SC-------ooSS---SoU--SC----
SSSSSSSSS---SS--------#-#-----SSSS--SSSSSS--SSSSS--SSSSSS---S-SSSSSS---SSS--SSSSS--SSSSSS---SSS-SS-SSSS---SSS-TT---------------S--SS--SSSS-SSSS---SSS--SS--S-
--------------------#-#-#-#-----SS---------------------------------------------SS-----------------------------TT-----------SS--S-----------------------------
------------------#-#-#-#-#-----SS---------------------------------------------SS-----------------------------TT----TT-----SS--S----------------------------F
---M------------#-#-#-#-#-#-E---------------------------------------------------------------------------------TT----TT-----SS-------------------------------#
XXXXXXXXXXXXXXXXXXXXXXXXXXXXXXXXXXXXXXXXXXXXXXXXXXXXXXXXXXXXXXXXXXXXXXXXXXXXXXXXXXXXXXXXXXXXXXXXXXXXXXXXXXXXXXXXXXXXXXXXX--XX--XXXXXXXXXXX-XXXXXXXXXXXXXXXXXX
XXXXXXXXXXXXXXXXXXXXXXXXXXXXXXXXXXXXXXXXXXXXXXXXXXXXXXXXXXXXXXXXXXXXXXXXXXXXXXXXXXXXXXXXXXXXXXXXXXXXXXXXXXXXXXXXXXXXXXXXX--XX--XXXXXXXXXXX-XXXXXXXXXXXXXXXXXX
