-------------------------------------------------------------------------------------------------------------------------------------------------------------
-------------------------------------------------------------------------------------------------------------------------------------------------------------
-------------------------------------------------------------------------------------------------------------------------------------------------------------
SSSSSSSSSSSSSSSSSSSSSSSSSSSSSSSSSSSSSSSSSSSSSSSSSSSSSSSSSSSSSSSSSSSSSSSSSSSSSSSS--SSSSSSSSSSSSSSSSSSSSSSSSSSSSSSSSSSSSSSSSSSSSSSSSSSSSSSSS----------SSSSSSSSS
--SS--SSSSSS--SSSS---------------SSSSSS--SSSSSSSS--SSSSSS--SSSS----SSSSSS--SSSSS--SSSSSSS--SSSSSSS--SSSS------SSSSSSSSSS----------SSS------------------------
--SS--SSSSSS--SSSS---------------SSSSSS--SSSSSSSS--SSSSSS--SSSS----SSSSSS--SSSSS--SSSSSSS--SSSSSSS--SSSS------SSSSSSSSSS----------SSS------------------------
SS--------SS---S---------------------SS---S--SS--------SS---S----SS----SS---S-SS---S---SS---S---SS---S----SS----------SS--------ooSSS-------SSS-------oooo---
SS--------SS---S---------------------SS---S--SS--------SS---S----SS----SS---S-SS---S---SS---S---SS---S----SS----------SS----------SSS------------------------
SS--------SS---S---------------------SS---S--SS--------SS---S----SS----SS---S-SS---S---SS---S---SS---S----SS----------SS--------SSSSS---------------S-SSSS-U-
SS----ooooSS---SoU---------------ooooSS---SoUSS----ooooSS---SoU--SCooooSS---SoSS---SoooSS---SoooSS---SoU--SC------ooooSS--------SSSSS------------SSSSoS--SoS-
SSSS--SSSSSS---SSS----##------##-SSSSSS---SSSSSSS--SSSSSS---SSS--SSSSSSSS---SSSS---SSSSSS---SSSSSS---SSS--SS--SSSSSSSSSS----------SSS---##----------SSS--SSS-
--SS-----------------###-----###---------------SS--------------------------------------------------------------------------S-----------###-------------------
--SS----------------####----####---------------SS--------------------------------------------------------------------------S----------####--SSS-------------F
---M---------------#####---###g#-------------------------k------------------------------------g----------------------------S---------#####------------------#
XXXXXXXXXXXXXXXXXXXXXXXXXXXXXXXXXXXXXXXXXXXXXXXXXXXXXXXXXXXXXXXXXXXXXXXXXXXXXXXX--XXXXXXXXXXXXXXXXXXXXXXXXXXXXXXXXXXXXXXX--X---XXXXXXXXXXX-------XXXXXXXXXXXX
XXXXXXXXXXXXXXXXXXXXXXXXXXXXXXXXXXXXXXXXXXXXXXXXXXXXXXXXXXXXXXXXXXXXXXXXXXXXXXXX--XXXXXXXXXXXXXXXXXXXXXXXXXXXXXXXXXXXXXXX--X---XXXXXXXXXXX-------XXXXXXXXXXXX
