-------------------------------------------------------------------------------------------------------------------------------------------------------------
-------------------------------------------------------------------------------------------------------------------------------------------------------------
-------------------------------------------------------------------------------------------------------------------------------------------------------------
SSSSSSSSSSSSSSSSSSSSSSSSSSSSSSSSSSSSSSSSSSSSSSSSSSSSSSSSSSSSSSSSSSSSSSSSSSSSSSSS---SSSSSSSLSSSSSSSSSSSSSSSSSSSSSSSSSSSSSS-SSSSSSSSSSSSSSSS-------------------
SSSSSSSSS--SSSS-----------------SS--SSSSSS--SSSSSS-SSSSSS--SS-SSSSSS--SSSS----SS------------SSSSSS--SSSS------SSSSSSSSSS------SSSSSS-------------------------
SSSSSSSSS--SSSS-----------------SS--SSSSSS--SSSSSS-SSSSSS--SS-SSSSSS--SSSS----SS------------SSSSSS--SSSS------SSSSSSSSSS------SSSSSS-------------------------
---SS--SS---S----S------------SS--------SS---S--SS-----SS---S-----SS---S----SS-------oooooo-----SS---S----SS----------SS----------SS--------SSS--------------
---SS--SS---S----S------------SS--------SS---S--SS-----SS---S-----SS---S----SS------------------SS---S----SS----------SS----------SS-------------------------
---SS--SS---S----S------U-----SS--------SS---S--SS-----SS---S-----SS---S----SS-------SSSSSS-----SS---S----SS----------SS----------SS-------------------------
oooSSooSS---SoU--S------S-----SS----ooooSS---SooSS-ooooSS---S-ooooSS---SoU--SC-------SSSSSS-ooooSS---SoU--SC------ooooSS------ooooSS-------------SSSSSSU-----
SSSSSSSSS---SSS--S----##S-----SSSS--SSSSSS---SSSSS-SSSSSS---S-SSSSSS---SSS--SSSS------------SSSSSS---SSS--SS--SSSSSSSSSS------SSSSSS----##-------------------
---------------------###--------SS-----------------------------------------------------------------------------------------S-----------###-------------------
--------------------####--------SS-----------------------------------------------------------------------------------------S----------####--SSS-------------F
---M--------gg-----#####------g--------kk---------------kk--kg-g------ggggg-------------------g--gg-----------------T------S-------gg#####-------r----------#
XXXXXXXXXXXXXXXXXXXXXXXXXXXXXXXXXXXXXXXXXXXXXXXXXXXXXXXXXXXXXXXXXXXXXXXXXXXXXXXX----XXXXXXXXXXXXXXXXXXXXXXXXXXXXXXXXXXXXX--X-XXXXXXXXXXXXX-------XXXXXXXX--X-
XXXXXXXXXXXXXXXXXXXXXXXXXXXXXXXXXXXXXXXXXXXXXXXXXXXXXXXXXXXXXXXXXXXXXXXXXXXXXXXX----XXXXXXXXXXXXXXXXXXXXXXXXXXXXXXXXXXXXX--X-XXXXXXXXXXXXX-------XXXXXXXX--XX
