-------------------------------------------------------------------------------------------------------------------------------------------------------------
-------------------------------------------------------------------------------------------------------------------------------------------------------------
-------------------------------------------------------------------------------------------------------------------------------------------------------------
SSSSSSSSSSSSSSSSSSSSSSSSSSSSSSSSSSSSSSSSSSSSSSSSSSSSSSSSSSSSSSSSSSSSSSSSSSSSSSSS--SSSSSSSSSSSSSSSSSSSSSSSSSSSSSSSSSSSSSSSSSSSSSSSSSSSSSSSS-----SSSSSSSSSSSSSS
--SS--SSSSSS--SSSS--------------SS--SSSSSS--SSSS-S--SSSSSS--SSSS---------------S---SSSSSS--SSSS--SSSSSS--SSSS------SSSSS--SS---------------------------------
--SS--SSSSSS--SSSS--------------SS--SSSSSS--SSSS-S--SSSSSS--SSSS---------------S---SSSSSS--SSSS--SSSSSS--SSSS------SSSSS--SS---------------------------------
SS--------SS---S----SS--------SS--------SS---S----------SS---S----SS-o-------SS--------SS---S--------SS---S----SS-----SS---S----------------SSS-------oooo---
SS--------SS---S----SS--------SS--------SS---S----------SS---S----SS---------SS--------SS---S--------SS---S----SS-----SS---S---------------------------------
SS--------SS---S----SS--U-----SS--------SS---S----------SS---S----SS-S-U-----SS--------SS---S--------SS---S----SS-----SS---S------------------------S-SSSS-U-
SS----ooooSS---SoU--SC-oS-----SS----ooooSS---SoU----ooooSS---SoU--SC-SoS-----SS----ooooSS---SoU--ooooSS---SoU--SC---ooSS---S------------------------SoS--SoS-
SSSS--SSSSSS---SSS--SS-SS-----SSSS--SSSSSS---SSS-S--SSSSSS---SSS--SS-SSS-----SSS---SSSSSS---SSS--SSSSSS---SSS--SS--SSSSS---S------------##----------SSS--SSS-
--SS----------------------------SS---------------S-----------------------------S-------------------------------------------------------###-------------------
--SS----------------------------SS---------------S-----------------------------S------------------------------------------------------####--SSS-------------F
---M--------------------------g--------------------------k------------------------------------g--------------------------------------#####------------------#
XXXXXXXXXXXXXXXXXXXXXXXXXXXXXXXXXXXXXXXXXXXXXXXXXXXXXXXXXXXXXXXXXXXXXXXXXXXXXXXX--XXXXXXXXXXXXXXXXXXXXXXXXXXXXXXXXXXXXXXXXXX--XXXXXXXXXXXX-----XXXXXXXXXXXXXX
XXXXXXXXXXXXXXXXXXXXXXXXXXXXXXXXXXXXXXXXXXXXXXXXXXXXXXXXXXXXXXXXXXXXXXXXXXXXXXXX--XXXXXXXXXXXXXXXXXXXXXXXXXXXXXXXXXXXXXXXXXX--XXXXXXXXXXXX-----XXXXXXXXXXXXXX
