-------------------------------------------------------------------------------------------------------------------------------------------------------------
-------------------------------------------------------------------------------------------------------------------------------------------------------------
-------------------------------------------------------------------------------------------------------------------------------------------------------------
SSSSSSSSSSSSSSSSSSSSSSSSSSSSSSSSSSSSSSSSSSSSSSSSSSSSSSSSSSSSSSSSSSSSSSSSSSSSSSSSSSSSSSSSSSSSSSSSSSSSSSSSSSSSSSSSSSSSSSSSSSSSSSSSSSSSSSSSSS----SSSSSSSSSSSSSS-
--SS--SSSSSS--SSSS------SS------SS--SSSSSS--SSSS---SSSSSS--S--SSSSSS--SSSS------SSS-----SS--SSSSSS--SSSS-----------SS----------------------------------------
--SS--SSSSSS--SSSS------SS------SS--SSSSSS--SSSS---SSSSSS--S--SSSSSS--SSSS------SSS-----SS--SSSSSS--SSSS-----------SS----------------------------------------
SS--------SS---S----SS--------SS--------SS---S---------SS---------SS---S----SS--------SS--------SS---S----SS-----SS-------------------------SS---------------
SS--------SS---S----SS--------SS--------SS---S---------SS---------SS---S----SS--------SS--------SS---S----SS-----SS------------------------------------------
SS--------SS---S----SS--------SS--------SS---S---------SS---------SS---S----SS--------SS--------SS---S----SS-----SS------------------------------------------
SS----ooooSS---SoU--SC--------SS----ooooSS---SoU---ooooSS-----ooooSS---SoU--SC--------SS----ooooSS---SoU--SC-----SS------------------------------------------
SSSS--SSSSSS---SSS--SS--SS----SSSS--SSSSSS---SSS---SSSSSS-----SSSSSS---SSS--SS--SSS---SSSS--SSSSSS---SSS--SS-----SSSS-------------------##----------------##-
--SS----------------------------SS------------------------------------------------------SS-------------------------SS-----SS-----------###---------------###-
--SS----------------------------SS------------------------------------------------------SS-------------------------SS-----SS----------####--SS----------####F
---M----------------------------------------------------------------------------------------------------------------------SS---------#####-------------######
XXXXXXXXXXXXXXXXXXXXXXXXXXXXXXXXXXXXXXXXXXXXXXXXXXXXXXXXXXXXXXXXXXXXXXXXXXXXXXXXXXXXXXXXXXXXXXXXXXXXXXXXXXXXXXXXXXXXXXXX--XX--XXXXXXXXXXXX------XXXXXXXXXXXX-
XXXXXXXXXXXXXXXXXXXXXXXXXXXXXXXXXXXXXXXXXXXXXXXXXXXXXXXXXXXXXXXXXXXXXXXXXXXXXXXXXXXXXXXXXXXXXXXXXXXXXXXXXXXXXXXXXXXXXXXX--XX--XXXXXXXXXXXX------XXXXXXXXXXXX-
