-------------------------------------------------------------------------------------------------------------------------------------------------------------
-------------------------------------------------------------------------------------------------------------------------------------------------------------
-------------------------------------------------------------------------------------------------------------------------------------------------------------
SSSSSSSSSSSSSSSSSSSSSSSSSSSSSSSSSSSSSSSSSSSSSSSSSSSSSSSSSSSSSSSSSSSSSSSSSSSSSSSS--SSSSSSSSSSSSSSSSSSSSSSSSSSSSSSSSSSSSSSSSSSSSSSSSSSSSSSSS------SSSSSSSSSSSSS
SSSS--SSSSSS--SSSS------SSSS----SS--SSSSSS-----SS--SSSSSS--SSSS------SSSS-----SS--SSSSSS--SSSS---S--SSSS---SSS------SS---------------------------------------
SSSS--SSSSSS--SSSS------SSSS----SS--SSSSSS-----SS--SSSSSS--SSSS------SSSS-----SS--SSSSSS--SSSS---S--SSSS---SSS------SS---------------------------------------
--SS---S--SS---S----SS--------SS--------SS---SS--------SS---S----SS----SS---SS--------SS---S----SS---S----SS----SS--------------------------SSS--------------
--SS---S--SS---S----SS--------SS--------SS---SS--------SS---S----SS----SS---SS--------SS---S----SS---S----SS----SS-------------------------------------------
--SS---S--SS---S----SS--------SS--------SS---SS--------SS---S----SS----SS---SS--------SS---S----SS---S----SS----SS-------------------------------------------
ooSS---SoUSS---SoU--SC--------SS----ooooSS---SS----ooooSS---SoU--SC---oSS---SS----ooooSS---SoU--SS---SoU--SSoU--SC---------------------------------------C---
SSSS---SSSSS---SSS--SS--SSSS--SSSS--SSSSSS---SSSS--SSSSSS---SSS--SS--SSSS--gSSSS--SSSSSS---SSS--SS---SSS--SSSS--SS--SS------------------##---------#-#-------
--------------------------------SS-------------SS-----------------------------SS------------------------------------------SS-----------###-------#-#-#-#---#-
--------------------------------SS-------------SS-----------------------------SS------------------------------------------SS----------####--SSS--#-#-#-#---#F
---M---------g--------------------------k---------------kk-----g--------ggg-------------------g---------------------------SS---------#####-------#-#-#-#-E-##
XXXXXXXXXXXXXXXXXXXXXXXXXXXX-XXXXXXXXXXXXXXXXXXXXXXXXXXXXXXXXXXXXXXXXXXXXXXXXXXX--XXXXXXXXXXXXXXXXXXXXXXXXXXXXXXXXXXXXXX--XX--XXXXXXXXXXXX------XXXXXXXXXXXXX
XXXXXXXXXXXXXXXXXXXXXXXXXXXX-XXXXXXXXXXXXXXXXXXXXXXXXXXXXXXXXXXXXXXXXXXXXXXXXXXX--XXXXXXXXXXXXXXXXXXXXXXXXXXXXXXXXXXXXXX--XX--XXXXXXXXXXXX------XXXXXXXXXXXXX
