-------------------------------------------------------------------------------------------------------------------------------------------------------------
-------------------------------------------------------------------------------------------------------------------------------------------------------------
-------------------------------------------------------------------------------------------------------------------------------------------------------------
SSSSSSSSSSSSSSSSSSSSSSSSSSSSSSSSSSSSSSSSSSSSSSSSSSSSSSSSSSSSSSSSSSSSSSSSSSSSSSSSSSSSSSSSSSSSSSSSSSSSSSSSSSSSSSSSSSSSSSSSSSSSSSSSSSSSSSSSSSSSSSSSSSSSSSSSSSSSS
--SS--SSSSSS--SSSS---------------S--SSSSSS--SSSS----SSSSSS--SSSS-SSS--SSSS--------------SS--SSSSSS--SSSS------S---SS--SSSSSS--SSSS------SS----------------SS-
--SS--SSSSSS--SSSS---------------S--SSSSSS--SSSS----SSSSSS--SSSS-SSS--SSSS--------------SS--SSSSSS--SSSS------S---SS--SSSSSS--SSSS------SS----------------SS-
SS--------SS---S------------------------SS---S----SS----SS---S----SS---S----SS--------SS--------SS---S----SS----SS--------SS---S----SS------------------SS---
SS--------SS---S------------------------SS---S----SS----SS---S----SS---S----SS--------SS--------SS---S----SS----SS--------SS---S----SS------------------SS---
SS--------SS---S------------------------SS---S----SS----SS---S----SS---S----SS--U-----SS--------SS---S----SS----SS--------SS---S----SS------------------SS---
SS----ooooSS---SoU------------C-----ooooSS---SoU--SCooooSS---SoU-oSS---SoU--SC--S-----SS----ooooSS---SoU--SC----SS----ooooSS---SoU--SC------------------SS---
SSSS--SSSSSS---SSS------#-#------S--SSSSSS---SSS--SSSSSSSS---SSS-SSS---SSS--SS--S-----SSSS--SSSSSS---SSS--SS--S#SSSS--SSSSSS---SSS--SS--SS------------##SSSS-
--SS------------------#-#-#-#---#S------------------------------------------------------SS---------------------#--SS---------------------------------###--SS-
--SS----------------#-#-#-#-#---#S------------------------------------------------------SS---------------------#--SS--------------------------------####--SSF
---M----------------#-#-#-#-#-E-#------------------------------------------------------------------------------#-----------------------------------#####----#
XXXXXXXXXXXXXXXXXXXXXXXXXXXXXXXXXXXXXXXXXXXXXXXXXXXXXXXXXXXXXXXXXXXXXXXXXXXXXXXXXXXXXXXXXXXXXXXXXXXXXXXXXXXXXXXXXXXXXXXXXXXXXXXXXXXXXXXXXX--XXXXXXXXXXXXXXXXX
XXXXXXXXXXXXXXXXXXXXXXXXXXXXXXXXXXXXXXXXXXXXXXXXXXXXXXXXXXXXXXXXXXXXXXXXXXXXXXXXXXXXXXXXXXXXXXXXXXXXXXXXXXXXXXXXXXXXXXXXXXXXXXXXXXXXXXXXXX--XXXXXXXXXXXXXXXXX
