-------------------------------------------------------------------------------------------------------------------------------------------------------------
-------------------------------------------------------------------------------------------------------------------------------------------------------------
-------------------------------------------------------------------------------------------------------------------------------------------------------------
SSSSSSSSSSSSSSSSSLSSSSSSSSSSSSSSSSSSSSSSSSSSSSSSSSSSSSSSSSSSSSSSSSSSSSSSSSSSSSSS--SSSSSSSSSSSSSSSSSSSSSSSSSSSSSSSSSSSSSSSSSSSSSSSSSSSLSSSS-SSSSSSSSSSSSSSSSSS
--SS--SSSSSS-------------------------SS--SSSSSS--SSSS------SSSSSSSS--SSSS-----SS--SSSSSS--SSSS---S--SSSS--SSSS------SSSS--SS---------------S-----------------
--SS--SSSSSS-------------------------SS--SSSSSS--SSSS------SSSSSSSS--SSSS-----SS--SSSSSS--SSSS---S--SSSS--SSSS------SSSS--SS---------------S-----------------
SS--------SSoooooo-----------------SS--------SS---S----SS--------SS---S----SSS--------SS---S----SS---S-S---S----SS--------------oooooo----------------oooo---
SS--------SS-----------------------SS--------SS---S----SS--------SS---S----SSS--------SS---S----SS---S-S---S----SS-------------------------------------------
SS--------SSSSSSSS-----------------SS--------SS---S----SS--------SS---S----SSS--------SS---S----SS---S-S---S----SS--------------SSSSSS--------------S-SSSS-U-
SS----ooooSSSSSSSS-----------------SS----ooooSS---SoU--SC----ooooSS---SoU--SSS----ooooSS---SoU--SS---SoS---SoU--SC--------------SSSSSS--------------SoS--SoS-
SSSS--SSSSSS-----------------------SSSS--SSSSSS---SSS--SS--SSSSSSSS---SSS--SSSSS--SSSSSS---SSS--SS---SSS---SSS--SS--SSSS--SS---------------S--------SSS--SSS-
--SS---------------------------TT----SS---------------------------------------SS-----------------------------------------------------------------------------
--SS---------------------------TT----SS---------------------------------------SS----------------------------------------------------------------------------F
---M--------------------------gTT------------------------k------------------------------------g-------------------------------------------------------------#
XXXXXXXXXXXXXXXXXXXXXXXXXXXXXXXXXXXXXXXXXXXXXXXXXXXXXXXXXXXXXXXXXXXXXXXXXXXXXXXX--XXXXXXXXXXXXXXXXXXXXXXXXXXXXXXXXXXXXXX--XX---XXXXXXXXXXX-X---XXXXXXXXXXXXXX
XXXXXXXXXXXXXXXXXXXXXXXXXXXXXXXXXXXXXXXXXXXXXXXXXXXXXXXXXXXXXXXXXXXXXXXXXXXXXXXX--XXXXXXXXXXXXXXXXXXXXXXXXXXXXXXXXXXXXXX--XX---XXXXXXXXXXX-X---XXXXXXXXXXXXXX
