-------------------------------------------------------------------------------------------------------------------------------------------------------------
-------------------------------------------------------------------------------------------------------------------------------------------------------------
-------------------------------------------------------------------------------------------------------------------------------------------------------------
SSSSSSSSSSSSSSSSSSSSSSSSSSSSSSSSSSSSSSSSSSSSSSSSSSSSSSSSSSSSSSSSSSSSSSSSSSSSSSSS---SSSSSSSSSSSSSSSSSSSSSSSSSSSSSSSSSSSSSS-SSSSSSSSSSSSSSSS----------SSSSSSSSS
SSSS--SSSS------SSSS------------SS--SSSSSS--SSSS------SSSS--SSSSSSSS--SSSS-----S---SSSSSS--SSSSSSS--SSSS-SSS-------SS--SS-SSS--SSSS--------------------------
SSSS--SSSS------SSSS------------SS--SSSSSS--SSSS------SSSS--SSSSSSSS--SSSS-----S---SSSSSS--SSSSSSS--SSSS-SSS-------SS--SS-SSS--SSSS--------------------------
--SS---S----SS----------------SS--------SS---S----SS----SS---S----SS---S----SS---------SS---S---SS---S----SS-----SS--------SS---S-----------SSS-------oooo---
--SS---S----SS----------------SS--------SS---S----SS----SS---S----SS---S----SS---------SS---S---SS---S----SS-----SS--------SS---S----------------------------
--SS---S----SS----------------SS--------SS---S----SS----SS---S----SS---S----SS---------SS---S---SS---S----SS-----SS--------SS---S-------------------S-SSSS-U-
ooSS---SoU--SC----------------SS----ooooSS---SoU--SC--ooSS---SooooSS---SoU--SC-----ooooSS---SoUoSS---SoU-oSS-----SS----oo-oSS---SoU--------------SSSSoS--SoS-
SSSS---SSS--SS--SSSS-----##---SSSS--SSSSSS---SSS--SS--SSSS---SSSSSSS---SSS--SS-S---SSSSSS---SSSSSS---SSS-SSS-----SSSS--SS-SSS---SSS-----##----------SSS--SSS-
------------------------###-----SS---------------------------------------------S-----------------------------------SS------------------###-------------------
-----------------------####-----SS---------------------------------------------S-----------------------------------SS-----------------####--SSS-------------F
---M--------gg--------#####---g--------kk---------------kk--kg-g------ggggg-------------------g--gg-----------------T--------------gg#####-------r----------#
XXXXXXXXXXXXXXXXXXXXXXXXXXXXXXXXXXXXXXXXXXXXXXXXXXXXXXXXXXXXXXXXXXXXXXXXXXXXXXXX---XXXXXXXXXXXXXXXXXXXXXXXXXXXXXXXXXXXXXX-XXXXXXXXXXXXXXXX-------XXXXXXXXXXXX
XXXXXXXXXXXXXXXXXXXXXXXXXXXXXXXXXXXXXXXXXXXXXXXXXXXXXXXXXXXXXXXXXXXXXXXXXXXXXXXX---XXXXXXXXXXXXXXXXXXXXXXXXXXXXXXXXXXXXXX-XXXXXXXXXXXXXXXX-------XXXXXXXXXXXX
