-------------------------------------------------------------------------------------------------------------------------------------------------------------
-------------------------------------------------------------------------------------------------------------------------------------------------------------
-------------------------------------------------------------------------------------------------------------------------------------------------------------
SSSSSSSSSSSSSSSSSSSSSSSSSSSSSSSSSSSSSSSSSSSSSSSSSSSSSSSSSSSSSSSSSSSSSSSSSSSSSSSS--SSSSSSSLSSSSSSSSSSSSSSSSSSSSSSSSSSSSSSSSSSSSSSSSSSSSSSSS-----SSSSSSSSSSSSSS
--SS--SSSSSS--SSSS------SS-----SS--SSSSSS------SS--SSSSSS--SSSS------SSS----SSSS------------SSSSSS--SSSS------S--S-------------------------------------------
--SS--SSSSSS--SSSS------SS-----SS--SSSSSS------SS--SSSSSS--SSSS------SSS----SSSS------------SSSSSS--SSSS------S--S-------------------------------------------
SS--------SS---S----SS-------SS--------SS----SS--------SS---S----SS-----SS----------oooooo------SS---S----SS-----S--------------------------SSS-------oooo---
SS--------SS---S----SS-------SS--------SS----SS--------SS---S----SS-----SS----------------------SS---S----SS-----S-------------------------------------------
SS--------SS---S----SS-------SS--------SS----SS--------SS---S----SS-----SS----------SSSSSS------SS---S----SS-----S----------------------------------S-SSSS-U-
SS----ooooSS---SoU--SC-------SS----ooooSS----SS----ooooSS---SoU--SC-----SC----------SSSSSS--ooooSS---SoU--SC-----S----------------------------------SoS--SoS-
SSSS--SSSSSS---SSS--SS--SS---SSSS--SSSSSS----SSSS--SSSSSS---SSS--SS--SSSSS-gSSSS------------SSSSSS---SSS--SS--S##S----------------------##----------SSS--SSS-
--SS---------------------------SS--------------SS--------------------------------------------------------------##S--------SS-----------###-------------------
--SS---------------------------SS--------------SS--------------------------------------------------------------##S-TT-----SS----------####--SSS-------------F
---M---------g--------------------------k---------------kk-----g--------ggg-------------------g----------------##S-TT-----SS---------#####------------------#
XXXXXXXXXXXXXXXXXXXXXXXXXXXXXXXXXXXXXXXXXXXXXXXXXXXXXXXXXXXXXXXXXXXXXXXXXXXXXXXX---XXXXXXXXXXXXXXXXXXXXXXXXXXXXXXXXXXXXX--XX--XXXXXXXXXXXX-----XXXXXXXXXXXXXX
XXXXXXXXXXXXXXXXXXXXXXXXXXXXXXXXXXXXXXXXXXXXXXXXXXXXXXXXXXXXXXXXXXXXXXXXXXXXXXXX---XXXXXXXXXXXXXXXXXXXXXXXXXXXXXXXXXXXXX--XX--XXXXXXXXXXXX-----XXXXXXXXXXXXXX
