XXXXXXXXXXXXXXSSSSSSXXXXSXXXXXXXXXXXXXXXXSXXXXXXXXXXXXXXXXXXXXXXXXXXXXXXXXXXXXXX--XXXXXXXXXXXXXXXXXXXXXXXXXXXXXXXXXXXXXXXXXXXXXXXXXXXXXXXXXXXXXXXXXXXXXXXXXX-
XXXXXXXXXXXXXXSSSSSSXXXXSXXXXXXXXXXXXXXXXSXXXXXXXXXXXXXXXXXXXXXXXXXXXXXXXXXXXXXX--XXXXXXXXXXXXXXXXXXXXXXXXXXXXXXXXXXXXXXXXXXXXXXXXXXXXXXXXXXXXXXXXXXXXXXXXXX-
-------------------------------------------------------------------------------------------------------------------------------------------------------------
SSSSSSSSSSSSSSSSSSSSSSSSSSSSSSSSSSSSSSSSSSSSSSSSSSSSSSSSSSSSSSSSSSSSSSSSSSSSSSSS--SSSSSSSSSSSSSSSSSSSSSSSSSSSSSSSSSSSSSSSSSSSSSSSSSSSSSSSS-SSSSSSSSSSSSSSSSSS
SSSS--SSSSSSSS--SSSS---------------SSS--SSSSSSS--SSSS---SSSS--SSSSSSSSSS--SSSSSS---SSSSSSSSSSSSSSS--SSSS----------SSSSSS-SSS---------------------------------
SSSS--SSSSSSSS--SSSS---------------SSS--SSSSSSS--SSSS---SSSS--SSSSSSSSSS--SSSSSS---SSSSSSSSSSSSSSS--SSSS----------SSSSSS-SSS---------------------------------
--SS---S----SS---S------------------SS---S---SS---S----S--SS---S------SS---SS--S----S-----SS-SS-SS---S----SS----------SS--------ooooo------------------ooo---
--SS---S----SS---S------------------SS---S---SS---S----S--SS---S------SS---SS--S----S-----SS-SS-SS---S----SS----------SS-------------------------------------
--SS---S----SS---S------------------SS---S---SS---S----S--SS---S------SS---SS--S----S-----SS-SS-SS---S----SS----------SS--------SSSSS------------------SSS-U-
ooSS---SooooSS---SoU----------C----oSS---SoooSS---SoU--SooSS---SoUooooSS---SSooS----SoUoooSSoSSoSS---SoU--SC------ooooSS--------SSSSS--------------------SoS-
SSSS---SSSSSSS---SSS----#-#--------SSS---SSSSSS---SSS--SSSSS---SSSSSSSSS---gSSSS----SSSSSSSSSSSSSS---SSS--SS----##SSSSSS-SSS------------##-----------##--SSS-
----------------------#-#-#-#---#------------------------------------------------------------------------------###---------------------###----------###------
--------------------#-#-#-#-#---#-#---------------------------------------------------------------------------####--------------------####---------####-----F
---M---------g------#-#-#-#-#-E-#-#-----k---------------kk-----g--------ggg-------------------g--------------#####-------------------#####--------#####-----#
XXXXXXXXXXXXXXXXXXXXXXXXXXXXXXXXXXXXXXXXXXXXXXXXXXXXXXXXXXXXXXXXXXXXXXXXXXXXXXXX--XXXXXXXXXXXXXXXXXXXXXXXXXXXXXXXXXXXXXXXXXX---XXXXXXXXXXX-XXXXXXXXXXXXXXXXXX
XXXXXXXXXXXXXXXXXXXXXXXXXXXXXXXXXXXXXXXXXXXXXXXXXXXXXXXXXXXXXXXXXXXXXXXXXXXXXXXX--XXXXXXXXXXXXXXXXXXXXXXXXXXXXXXXXXXXXXXXXXX---XXXXXXXXXXX-XXXXXXXXXXXXXXXXXX
