SSSSSSSSSSSSSSSSSSSSSSSSSSSSSSSSSSSSSSSSSSSSSSSSSSSSSSSSSSSSSSS---------------SSSSSSSSSSS----#####SSSSSSSSSSSSSSSSSSSSSTT#-#-#-#---##-#-#-#-#---#-#SSSSSSSSSS
SSSS--SSSSSSS--SSSSSSSS--SSSS-SSSSSSSSSSSSS--SSSSSSSSSS--SSSSSSSSSSSSSSSSSSSSSSSSSS--SSSSXXXXXXXXXSSSSSS--SSSS---SSSSSSTT#-#-#-#-E-##-#-#-#-#-E-#-#S--SSSSSS-
SSSS--SSSSSSS--SSSSSSSS--SSSS-SSSSSSSSSSSSS--SSSSSSSSSS--SSSSSSSSSSS--SSSS----SSSSS--SSSSXXXXXXXXXSSSSSS--SSSS---SSSSSSTTXXXXXXXXXXXXXXXXXXXXXXXXXXS--SSSSSS-
--SS---S---SS---S----SS---S------SS--SS--SS---S------SS---S--SSSSSSS--SSSS----SSSSSSSSSSSSSSSSSSSS----SS---S---------SSXXXXXXXXXXXXXXXXXXXXXXXXXXXX-------SS-
--SS---S---SS---S----SS---S------SS--SS--SS---S------SS---S--SS---SS---S----SSSSSSS--SSSSSSSS--SSS----SS---S---------SSSSSSSSSSSSS-------------SSSSSSS-------
--SS---S---SS---S----SS---S------SS--SS--SS---S------SS---S--SS---SS---S----SSSSSSS--SSSSSSSS--SSS----SS---S---------SS-SSSS---------------------------------
ooSS---SoooSS---SooooSS---SoU-oooSSooSSooSS---SoUooooSS---SoUSS---SS---S----SS---SS---S----SS---S-ooooSS---SoU---ooooSS-SSSS----------------SSS--------------
--SS---S----------------------SS--------SS---SSS---S----SS---SSoooSS---SoU--SC---SS---S----SS---S-SSSSSS---SSS---SSSSSS---------oo---------------------SSSSSS
--SS---SSSSSSS----------------SS--------SS---SSS---S----SS---SSSSSSS---SSS--SS---SS---S----SS---S------------------------------------------------------SSSSS-
ooSS---SSSSSSS----------------SS----ooooSS--oSSS---SoU--SC---SCoooSS---SoU--SCoooSS---SoUooSS---So------------------------------SS---------------------SSSSS-
SSSS---S----------------#-#---SSSS--SSSSSS--SSSS---SSS--SS---SSSSSSS---SSS--SSSSSSS---SSSSSSS---SS------------------------------SS------##----------------SS-
----------------------#-#-#-#---SS----------------------------------------------------------------XXXXXXXXXXXXXXXXXXXXX-SSSS-----------###----------##----SS-
--------------------#-#-#-#-#---SS----------------------------------------------------------------XXXXXXXXXXXXXXXXXXXXX---------------####--SSS----###----SSF
---M--------------#-#-#-#-#-#---------------------------------------------------------------------TT----TT----T#-#-#-#---------------#####--------####-oooSS#
XXXXXXXXXXXXXXXXXXXXXXXXXXXXXXXXXXXXXXXXXXXXXXXXXXXXXXXXXXXXXXXXXXXXXXXXXXXXXXXXXXXXXXXXXXXXXXXXXXXXXXXXXXXXXXXXXXXXXXX-----------XXXXXXXX-------#####-SSSSS-
XXXXXXXXXXXXXXXXXXXXXXXXXXXXXXXXXXXXXXXXXXXXXXXXXXXXXXXXXXXXXXXXXXXXXXXXXXXXXXXXXXXXXXXXXXXXXXXXXXXXXXXXXXXXXXXXXXXXXXXXXXXX---XXXXXXXXXXX-----XXXXXXX-------
