-------------------------------------------------------------------------------------------------------------------------------------------------------------
-------------------------------------------------------------------------------------------------------------------------------------------------------------
-------------------------------------------------------------------------------------------------------------------------------------------------------------
SSSSSSSSSSSSSSSSSSSSSSSSSSSSS--SSSSSSSSSSSSSSSSSSSSSSSSSSSSSSSSSSSSSSSSSSSSSSSSSSSSSSSSSLSSSSSSSSSSSSSSSSSSSSSSSSSSSSSSSSSSSSSSSSSSSSSSSSSSSSSSSSSSSSSSS--SSS
SSSS--SSSS-----------------------SSSSS--SSSSSSS--SSSS-----SSSS--SSSS-------SSSS----------SSSSSSSSS--SSSS-----------------SSSS------SS--S---------------------
SSSS--SSSS-----------------------SSSSS--SSSSSSS--SSSS-----SSSS--SSSS-------SSSS----------SSSSSSSSS--SSSS-----------------SSSS------SS--S---------------------
--SS---S----------------------------SS---S---SS---S----SS---SS---S----SSS----------oooooo-SS----SS---S---------------SS----------ooSS------------------------
--SS---S----------------------------SS---S---SS---S----SS---SS---S----SSS-----------------SS----SS---S---------------SS------------SS------------------------
--SS---S----------------------------SS---S---SS---S----SS---SS---S----SSS----------SSSSSS-SS----SS---S---------------SS----------SSSS------------------------
ooSS---SoU------------------------ooSS---SoooSS---SoU--SC-ooSS---SoU--SSC----------SSSSSSoSSooooSS---SoU-------------SC----------SSSS------------------------
SSSS---SSS----------------TT-----SSSSS---SSSSSS---SSS--SS-SSSS---SSS--SSS--SSSS----------SSSSSSSSS---SSS------TT-----SS--SSSS------SS-----------------##-----
--------------------TT----TT----#S----------------------------------------------------------------------TT----TT------------------------SS-----------###---SS
--------------------TT----TT---##S----------------------------------------------------------------------TT----TT------------------------SS----------####---SF
---M----------------TT----TT---##-----------------------------------------------------------------------TT----TT------------------------SS---------#####---S#
XXXXXXXXXXXXXXXXXXXXXXXXXXXXXXXXXXXXXXXXXXXXXXXXXXXXXXXXXXXXXXXXXXXXXXXXXXXXXXX---XXXXXXXXXXXXXXXXXXXXXXXXXXXXXXXXXXXXXXXXXXX---XXXXXXXXXX--XXXXXXXXXXXX---XX
XXXXXXXXXXXXXXXXXXXXXXXXXXXXXXXXXXXXXXXXXXXXXXXXXXXXXXXXXXXXXXXXXXXXXXXXXXXXXXX---XXXXXXXXXXXXXXXXXXXXXXXXXXXXXXXXXXXXXXXXXXX---XXXXXXXXXX--XXXXXXXXXXXX---XX
