-------------------------------------------------------------------------------------------------------------------------------------------------------------
-------------------------------------------------------------------------------------------------------------------------------------------------------------
-------------------------------------------------------------------------------------------------------------------------------------------------------------
SSSSSSSSSSSSSSSSSSSSSSSSSSSSSSSSSSSSSSSSSSSSSSSSSSSSSSSSSSSSSSSSSSSSSSSSSSSSSSSS--SSSSSSSSSSSSSSSSSSSSSSSSSSSSSSSSSSSSSSSSSSSSSSSSSSSSSSSSS------------------
--SS--SSSSSS--SSS---------------------S--SSSSSS--SSSSSSSSS--SSSS----SSSSS--SSSS------SSSS--SSSS--------------------------SSSS--S------SSSS-------------------
--SS--SSSSSS--SSS---------------------S--SSSSSS--SSSSSSSSS--SSSS----SSSSS--SSSS------SSSS--SSSS--------------------------SSSS--S------SSSS-------------------
SS--------SS---S-----------------------------SS---S-----SS---S----SS---SS---S-----S----SS---S----SS------------------SS-----------SS--------SSS--------------
SS--------SS---S-----------------------------SS---S-----SS---S----SS---SS---S-----S----SS---S----SS------------------SS-----------SS-------------------------
SS--------SS---S-----------------------------SS---S-----SS---S----SS---SS---S-----S----SS---S----SS------------------SS-----------SS-------------------------
SS----ooooSS---So------------------------ooooSS---SoooooSS---SoU--SCoooSS---SoU---C---oSS---SoU--SC------------------SC--------U--SC-------------SSSSSSU-----
SSSS--SSSSSS---SS------##-------TT----S--SSSSSS---SSSSSSSS---SSS--SSSSSSS---SSS---S--SSSS---SSS--SS-----------TT-----SS--SSSS--S--SS--SSSS-------------------
--SS------------------###-TT----TT----S-----------------------------------------------------------------TT----TT---------------------------------------------
--SS-----------------####-TT----TT----S-----------------------------------------------------------------TT----TT----------------------------SSS-------------F
---M---------g------#####-TT----TT-----kk----------------k--------------ggg-----------------------------TT----TT----T-------------------------------r-------#
XXXXXXXXXXXXXXXXXXXXXXXXXXXXXXXXXXXXXXXXXXXXXXXXXXXXXXXXXXXXXXXXXXXXXXXXXXXXXXXX--XXXXXXXXXXXXXXXXXXXXXXXXXXXXXXXXXXXXXXXXXXX--XXXXXXXXXXX-------XXXXXXXX--X-
XXXXXXXXXXXXXXXXXXXXXXXXXXXXXXXXXXXXXXXXXXXXXXXXXXXXXXXXXXXXXXXXXXXXXXXXXXXXXXXX--XXXXXXXXXXXXXXXXXXXXXXXXXXXXXXXXXXXXXXXXXXX--XXXXXXXXXXX-------XXXXXXXX--XX
