-------------------------------------------------------------------------------------------------------------------------------------------------------------
-------------------------------------------------------------------------------------------------------------------------------------------------------------
-------------------------------------------------------------------------------------------------------------------------------------------------------------
SSSSSSSSSSSSSSSSSSSSSSSSSSSSSSSSSSSSSSSSSSSSSSSSSSSSSSSSSSSSSSSSSSSSSSSSSSSSSSSS--SSSSSSSSSSSSSSLSSSSSSSSSSSSSSSSSSSSSSSSSSSSSSSSSSSSSSSSSSSSSSSSSSSSSSSSSSSS
--SS--SSSSSS--S---------------------SSSSSSSSSSSSSS--SSSS--SSSSS--SSSS------SSSSS---SSSSSSSSSSS---------------------------------SSSSSS--SSSS------------------
--SS--SSSSSS--S---------------------SSSSSSSSSSSSSS--SSSS--SSSSS--SSSS------SSSSS---SSSSSSSSSSS---------------------------------SSSSSS--SSSS------------------
SS--------SS------------------------SS----SS----SS---S----SS-SS---S----SS--------------SS---SSooo----------------------------------SS---S--------------------
SS--------SS------------------------SS----SS----SS---S----SS-SS---S----SS--------------SS---SS-------------------------------------SS---S--------------------
SS--------SS------------------------SS----SS----SS---S----SS-SS---S----SS--------------SS---SSSSS----------------------------------SS---S--------------------
SS----ooooSS------------------------SSooooSSooooSS---SoU--SSoSS---SoU--SC---g------ooooSSoooSSSSS------------------------------ooooSS---SoU------------------
SSSS--SSSSSS--------------TT--------SSSSSSSSSSSSSS---SSS--SSSSS---SSS--SS--SSSSS---SSSSSSSSSSS---------------------------------SSSSSS---SSS------------##----
--SS----------------TT----TT----TT----------------------------------------------------------------------T-----TT-----------SS-------------------------###----
--SS----------------TT----TT----TT----------------------------------------------------------------------------TT----TT-----SS------------------------####--TF
---M----------------TT----TT----TT------k---------------------------------------------------------------------TT----TT-----SS-----------------------r####--T#
XXXXXXXXXXXXXXXXXXXXXXXXXXXXXXXXXXXXXXXXXXXXXXXXXXXXXXXXXXXXXXXXXXXXXXXXXXXXXXXX---XXXXXXXXXXXXXXXXXXXXXXXXXXXXXXXXXXXXXX--XX-XXXXXXXXXXXXX--XXXXXXXXXXXX--XX
XXXXXXXXXXXXXXXXXXXXXXXXXXXXXXXXXXXXXXXXXXXXXXXXXXXXXXXXXXXXXXXXXXXXXXXXXXXXXXXX---XXXXXXXXXXXXXXXXXXXXXXXXXXXXXXXXXXXXXX--XX-XXXXXXXXXXXXX--XXXXXXXXXXXX--XX
