-------------------------------------------------------------------------------------------------------------------------------------------------------------
-------------------------------------------------------------------------------------------------------------------------------------------------------------
-------------------------------------------------------------------------------------------------------------------------------------------------------------
SSSSSSSSSSSSSSSSSSSSSSSSSSSSSSSSSSSSSSSSSSSSSSSSSSSSSSSSSSSSSSSSSSSSSSSSSSSSSSSS---SSSSSSSSSSSSSSSSSSSSSSSSSSSSSSSSSSSSSS-SSSSSSSSSSSSSSSS-------------------
--SS--SSSSSS--SSS---------------SS--SSSSSS-SSSSS--SSSS----SSSSS--SSSS------SSSSS---SSSSSS--SSSS--------------------SSSS--------------------------------------
--SS--SSSSSS--SSS---------------SS--SSSSSS-SSSSS--SSSS----SSSSS--SSSS------SSSSS---SSSSSS--SSSS--------------------SSSS--------------------------------------
SS--------SS---S--------------SS--------SS----SS---S----SS---SS---S----SS------S----S--SS---S-------------------S---------------------------SSS--------------
SS--------SS---S--------------SS--------SS----SS---S----SS---SS---S----SS------S----S--SS---S-------------------S--------------------------------------------
SS--------SS---S--------U-----SS--------SS----SS---S----SS---SS---S----SS------S----S--SS---S-------------------S--------------------------------------------
SS----ooooSS---So-------S-----SS----ooooSS-oooSS---SoU--SCoooSS---SoU--SC--ooooS----SooSS---SoU-----------------C--------------------------------SSSSSSU-----
SSSS--SSSSSS---SS-----##S-----SSSS--SSSSSS-SSSSS---SSS--SSSSSSS---SSS--SS--SSSSS----SSSSS---SSS---------T-----TTS--SSSS-----------------##-------------------
--SS-----------------###--------SS----------------------------------------------------------------------TT----TT----------SS-----------###-------------------
--SS----------------####--------SS----------------------------------------g-----------------------------TT----TT----------SS----------####--SSS-------------F
---M---------g-----#####--------------kkk---------------kk---g-g--------ggg-------------------g-ggg-----TT----TT----T-----SS-------g-#####-------r----------#
XXXXXXXXXXXXXXXXXXXXXXXXXXXXXXXXXXXXXXXXXXXXXXXXXXXXXXXXXXXXXXXXXXXXXXXXXXXXXXXX---XXXXXXXXXXXXXXXXXXXXXXXXXXXXXXXXXXXX---XX--XXXXXXXXXXXX-------XXXXXXXX--X-
XXXXXXXXXXXXXXXXXXXXXXXXXXXXXXXXXXXXXXXXXXXXXXXXXXXXXXXXXXXXXXXXXXXXXXXXXXXXXXXX---XXXXXXXXXXXXXXXXXXXXXXXXXXXXXXXXXXXX---XX--XXXXXXXXXXXX-------XXXXXXXX--XX
