-------------------------------------------------------------------------------------------------------------------------------------------------------------
-------------------------------------------------------------------------------------------------------------------------------------------------------------
-------------------------------------------------------------------------------------------------------------------------------------------------------------
SSSSSSSSSSSSSSSSSSSSSSSSSSSSSSSSSSSSSSSSSSSSSSSSSSSSSSSSSSSSSSSSSSSSSSSSSSSSSSSS--SSSSSSSSSSSSSSSSSSSSSSSSSSSSSSSSSSSSSSSSSSSSSSSSSSSLSSSS-------SSSSSSSSSSSS
--SS--SSSSSS--SSSS--------------SS--SSSSSS--SSSS---SSSSSS--SSSS------SSSSSSSSS----SS--SSSSSS--SSSS------SSS-------------SSSS---------------------------------
--SS--SSSSSS--SSSS--------------SS--SSSSSS--SSSS---SSSSSS--SSSS------SSSSSSSSS----SS--SSSSSS--SSSS------SSS-------------SSSS---------------------------------
SS--------SS---S----SS--------SS--------SS---S---------SS---S----SS---------SS------------SS---S----SS--------------------------oooooo------SSS--------------
SS--------SS---S----SS--------SS--------SS---S---------SS---S----SS---------SS------------SS---S----SS-------------------------------------------------------
SS--------SS---S----SS--------SS--------SS---S---------SS---S----SS---------SS------------SS---S----SS--------------------------SSSSSS-----------------------
SS----ooooSS---SoU--SC--------SS----ooooSS---SoU---ooooSS---SoU--SC-----oooogS----oU--ooooSS---SoU--SC--------------------------SSSSSS-------------------C---
SSSS--SSSSSS---SSS--SS--##T---SSSS--SSSSSS---SSS---SSSSSS---SSS--SS--SSSSSSSSS----SS--SSSSSS---SSS--SS--SSS---TT--------SSSS------------##---------#-#-------
--SS-------------------###T-----SS----------------------------------------------------------------------T-----TT-----------------------###-------#-#-#-#---#-
--SS-------------------###T-----SS----------------------------------------------------------------------------TT----TT-----------------###--SSS--#-#-#-#---#F
---M-------------------###T-------------k---------------------------------------------------------------------TT----TT-----------------###-------#-#r#-#-E-##
XXXXXXXXXXXXXXXXXXXXXXXXXXXXXXXXXXXXXXXXXXXXXXXXXXXXXXXXXXXXXXXXXXXXXXXXXXXXXXXX--XXXXXXXXXXXXXXXXXXXXXXXXXXXXXXXXXXXXXXXXXX---XXXXXXXXXXX-------XXXXXXXXXXXX
XXXXXXXXXXXXXXXXXXXXXXXXXXXXXXXXXXXXXXXXXXXXXXXXXXXXXXXXXXXXXXXXXXXXXXXXXXXXXXXX--XXXXXXXXXXXXXXXXXXXXXXXXXXXXXXXXXXXXXXXXXX---XXXXXXXXXXX-------XXXXXXXXXXXX
