-------------------------------------------------------------------------------------------------------------------------------------------------------------
-------------------------------------------------------------------------------------------------------------------------------------------------------------
-------------------------------------------------------------------------------------------------------------------------------------------------------------
SSSSSSSSSSSSSSSSSSSSSSSSSSSSSSSSSSSSSSSSSSSSSSSSSSSSSSSSSSSSSSSSSSSSSSSSSSSSSSSS---SSSSSSSSSSSSSSSSSSSSSSSSSSSSSSSSSSSSSS-SSSSSSSSSSSSSSSSSSSSSSSSSSSSSSS----
SSSS--SSSSSS--SSSS------S-------SS--SSSSSSSSSSSS--SSSS----SSSSS--SSSS------SS--S---SSSSSS--SSSS--S--SSS------------------------S------SSSS-------------------
SSSS--SSSSSS--SSSS------S-------SS--SSSSSSSSSSSS--SSSS----SSSSS--SSSS------SS--S---SSSSSS--SSSS--S--SSS------------------------S------SSSS-------------------
--SS---SS-SS---S----SS--------SS--------SS----SS---S----SS---SS---S----SS----SS--------SS---S----S---SS---------------------------SS----------o------------SS
--SS---SS-SS---S----SS--------SS--------SS----SS---S----SS---SS---S----SS----SS--------SS---S----S---SS---------------------------SS-------------------------
--SS---SS-SS---S----SS--------SS--------SS----SS---S----SS---SS---S----SS----SS--------SS---S----S---SS---------------------------SS----------S--------------
ooSS---SSoSS---SoU--SC--------SS----ooooSSooooSS---SoU--SCoooSS---SoU--SC----SS----ooooSS---SoU--S---SS------------------------U--SC----------S--------------
SSSS---SSSSS---SSS--SS--S-----SSSS--SSSSSSSSSSSS---SSS--SSSSSSS---SSS--SS--SSSSS---SSSSSS---SSS--S---SS-T-----TT---------------S--SS--SSSS-------------##----
--------------------------------SS---------------------------------------------S------------------------TT----TT-----------SS--------------------S----###----
--------------------------------SS----------------------------------------g----S------------------------TT----TT----TT-----SS--------------------S---####--SF
---M---------g------------------------kkk---------------kk---g-g--------ggg-------------------g-ggg-----TT----TT----TT-----SS------g-------------r--#####---#
XXXXXXXXXXXXXXXXXXXXXXXXXXXXXXXXXXXXXXXXXXXXXXXXXXXXXXXXXXXXXXXXXXXXXXXXXXXXXXXX---XXXXXXXXXXXXXXXXXXXXXXXXXXXXXXXXXXXXXX--XX--XXXXXXXXXXX---XX--XXXXXXXX----
XXXXXXXXXXXXXXXXXXXXXXXXXXXXXXXXXXXXXXXXXXXXXXXXXXXXXXXXXXXXXXXXXXXXXXXXXXXXXXXX---XXXXXXXXXXXXXXXXXXXXXXXXXXXXXXXXXXXXXX--XX--XXXXXXXXXXX---XX--XXXXXXXX----
