-------------------------------------------------------------------------------------------------------------------------------------------------------------
-------------------------------------------------------------------------------------------------------------------------------------------------------------
-------------------------------------------------------------------------------------------------------------------------------------------------------------
SSSSSSSSSSSSSSSSSSSSSSSSSSSSSSSSSSSSSSSSSSSSSSSSSSSSSSSSSSSSSSSSSSSSSSSSSSSSSSSS--SSSSSSSSSSSSSSSLSSSSSSSSSSSSSSSSSSSSSSSSSSSSSSSSSSSSSSSSSSSSSSSSSSSSSSSSSSS
--SS--SSSSSS--S-----------------------SS--SSSSSS--SSSS-SS--SSSS--SSSS------SSSSS---SSSSSSSSSS-----------------------SS---SSSS--S------SSSS-SSS---------------
--SS--SSSSSS--S-----------------------SS--SSSSSS--SSSS-SS--SSSS--SSSS------SSSSS---SSSSSSSSSS-----------------------SS---SSSS--S------SSSS-SSS---------------
SS--------SS------------------------SS--------SS---S---SS----SS---S----SS------S----S-----SSSooooo-------------------SS-----------SS-------------------------
SS--------SS------------------------SS--------SS---S---SS----SS---S----SS------S----S-----SSS------------------------SS-----------SS-------------------------
SS--------SS------------------------SS--------SS---S---SS----SS---S----SS------S----S-----SSSSSSSS-------------------SS-----------SS-------------------------
SS----ooooSS------------------------SS----ooooSS---SoU-SS---oSS---SoU--SC--ooooS----SoUoooSSSSSSSS-------------------SC--------U--SC---------------------C---
SSSS--SSSSSS--------------TT--------SSSS--SSSSSS---SSS-SS---SSS---SSS--SS--SSSSS----SSSSSSSSS-----------------T------SS--SSSS--S--SS--SSSS-SSS-----#-#-------
--SS----------------TT----TT----------SS----------------------------------------------------------------T------TT--------------------------------#-#-#-#---#-
--SS----------------TT----TT----TT----SS-----------------------------------------------------------------------TT--------------------------------#-#-#-#---#F
---M---------g------TT----TT----TT-----kk----------------k--------------ggg------------------------------------TT---T----------------------------#-#r#-#-E-##
XXXXXXXXXXXXXXXXXXXXXXXXXXXXXXXXXXXXXXXXXXXXXXXXXXXXXXXXXXXXXXXXXXXXXXXXXXXXXXXX--XXXXXXXXXXXXXXXXXXXXXXXXXXXXXXXXXXXXXXXXXXX--XXXXXXXXXXX-XXX---XXXXXXXXXXXX
XXXXXXXXXXXXXXXXXXXXXXXXXXXXXXXXXXXXXXXXXXXXXXXXXXXXXXXXXXXXXXXXXXXXXXXXXXXXXXXX--XXXXXXXXXXXXXXXXXXXXXXXXXXXXXXXXXXXXXXXXXXX--XXXXXXXXXXX-XXX---XXXXXXXXXXXX
