-------------------------------------------------------------------------------------------------------------------------------------------------------------
-------------------------------------------------------------------------------------------------------------------------------------------------------------
-------------------------------------------------------------------------------------------------------------------------------------------------------------
SSSSSSSSSSSSSSSSSSSSSSSSSSSSSSSSSSSSSSSSSSSSSSSSSSSSSSSSSSSSSSSSSSSSSSSSSSSSSSSSSSSSSSSSSSSSSSSSSSSSSSSSSSSSSSSSSSSSSSSSSSSSSSSSSSSSSSSSSSSS-----------------
SSSSSSSS--SSSS------SSS--------------S--SSSSSSS--SSSS-----SSSSS--SSSS------SS--SS--SSSSSS--SSSS--S--SSSS------------------------------SSSS-------------------
SSSSSSSS--SSSS------SSS--------------S--SSSSSSS--SSSS-----SSSSS--SSSS------SS--SS--SSSSSS--SSSS--S--SSSS------------------------------SSSS-------------------
S-SS--SS---S----SS-------------------S---S---SS---S----SS----SS---S----SS----SS--------SS---S----S---S----------------------------SS--------SSS--------------
S-SS--SS---S----SS-------------------S---S---SS---S----SS----SS---S----SS----SS--------SS---S----S---S----------------------------SS-------------------------
S-SS--SS---S----SS-------------------S---S---SS---S----SS----SS---S----SS----SS--------SS---S----S---S----------------------------SS-------------------------
SoSSooSS---SoU--SC-------------------S---SoooSS---SoU--SC-oooSS---SoU--SC----SS----ooooSS---SoU--S---SoU--------------------------SC-------------SSSSSSU-----
SSSSSSSS---SSS--SS--SSS---------TT---S---SSSSSS---SSS--SS-SSSSS---SSS--SS--SSSSSS--SSSSSS---SSS--S---SSS------TT------------------SS--SSSS-------------------
S-------------------------TT----TT---------------------------------------------SS------------------------T----TT-----------S---------------------------------
S-------------------------TT----TT---------------------------------------------SS------------------------T----TT----TT-----S----------------SSS-------------F
S--M----------------------TT----TT-----------------------------------------------------------------------T----TT----TT-----S--------------------------------#
XXXXXXXXXXXXXXXXXXXXXXXXXXXXXXXXXXXXXXXXXXXXXXXXXXXXXXXXXXXXXXXXXXXXXXXXXXXXXXXXXXXXXXXXXXXXXXXXXXXXXXXXXXXXXXXXXXXXXXXXX--X--XXXXXXXXXXXX-------XXXXXXXX--X-
XXXXXXXXXXXXXXXXXXXXXXXXXXXXXXXXXXXXXXXXXXXXXXXXXXXXXXXXXXXXXXXXXXXXXXXXXXXXXXXXXXXXXXXXXXXXXXXXXXXXXXXXXXXXXXXXXXXXXXXXX--X--XXXXXXXXXXXX-------XXXXXXXX--XX
