-------------------------------------------------------------------------------------------------------------------------------------------------------------
-------------------------------------------------------------------------------------------------------------------------------------------------------------
-------------------------------------------------------------------------------------------------------------------------------------------------------------
SSSSSSSSSSSSSSSSSSSSSSSSSSSS-SSSSSSSSSSSSSSSSSSSSSSSSSSSSSSSSSSSSSSSSSSSSSSSSSSS--SSSSSSSSLSSSSSSSSSSSSSSSSSSSSSSSSSSSSSSSSSSSSSSSSSSSSSSS-------------------
--SS--SSSSSS--SSSS-------------SSSSSS--SSSSSSSS--SSSS------SSSSSSSS--SSSS----SSS------------SSSSSS----------------------SSSS------SS--S----------------------
--SS--SSSSSS--SSSS-------------SSSSSS--SSSSSSSS--SSSS------SSSSSSSS--SSSS----SSS------------SSSSSS----------------------SSSS------SS--S----------------------
SS--------SS---S----SS-------------SS---S----SS---S----SS--------SS---S----SS--------oooooo--SSSSS------------------------------ooSS--------SSS--------------
SS--------SS---S----SS-------------SS---S----SS---S----SS--------SS---S----SS----------------SSSSS--------------------------------SS-------------------------
SS--------SS---S----SS-------------SS---S----SS---S----SS--------SS---S----SS--------SSSSSS--SSSSS------------------------------SSSS-------------------------
SS----ooooSS---SoU--SC---------ooooSS---SooooSS---SoU--SC-----oooSS---SoU--Sg--------SSSSSS-oSSSSS------------------------------SSSS-------------SSSSSSU-----
SSSS--SSSSSS---SSS--SS----##---SSSSSS---SSSSSSS---SSS--SS--SSSSSSSS---SSS--SSSSS------------SSSSSS------------TT--------SSSS------SS----##-------------------
--SS---------------------###----------------------------------------------------------------------------TT----TT-----------------------###-------------------
--SS--------------------####----------------------------------------------------------------------------TT----TT----TT-----------------###--SSS-------------F
---M--------------------####------------k---------------------------------------------------------------TT----TT----TT-----------------###----------r-------#
XXXXXXXXXXXXXXXXXXXXXXXXXXXX-XXXXXXXXXXXXXXXXXXXXXXXXXXXXXXXXXXXXXXXXXXXXXXXXXXX----XXXXXXXXXXXXXXXXXXXXXXXXXXXXXXXXXXXXXXXX---XXXXXXXXXXX-------XXXXXXXX--X-
XXXXXXXXXXXXXXXXXXXXXXXXXXXX-XXXXXXXXXXXXXXXXXXXXXXXXXXXXXXXXXXXXXXXXXXXXXXXXXXX----XXXXXXXXXXXXXXXXXXXXXXXXXXXXXXXXXXXXXXXX---XXXXXXXXXXX-------XXXXXXXX--XX
