-------------------------------------------------------------------------------------------------------------------------------------------------------------
-------------------------------------------------------------------------------------------------------------------------------------------------------------
-------------------------------------------------------------------------------------------------------------------------------------------------------------
SSSSSSSSSSSSSSSSSSSSSSSSSSSSSSSSSSSSSSSSSSSSSSSSSSSSSSSSSSSSSSSSSSSSSSSSSSSSSSSSSSSSSSSSSSSSSSSSSSSSSSSSSSSSSSSSSSSSSSSSSSSSSSSSSSSSSSSSSS--SSSSSSSSSSSSS----
--SS--SSSSSS--SSSS--------------------SS--SSSSSS--SSS----------SS--SSSSSS--SSSSSS--SSSSSSSSSS--SSSS----------------------------------------------------------
--SS--SSSSSS--SSSS--------------------SS--SSSSSS--SSS----------SS--SSSSSS--SSSSSS--SSSSSSSSSS--SSSS----------------------------------------------------------
SS--------SS---S----SS--------------SS--------SS---S-o-------SS--------SS---S--SS---S------SS---S----SS----------------------------------------------------SS
SS--------SS---S----SS--------------SS--------SS---S---------SS--------SS---S--SS---S------SS---S----SS------------------------------------------------------
SS--------SS---S----SS--------------SS--------SS---S-S-U-----SS--------SS---S--SS---S------SS---S----SS------------------------------------------------------
SS----ooooSS---SoU--SC--------------SS----ooooSS---SoSoS-----SS----ooooSS---SooSS---SoUooooSS---SoU--SC------------------------------------------------------
SSSS--SSSSSS---SSS--SS---TT---------SSSS--SSSSSS---SSSSS-----SSSS--SSSSSS---SSSSS---SSSSSSSSS---SSS--SS-------TT------------------------##---------##--##----
--SS---------------------TT-----------SS-----------------------SS---------------------------------------------TT----------SS-----------###--------###-###----
--SS---------------------TT----TT-----SS-----------------------SS---------------------------------------TT----TT---TT-----SS----------####-------########--SF
---M---------------------TT----TT-----------------------------------------------------------------------TT----TT---TT-----SS---------#####------#########---#
XXXXXXXXXXXXXXXXXXXXXXXXXXXXXXXXXXXXXXXXXXXXXXXXXXXXXXXXXXXXXXXXXXXXXXXXXXXXXXXXXXXXXXXXXXXXXXXXXXXXXXXXXXXXXXXXXXXXXXXX--XX--XXXXXXXXXXXX--XXXXXXXXXXXXX----
XXXXXXXXXXXXXXXXXXXXXXXXXXXXXXXXXXXXXXXXXXXXXXXXXXXXXXXXXXXXXXXXXXXXXXXXXXXXXXXXXXXXXXXXXXXXXXXXXXXXXXXXXXXXXXXXXXXXXXXX--XX--XXXXXXXXXXXX--XXXXXXXXXXXXX----
