-------------------------------------------------------------------------------------------------------------------------------------------------------------
-------------------------------------------------------------------------------------------------------------------------------------------------------------
-------------------------------------------------------------------------------------------------------------------------------------------------------------
SSSSSSSSSSSSSSSSSSSSSSSSSSSSSSSSSSSSSSSSSSSSSSSSSSSSSSSSSSSSSSSSSSSSSSSSSSSSSSSS--SSSSSSSSSSSSSSSSSSSSSSSSSSSSSSSSSSSSSSSSSSSSSSSSSSSSSSSS-------------------
SSSS--SSSSSS--SSSS------SS-------S--SSSSSS--SSSS------SSSS--SSSS------SSSSSSSS----SSSSSSS--SSSS--------------------------------------------------------------
SSSS--SSSSSS--SSSS------SS-------S--SSSSSS--SSSS------SSSS--SSSS------SSSSSSSS----SSSSSSS--SSSS--------------------------------------------------------------
-SS-------SS---S----SS------------------SS---S----SS----SS---S----SS--------SS---------SS---S----SS-----------------------------------------SSS--------------
-SS-------SS---S----SS------------------SS---S----SS----SS---S----SS--------SS---------SS---S----SS----------------------------------------------------------
-SS-------SS---S----SS------------------SS---S----SS----SS---S----SS--------SS---------SS---S----SS----------------------------------------------------------
oSS---ooooSS---SoU--SC--------------ooooSS---SoU--SC---oSS---SoU--SC----ooooSS----oUoooSS---SoU--SC----------------------------------------------SSSSSSU-----
SSSS--SSSSSS---SSS--SS--SSTT-----S--SSSSSS---SSS--SS--SSSS---SSS--SS--SSSSSSSS----SSSSSSS---SSS--SS-----------TT------------------------##-------------------
---S----------------------TT-----S----------------------------------------------------------------------TT----TT-----------SS----------###-------------------
---S----------------------TT----TS----------------------------------------------------------------------TT----TT----TT-----SS---------####--SSS-------------F
---M---------g------------TT----T------kk----------------k--------------ggg-----------------------------TT----TT----TT-----SS--------#####----------r-------#
XXXXXXXXXXXXXXXXXXXXXXXXXXXXXXXXXXXXXXXXXXXXXXXXXXXXXXXXXXXXXXXXXXXXXXXXXXXXXXXX--XXXXXXXXXXXXXXXXXXXXXXXXXXXXXXXXXXXXXXX--XX--XXXXXXXXXXX-------XXXXXXXX--X-
XXXXXXXXXXXXXXXXXXXXXXXXXXXXXXXXXXXXXXXXXXXXXXXXXXXXXXXXXXXXXXXXXXXXXXXXXXXXXXXX--XXXXXXXXXXXXXXXXXXXXXXXXXXXXXXXXXXXXXXX--XX--XXXXXXXXXXX-------XXXXXXXX--XX
