-------------------------------------------------------------------------------------------------------------------------------------------------------------
-------------------------------------------------------------------------------------------------------------------------------------------------------------
-------------------------------------------------------------------------------------------------------------------------------------------------------------
SSSSSSSSSSSSSSSSSSSSSSSSSSSSSSSSSSSSSSSSSSSSSSSSSSSSSSSSSSSSSSSSSSSSSSSSSSSSSSSS---SSSSSSSSSSSSSSSSSSSSSSSSSSSSSSSSSSSSSS-SSSSSSSSSSSSSSSS-------------------
--SS--SSSSSS--SSSS-------------------SS--SSSSSS--SSSSSSS--SSSSS--SSSS------SSSS--------SSSSSS--SSS--SSSS--SS-------------------------------------------------
--SS--SSSSSS--SSSS-------------------SS--SSSSSS--SSSSSSS--SSSSS--SSSS------SSSS--------SSSSSS--SSS--SSSS--SS-------------------------------------------------
SS--------SS---S-------------------SS--------SS---S---SS---S-SS---S----SS----------ooo-----SS---SS---S-----S--------------------------------SSS--------------
SS--------SS---S-------------------SS--------SS---S---SS---S-SS---S----SS------------------SS---SS---S-----S-------------------------------------------------
SS--------SS---S-------------------SS--------SS---S---SS---S-SS---S----SS----------SSS-----SS---SS---S-----S-------------------------------------------------
SS----ooooSS---SoU-----------------SS----ooooSS---SoUoSS---SoSS---SoU--SC----------SSS-ooooSS---SS---SoU---S-------------------------------------SSSSSSU-----
SSSS--SSSSSS---SSS--------TT-------SSSS--SSSSSS---SSSSSS---SSSS---SSS--SS--SSSS--------SSSSSS---SS---SSST--S--TT------------------------##-------------------
--SS----------------TT----TT---------SS-----------------------------------------------------------------T-----TT-----------SS----------###-------------------
--SS----------------TT----TT---------SS-----------------------------------g-----------------------------------TT----TT-----SS---------####--SSS-------------F
---M---------g------TT----TT----------kkk---------------kk---g-g--------ggg-------------------g-ggg-----------TT----TT-----SS------g-#####-------r----------#
XXXXXXXXXXXXXXXXXXXXXXXXXXXXXXXXXXXXXXXXXXXXXXXXXXXXXXXXXXXXXXXXXXXXXXXXXXXXXXX----XXXXXXXXXXXXXXXXXXXXXXXXXXXXXXXXXXXXXX--XX--XXXXXXXXXXX-------XXXXXXXX--X-
XXXXXXXXXXXXXXXXXXXXXXXXXXXXXXXXXXXXXXXXXXXXXXXXXXXXXXXXXXXXXXXXXXXXXXXXXXXXXXX----XXXXXXXXXXXXXXXXXXXXXXXXXXXXXXXXXXXXXX--XX--XXXXXXXXXXX-------XXXXXXXX--XX
