-------------------------------------------------------------------------------------------------------------------------------------------------------------
-------------------------------------------------------------------------------------------------------------------------------------------------------------
-------------------------------------------------------------------------------------------------------------------------------------------------------------
SSSSSSSSSSSSSSSSSSSSSSSSSSSSSSSSSSSSSSSSSSSSSSSSSSSSSSSSSSSSSSSSSSSSSSSSSSSSSSSS--SSSSSSSSSSSSSSSSSSSSSSSSSSSSSSSSSSSSSSSSSSSSSSSSSSSSSSSS-------------------
SSSSS--SSSS------SSSS-----------------SS--SSSSSS--SSSSSSSS--SSSS------SSSS----SS--SSSSSS--SSSS---------------------------------------------------------------
SSSSS--SSSS------SSSS-----------------SS--SSSSSS--SSSSSSSS--SSSS------SSSS----SS--SSSSSS--SSSS---------------------------------------------------------------
SS-SS---S----SS---------------------SS--------SS---S----SS---S----SS--------SS--------SS---S----S-------------------------------------------SSS--------------
SS-SS---S----SS---------------------SS--------SS---S----SS---S----SS--------SS--------SS---S----S------------------------------------------------------------
SS-SS---S----SS---------------------SS--------SS---S----SS---S----SS--------SS--------SS---S----S------------------------------------------------------------
SSoSS---SoU--SC---------------------SS----ooooSS---SoUooSS---SoU--SC--------SS----ooooSS---SoU--S------------------------------------------------SSSSSSU-----
SSSSS---SSS--SS--SSSS-----TT--------SSSS--SSSSSS---SSSSSSS---SSS--SS--SSSS--SSSS--SSSSSS---SSS--S-------------TT------------------------##-------------------
---------------------T----TT----------SS--------------------------------------SS------------------------TT----TT----------SS-----------###-------------------
---------------------T----TT----TT----SS--------------------------------------SS------------------------TT----TT----TT----SS----------####--SSS-------------F
---M---------g-------T----TT----TT-----kk----------------k--------------ggg-----------------------------TT----TT----TT----SS---------#####----------r-------#
XXXXXXXXXXXXXXXXXXXXXXXXXXXXXXXXXXXXXXXXXXXXXXXXXXXXXXXXXXXXXXXXXXXXXXXXXX-XXXXX--XXXXXXXXXXXXXXXXXXXXXXXXXXXXXXXXXXXXXX--XX--XXXXXXXXXXXX-------XXXXXXXX--X-
XXXXXXXXXXXXXXXXXXXXXXXXXXXXXXXXXXXXXXXXXXXXXXXXXXXXXXXXXXXXXXXXXXXXXXXXXX-XXXXX--XXXXXXXXXXXXXXXXXXXXXXXXXXXXXXXXXXXXXX--XX--XXXXXXXXXXXX-------XXXXXXXX--XX
