-------------------------------------------------------------------------------------------------------------------------------------------------------------
-------------------------------------------------------------------------------------------------------------------------------------------------------------
-------------------------------------------------------------------------------------------------------------------------------------------------------------
SSSSSSSSSSSSSSSSSSSSSSSSSSSSSSSSSSSSSSSSSSSSSSSSSSSSSSSSSSSSSSSSSSSSSSSSSSSSSSSS--SSSSSSLSSSSSSSLSSSSSSSSSSSSSSSSSSSSSSSSSSSSSSSSSSSSSSSSS-------------------
S-SS--SSSSSS--SSSS---------------S--SSSSSS--SSSSS--SSSSSS--SSSS---SSS------SSSS----------SSSSS--------------------------SS--SSSSSS--SSS----------------------
S-SS--SSSSSS--SSSS---------------S--SSSSSS--SSSSS--SSSSSS--SSSS---SSS------SSSS----------SSSSS--------------------------SS--SSSSSS--SSS----------------------
SS--------SS---S------------------------SS---S---------SS---S----SS----SS----------ooooooS--SSooo---------------------SS--------SS---S------SSS--------------
SS--------SS---S------------------------SS---S---------SS---S----SS----SS----------------S--SS------------------------SS--------SS---S-----------------------
SS--------SS---S------------------------SS---S---------SS---S----SS----SS----------SSSSSSS--SSSSS---------------U-----SS--------SS---S-----------------------
SS----ooooSS---SoU------------------ooooSS---So----ooooSS---SoU--SSoU--SC---g------SSSSSSSooSSSSS---------------S-----SS----ooooSS---So----------SSSSSSU-----
SSSS--SSSSSS---SSS--------TT-----S--SSSSSS---SSSS--SSSSSS---SSS--SSSS--SS--SSSS----------SSSSS------------------S-----SSSS--SSSSSS---SS-##-------------------
S-SS----------------TT----TT-----S-------------SS-------------------------------------------------------T-----TT--------SS-------------###-------------------
S-SS----------------TT----TT----TS-------------SS-------------------------------------------------------------TT--------SS-------------###--SSS-------------F
S--M----------------TT----TT----T-------k---------------------------------------------------------------------TT-----------------------###----------r-------#
XXXXXXXXXXXXXXXXXXXXXXXXXXXXXXXXXXXXXXXXXXXXXXXXXXXXXXXXXXXXXXXXXXXXXXXXXXXXXXX---XXXXXXXXXXXXXXXXXXXXXXXXXXXXXXXXXXXXXXXXXXXXXXXXXXXXXXXX-------XXXXXXXX--X-
XXXXXXXXXXXXXXXXXXXXXXXXXXXXXXXXXXXXXXXXXXXXXXXXXXXXXXXXXXXXXXXXXXXXXXXXXXXXXXX---XXXXXXXXXXXXXXXXXXXXXXXXXXXXXXXXXXXXXXXXXXXXXXXXXXXXXXXX-------XXXXXXXX--XX
