-------------------------------------------------------------------------------------------------------------------------------------------------------------
-------------------------------------------------------------------------------------------------------------------------------------------------------------
-------------------------------------------------------------------------------------------------------------------------------------------------------------
SSSSSSSSSSSSSSSSSSSSSSSSSSSSSSSSSSSSSSSSSSSSSSSSSSSSSSSSSSSSSSSSSSSSSSSSSSSSSSSS---SSSSSSSSSSSSSSSSSSSSSSSSSSSSSSSSSSSSSS-SSSSSSSSSSSSSSSS-------------------
SSSS--SSSS----SSSS--SS---------------SS--SSSSSS--SSSS------SSSSSSSSS--SSSS---------SSSSSS--SSSS------SSSS----------------------SSSSSS------------------------
SSSS--SSSS----SSSS--SS---------------SS--SSSSSS--SSSS------SSSSSSSSS--SSSS---------SSSSSS--SSSS------SSSS----------------------SSSSSS------------------------
--SS---S----SS--SS---S--------------S--------SS---S----SS---------SS---S----SS---------SS---S----SS--------------------------------SS-------SSS--------------
--SS---S----SS--SS---S--------------S--------SS---S----SS---------SS---S----SS---------SS---S----SS--------------------------------SS------------------------
--SS---S----SS--SS---S--------------S--------SS---S----SS---------SS---S----SS---------SS---S----SS--------------------------------SS------------------------
ooSS---SoU--SCooSS---S--------C-----S----ooooSS---SoU--SC------oooSS---SoU--SC-----ooooSS---SoU--SC----------------------------ooooSS------------SSSSSSU-----
SSSS---SSS--SSSSSS---S--#-#---------SSS--SSSSSS---SSS--SS--SSSSSSSSS---SSS--SS-----SSSSSS---SSS--SS--SSST-----TT---------------SSSSSS---##-------------------
----------------------#-#-#-#---#----SS-----------------------------------------------------------------T-----TT-----------SS----------###-------------------
----------------------#-#-#-#---#-#--SS-----------------------------------g-----------------------------------TT----TT-----SS---------####--SSS-------------F
---M---------g--------#-#-#-#-E-#-#---kkk---------------kk---g-g--------ggg-------------------g-ggg-----------TT----TT-----SS------g--####-------r----------#
XXXXXXXXXXXXXXXXXXXXXXXXXXXXXXXXXXXXXXXXXXXXXXXXXXXXXXXXXXXXXXXXXXXXXXXXXXXXXXXX---XXXXXXXXXXXXXXXXXXXXXX-XXXXXXXXXXXXXXX--XXXXXXXXXXXXXXX-------XXXXXXXX--X-
XXXXXXXXXXXXXXXXXXXXXXXXXXXXXXXXXXXXXXXXXXXXXXXXXXXXXXXXXXXXXXXXXXXXXXXXXXXXXXXX---XXXXXXXXXXXXXXXXXXXXXX-XXXXXXXXXXXXXXX--XXXXXXXXXXXXXXX-------XXXXXXXX--XX
