-------------------------------------------------------------------------------------------------------------------------------------------------------------
-------------------------------------------------------------------------------------------------------------------------------------------------------------
-------------------------------------------------------------------------------------------------------------------------------------------------------------
SSSSSSSSSSSSSSSSSSSSSSSSSSSSSSSSSSSSSSSSSSSSSSSSSSSSSSSSSSSSSSSSSSSSSSSSSSSSSSSSSSSSSSSSSSSSSSSSSSSSSSSSSSSSSSSSSSSSSSSSSSSSSSSSSSSSSSSSSS-------------SSSSSS
--SS--SSSSSS--SSSS--------------SS--SSSSSS--SSSS------SS--SSSS--SSSS----------SS--SSSSSS--SSSS---------------------SSSS--------------------------------------
--SS--SSSSSS--SSSS--------------SS--SSSSSS--SSSS------SS--SSSS--SSSS----------SS--SSSSSS--SSSS---------------------SSSS--------------------------------------
SS--------SS---S----SS--------SS--------SS---S----SS--SS---SSS---S----SS----SS--------SS---S--------------------S---------------------------SSS--------------
SS--------SS---S----SS--------SS--------SS---S----SS--SS---SSS---S----SS----SS--------SS---S--------------------S--------------------------------------------
SS--------SS---S----SS--U-----SS--------SS---S----SS--SS---SSS---S----SS----SS--------SS---S--------------------S--------------------------------------------
SS----ooooSS---SoU--SC-oS-----SS----ooooSS---SoU--SC--SS---SSS---SoU--SC----SS----ooooSS---SoU------------------C--------------------------------SSSSSS------
SSSS--SSSSSS---SSS--SS-SS-----SSSS--SSSSSS---SSS--SS--SS---SSS---SSS--SS----SSSS--SSSSSS---SSS----------------TTS--SSSS-----------------##-------------------
--SS----------------------------SS--------------------------------------------SS------------------------TT----TT----------SS-----------###-------------SS----
--SS----------------------------SS--------------------------------------------SS------------------------TT----TT----------SS----------####--SSS--------SS---F
---M----------------------------------------------------------------------------------------------------TT----TT----------SS---------#####-------------SS---#
XXXXXXXXXXXXXXXXXXXXXXXXXXXXXXXXXXXXXXXXXXXXXXXXXXXXXXXXXXXXXXXXXXXXXXXXXXXXXXXXXXXXXXXXXXXXXXXXXXXXXXXXXXXXXXXXXXXXXXX---XX--XXXXXXXXXXXX-------XXXXXXXX--XX
XXXXXXXXXXXXXXXXXXXXXXXXXXXXXXXXXXXXXXXXXXXXXXXXXXXXXXXXXXXXXXXXXXXXXXXXXXXXXXXXXXXXXXXXXXXXXXXXXXXXXXXXXXXXXXXXXXXXXXX---XX--XXXXXXXXXXXX-------XXXXXXXX--XX
