--------SSSSSSSSSSSSSSSSSSSSSSSSSSSSSSSSSSSSXXXXXXXXXXXSSSSSSSSSSSSSSSSSSSSSSSXXXXXXXXXLSSSSSSSSSSSSSSSXXXXSSSSSSSSSSSSSSSSSSSSSSSSSSSSSSSSXXXXXXXXXXXX@QQQQ-
SSSSSSSSSSS--SSSSSSSSS--SSSS---------------------------------------------------------------------------------------------------------------------------------
SSS--SSSSSS--SSSSSSSSS--SSSS---------------------------------------------------------------------------------------------------------------------------------
SSS--SSS-SS---S--SS-SS---S----SSSSSSSSSSSSSSSSSSSSSSSSSSSSSSSSSSSSSSSSSSSSSSSSSSSSSSSSSSSLSSSSSSSSSSSSSSSSSSSSSSSSSSSS----------SSSSSSSSSS--------SSSSSSS----
-SS---S--SS---S--SS-SS---S---------SSS--SSSSSSSSSS--SSSSSS--SSSS-SSSSSSS--SSSSSS----------SSSSSSSS--SSSS---S----------SSSSSSSSSSSSSS-------------------------
-SS---S--SS---S--SS-SS---S---------SSS--SSSSSSSSSS--SSSSSS--SSSS-SSSSSSS--SSSSSS----------SSSSSSSS--SSSS---S------------SSSS----SSSS-------------------------
-SS---S-oSS---SoUSSoSS---SoU-------SSS---S------SS---S--SS---S----SS--SS---S--------ooooooSS----SS---S----S-------------SSSS------SS--------SSS------------SS
oSS---SoSSS---SSSSSSSS---SSS-------SSS---S------SS---S--SS---S----SS--SS---S--------------SS----SS---S----S-----------------------SS-------------------------
SSS---SS---------------------------SSS---S------SS---S--SS---S----SS--SS---S--------SSSSSSSS----SS---S----S-----------------------SS-------------------------
-----------------------------------SSS---SoUooooSS---SoUSS---SoU-oSSooSS---S--------SSSSSSSSooooSS---SoU--S----------------------oSS-------------S-----------
SSS--SSSSS-----------------------##SSS---SSSSSSSSS---SSSSS---SSS-SSSSSSS---SSSSS----------SSSSSSSS---SSS--S---TTT----------------SSS----##-------------##----
-SS----------------XXXXXXXXXXX--###---------------------------------------------------------------------------TTT-------SSSS-----------###------------###----
-SS-----------------#-#-#-#----####---------------------------------------------------------------------------TTT----T----------------####--SSS------####--SF
---M------------#TT-#-#-#-#-E-#####---------------------------------------------------------------------------TTT----T---------------#####----------#####---#
XXXXXXXXXXXXXXXXXTTXXXXXXXXXXXXXXXXXXXXXXXXXXXXXXXXXXXXXXXXXXXXXXXXXXXXXXXXXXXXX---XXXXXXXXXXXXXXXXXXXXXXXXXXXXXXXXXXX----------XXXXXXXXXX-------XXXXXXXX----
XXXXXXXXXXXXXXXXXXXXXXXXXXXXXXXXXXXXXXXXXXXXXXXXXXXXXXXXXXXXXXXXXXXXXXXXXXXXXXXX---XXXXXXXXXXXXXXXXXXXXXXXXXXXXXXXXXXXXXXXXX---XXXXXXXXXXX-------XXXXXXXX----
