SSSSSSSSSSSSSSSSSSSSSSSSSSSSSSSSSSSSSSSSSSSSSSSSSSSSSSSSSSSSSSSSSSSSSSSSSSSSSSSS---SSSSSSSSSSSSSSSSSSSSSSSSSSSSSSSSSSSSSS-SSS----SSSSSSSSSSSSSSS---------ooo-
SSSSSSSSSSSSSSSS--SSSSS--SSSSSSSSSSS--SSSS-SSSSSSSSSSSSS--SSSSSSSSSSSSSSSSSSS--S-------SSSSSSSSSS-SSSSSS--SSSS-SS--SSSSSS--SS----SSSSSS--SSSS---SSSSSSSSS----
SSSSSSSSSSSSSSSS--SSSSS--SSSSSSSSSSS--SSSS-SSSSSSSSSSSSS--SSSSSSSSSSSSSSSSSSS--S-------SSSSSSSSSS-SSSSSS--SSSS-SS--SSSSSS--SSSSSSSSSSSS--SSSS----SSSS----SSS-
----SSSSSS----SS---S-SS---S-------SS---S-------SS-SSSSSS---S-----SS---SS---SS--------SS----SS--SS-----SS---S-----------SS---SSSSS----SS---S----S-SSSS----SSS-
----SSSSSS----SS---S-SS---S-------SS---S-------SS-SSSSSS---S-----SS---SS---SS--------SS----SS--SS-----SS---S-----------SS---SSSSS----SS---S----S-------------
----SSSSSS----SS---S-SS---S-------SS---S-------SS-SSSSSS---S-----SS---SS---SS--------SS----SS--SS-----SS---S-----------SS---S---S----SS---S----S-------------
ooooSSSSSSooooSS---SoSS---S---ooooSS---SoU-ooooSSoSSSSSS---SoUoooSSoooSSoooSS--------SCooooSSooSS-ooooSS---SoU-----ooooSS---S---SooooSS---SoU--S-------------
SSSSSSSSSSSSSSSS---SSSS---SSSSSSSSSS---SSS-SSSSSSSSSSSSS---SSSSSSSSSSSSSSSSSS--------SSSSSSSSSSSS-SSSSSS---SSS-SS--SSSSSS---S---SSSSSSS---SSS--S-------------
-S-SSSS-U-----SSS------------------SS-----SSSSSS-------S-SSSS-U--SSSSSS-SSSS-U-------SSS-SSSS-U--------------------------------------------------------------
-SoS--SoS-----S--------------------SS-----SSSSSS-------SoS--SoS--SSSSSSoS--SoS-------SSSoS--SoS--------------------------------------------------------------
-SSS--SSS-----S-----------TT---------------------------SSS--SSS--------SS--SSS-------SSSSS--SSS---------T-----TT-------------------------S-------------##----
--------------------TT----TT----------------------------------------------------------------------------TT----TT-----------SS-----------#S------------###--TT
--------------------TT----TT----TT----------------------------------------g---------T-------------------TT----TT-----------SS----------##S-----------####--TF
---M---------g----##TT----TT----TT----kkk---------------kk---g-g--------ggg---------T---------g-ggg-----TT----TT----T##----SS------g--###S-------r--#####--T#
XXXXXXXXXXXXXXXXX###XXXXXXXXXXXXXXXXXXXXXXXXXXXXXXXXXXXXXXXXXXXXXXXXXXXXXXXXXXXX----TXXXXXXXXXXXXXXXXXXXXXXXXXXXXXX-###----XX--XXXXXXXXXXS---XXXXXXXXXXXX--XX
XXXXXXXXXXXXXXXXX###XXXXXXXXXXXXXXXXXXXXXXXXXXXXXXXXXXXXXXXXXXXXXXXXXXXXXXXXXXXX----TXXXXXXXXXXXXXXXXXXXXXXXXXXXXXX####----XX--XXXXXXXXXXS---XXXXXXXXXXXX--XX
