---------------SSSSSSSS---SSSSSSSSSSSSSSSSSSSSS--------------SSSSSSSSSSSSSSSSSSS--SSSSSSSSSSSSSSSSSSSSSSSSSSSSSSSSSSSSSSSSSSSSSSSSSSSSSSSSSSSSSSSSSSSSSSSSSSS
SSSSSSSSSSSSSSSSSSSSSSSooo--SSSSSS--SS--SSSSSS-SSSSSSSSSSSSSS--SS--SSSSSSSS--SSS--SS--SSSS--SS--SSSSSSSS--SSSS--SSSSSSSSSSSSS--SSSSSSSSSS--SSSS------SSSS----
SSSSS--SSSS----SSSSS-SS-----SSSSSS--SS--SSSSSS-SSSS--SSSS------SS--SSSSSSSS--SSS--SS--SSSS--SS--SSSSSSSS--SSSS--SSSSSSSSSSSSS--SSSSSSSSSS--SSSS------SSSS----
SSSSS--SSSS-------SS-SSSSS------SSSS--------SS-SSSS--SSSS----SS--------SSSS---S---SS---S--SS--------SSSS---S--------SSS-SS-SS---S------SS---S----SS----------
---SS---S----SS---SS-SSSSS------SSSS--------SS---SS---S----SSSS--------SSSS---S---SS---S--SS--------SSSS---S--------SSS-SS-SS---S------SS---S----SS----------
---SS---S----SS---SSoSS---------SSSS--------SS---SS---S----SSSS--------SSSS---S---SS---S--SS--------SSSS---S--------SSS-SS-SS---S------SS---S----SS----------
---SS---S----SSoooSSSSS-----ooooSSSS----ooooSS---SS---S----SSSS----ooooSSSS---So--SS---SoUSS----ooooSSSS---S----ooooSSSoSSoSS---SoUooooSS---SoU--SC----------
oooSS---SoU--SCSSSSS--------SSSSSSSSSS--SSSSSS-ooSS---SoU--SCSSSS--SSSSSSSS---SS--SS---SSSSSSS--SSSSSSSS---SSS--SSSSSSSSSSSSS---SSSSSSSSS---SSS--SS--SSSS----
SSSSS---SSS--SS---------------------SS---------SSSS---SSS--SS--SS---------------------------SS--------------SS--------S--------------------------------------
-------SSSS-------------------------S----S-SSSSS-SSSSSooSS---SoU--SCU--SC---g------SSSSoS-SSSSS--------------------------------------------------SSSSSSU-----
TT------------------------TT--------------------------SSSS---SSS--SSS--SS--SSSS-------SSS---------------------TT-------------------------S-------------------
TT------------------TT----TT-----TT---------------------------------------------------------------------TT----TT------------------------#S-------------------
TT----------------#-TT----TT----TTT---------------------------------------------------------------------TT----TT----TT-----------------##S----S-------------F
TT-M-------------##-TT----TT----TTT-----k---------------------------------------------------------------TT----TT----TT----------------###S----------r-------#
XXXXXXXXXXXXXXXXXXXXXXXXXXXXXXXXXXXXXXXXXXXXXXXXXXXXXXXXXXXXXXXXXXXXXXXXXXXXXXX---XXXXXXXXXXXXXXXXXXXXXXXXXXXXXXXXXXXXXX---C---XXXXXXXXXXS-------XXXXXXXX--X-
XXXXXXXXXXXXXXXXXXXXXXXXXXXXXXXXXXXXXXXXXXXXXXXXXXXXXXXXXXXXXXXXXXXXXXXXXXXXXXX---XXXXXXXXXXXXXXXXXXXXXXXXXXXXXXXXXXXXXX-------XXXXXXXXXXS-------XXXXXXXX--XX
