-------------------------------------------------------------------------------------------------------------------------------------------------------------
-------------------------------------------------------------------------------------------------------------------------------------------------------------
-------------------------------------------------------------------------------------------------------------------------------------------------------------
SSSSSSSSSSSSSSSSSSSSSSSSSSSSSSSSSSSSSSSSSSSSSSSSSSSSSSSSSSSSSSSSSSSSSSSSSSSSSSSS--SSSSSSSSSSSSSSSSSSSSSSSSSSSSSSSSSSSSSS-SSSSSSSSSSSSSSSSS--S----------------
SSSSS--SSSS------SS---------------SSSS--SSSSSS--SSSS------SSSSS--SSSS------SSSS---SSSSSS--SSSS------------------------S--------------------------------------
SSSSS--SSSS------SS---------------SSSS--SSSSSS--SSSS------SSSSS--SSSS------SSSS---SSSSSS--SSSS------------------------S--------------------------------------
---SS---S----SS---------------------SS---S--SS---S----SS-----SS---S----SS----SS-------SS---S----SS-------------------------------------------SS--------------
---SS---S----SS---------------------SS---S--SS---S----SS-----SS---S----SS----SS-------SS---S----SS-----------------------------------------------------------
---SS---S----SS---------------------SS---S--SS---S----SS-----SS---S----SS----SS-------SS---S----SS-----------------------------------------------------------
oooSS---SoU--SC----------------C--ooSS---SoUSS---SoU--SC---ooSS---SoU--SC----SS---ooooSS---SoU--SC-----------------------------------------------SSSSSSU-----
SSSSS---SSS--SS--SS------#-#------SSSS---SSSSS---SSS--SS--SSSSS---SSS--SS--SSSS---SSSSSS---SSS--SS------------TT------S-----------------##-------------------
-----------------------#-#-#-#---#----------------------------------------------------------------------TT----TT----------SS-----------###-------------------
---------------------#-#-#-#-#---#----------------------------------------------------------------------TT----TT----TT----SS----------####---SS-------------F
---M---------g-----#-#-#-#-#-#-E-#-----kk---------------kk----------------g-------------------g--g------TT----TT-g--TT----SS---------#####-------r----------#
XXXXXXXXXXXXXXXXXXXXXXXXXXXXXXXXXXXXXXXXXXXXXXXXXXXXXXXXXXXXXXXXXXXXXXXXXXXXXXXX--XXXXXXXXXXXXXXXXXXXXXXXXXXXXXXXXXXXXX---XX--XXXXXXXXXXXX-------XXXXXXXX--X-
XXXXXXXXXXXXXXXXXXXXXXXXXXXXXXXXXXXXXXXXXXXXXXXXXXXXXXXXXXXXXXXXXXXXXXXXXXXXXXXX--XXXXXXXXXXXXXXXXXXXXXXXXXXXXXXXXXXXXX---XX--XXXXXXXXXXXX-------XXXXXXXX--XX
