-------------------------------------------------------------------------------------------------------------------------------------------------------------
-------------------------------------------------------------------------------------------------------------------------------------------------------------
-------------------------------------------------------------------------------------------------------------------------------------------------------------
SSSSSSSSSSSSSSSSSSSSSSSSSSSSSSSSSSSSSSSSSSSSSSSSSSSSSSSSSSSSSSSSSSSSSSSSSSSSSSSSSSSSSSSSSSSSSSSSSSSSSSSSSSSSSSSSSSSSSSSSSSSSSSSSSSSSSSSSSSSSSSSSSSSSSSSS-SSSS
SSSSSS--SSSS------SSSS-------------SSSSSS--SSSS---SSSSSS--SSSS---SSS--SSSSSSSS--SSSSSSSS--SSSS----------------------SSSS-------------------------------------
SSSSSS--SSSS------SSSS-------------SSSSSS--SSSS---SSSSSS--SSSS---SSS--SSSSSSSS--SSSSSSSS--SSSS----------------------SSSS-------------------------------------
SSS-SS---S----SS-----------------------SS---S----S----SS---S----S-SS---S----SS---S----SS---S----SS-----------------------------------------------------------
SSS-SS---S----SS-----------------------SS---S----S----SS---S----S-SS---S----SS---S----SS---S----SS-----------------------------------------------------------
SSS-SS---S----SS-----------------------SS---S----S----SS---S----S-SS---S----SS---S----SS---S----SS-----------------------------------------------------------
SSSoSS---SoU--SC-------------------ooooSS---SoU--SooooSS---SoU--SoSS---SooooSS---SooooSS---SoU--SC-----------------------------------------------------------
SSSSSS---SSS--SS--SSSS----##-----#-SSSSSS---SSS--SSSSSSS---SSS--SSSS---SSSSSSS---SSSSSSS---SSS--SS------------TT----SSSS-----------------#------------##-----
--S-------------------#--###----##----------------------------------------------------------------------TT----TT---------------S--------##-----------###---SS
--S-------------------#-####---###----------------------------------------------------------------------TT----TT---------------S-------###----------####---SF
--SM------------------######--####----------------------------------------------------------------------TT----TT---------------S------####---------#####---S#
XXXXXXXXXXXXXXXXXXXXXXXXXXXXXXXXXXXXXXXXXXXXXXXXXXXXXXXXXXXXXXXXXXXXXXXXXXXXXXXXXXXXXXXXXXXXXXXXXXXXXXXXXXXXXXXXXXXXXXXX---X---XXXXXXXXXXX--XXXXXXXXXXXX---XX
XXXXXXXXXXXXXXXXXXXXXXXXXXXXXXXXXXXXXXXXXXXXXXXXXXXXXXXXXXXXXXXXXXXXXXXXXXXXXXXXXXXXXXXXXXXXXXXXXXXXXXXXXXXXXXXXXXXXXXXX---X---XXXXXXXXXXX--XXXXXXXXXXXX---XX
