-------------------------------------------------------------------------------------------------------------------------------------------------------------
-------------------------------------------------------------------------------------------------------------------------------------------------------------
-------------------------------------------------------------------------------------------------------------------------------------------------------------
SSSSSSSSSSSSSSSSSSSSSSSSSSSSSSSSSSSSSSSSSSSSSSSSSSSSSSSSSSSSSSSSSSSSSSSSSSSSSSSSS-SSSSSSSSSSSSSSSSSSSSSSSSSSSSSSSSSSSSSSSSSSSSSSSSSSSLSSSSSSSSSSSSSSSSSSSSSSS
SSSS-S--SSSS------SSSS----------SS--SSSSSSSSSS--SSSS-----SSSSSS--SSSS-SSS--SSS--S-SSSSSS--SSSS---S--SSSS-----------------------------------------------------
SSSS-S--SSSS------SSSS----------SS--SSSSSSSSSS--SSSS-----SSSSSS--SSSS-SSS--SSS--S-SSSSSS--SSSS---S--SSSS-----------------------------------------------------
SSSS-S---S----SS------------------------SS--SS---S----SS-----SS---S----SS---SS-------SSS---S----SS---S----S---------------------oooooo-----------------------
SSSS-S---S----SS------------------------SS--SS---S----SS-----SS---S----SS---SS-------SSS---S----SS---S----S--------------------------------------------------
SSSS-S---S----SS------------------------SS--SS---S----SS-----SS---S----SS---SS-------SSS---S----SS---S----S---------------------SSSSSS-----------------------
SSSS-S---SoU--SC--------------------ooooSSooSS---SoU--SC-ooooSS---SoU-oSS--oSS----oooSSS---SoU--SS---SoU--S---------------------SSSSSS-----------------------
SSSS-S---SSS--SS--SSSS---TT-----SS--SSSSSSSSSS---SSS--SS-SSSSSS---SSS-SSS--SSS----SSSSSS---SSS--SS---SSS--S---TT--------------------------------------#------
-------------------------TT-----SS----------------------------------------------------------------------T-----TT-----------S-------------S-----------##SS----
-------------------------TT----TSS----------------------------------------------------------------------------TT----TT-----S-------------S----------###SS---F
---M---------------------TT--g-T-------------------------k------------------------------------g---------------TT----TT-----S-------------S---------####SS---#
XXXXXXXXXXXXXXXXXXXXXX-XXXXXXXXXXXXXXXXXXXXXXXXXXXXXXXXXXXXXXXXXXXXXXXXXXXXXXXXXX-XXXXXXXXXXXXXXXXXXXXXXXXXXXXXXXXXXXXXXX--X---XXXXXXXXXXX--XXXXXXXXXXXXX--XX
XXXXXXXXXXXXXXXXXXXXXX-XXXXXXXXXXXXXXXXXXXXXXXXXXXXXXXXXXXXXXXXXXXXXXXXXXXXXXXXXX-XXXXXXXXXXXXXXXXXXXXXXXXXXXXXXXXXXXXXXX--X---XXXXXXXXXXX--XXXXXXXXXXXXX--XX
