-------------------------------------------------------------------------------------------------------------------------------------------------------------
-------------------------------------------------------------------------------------------------------------------------------------------------------------
-------------------------------------------------------------------------------------------------------------------------------------------------------------
SSSSSSSSSSSSSSSSSSSSSSSSSSSSSSSSSSSSSSSSSSSSSSSSSSSSSSSSSSSSSSSSSSSSSSSSSSSSSSSS---SSSSSSSSSSSSSSSSSSSSSSSSSSSSSSSSSSSSSS-SSSSSSSSSSSSSSSS---------SSSSSS----
--SS--SSSSSS--SSSS--------------------------SSS--SSSSSSSS--SSSS-SSSS--SSSS---------SSSSS--SSSS------S--------------------------------------------------------
--SS--SSSSSS--SSSS--------------------------SSS--SSSSSSSS--SSSS-SSSS--SSSS---------SSSSS--SSSS------S--------------------------------------------------------
SS--------SS---S-------------------------ooo-SS---S----SS---S-----SS---S----SS--------SS---S----SS------------------------------------------SSS------------SS
SS--------SS---S-----------------------------SS---S----SS---S-----SS---S----SS--------SS---S----SS-----------------------------------------------------------
SS--------SS---S-----------------------S-SSS-SS---S----SS---S-----SS---S----SS--------SS---S----SS-----------------------------------------------------------
SS----ooooSS---SoU-----------C---------SoS--oSS---SooooSS---SoU-ooSS---SoU--SC-----oooSS---SoU--SC-----------------------------------------------SS----------
SSSS--SSSSSS---SSS-----###-------------SSS--SSS---SSSSSSS---SSS-SSSS---SSS--SS-----SSSSS---SSS--SS--S---T-----TT------------------------##----------##-##----
--SS------------------####-#---#------------------------------------------------------------------------T-----TT-----------SS----------###---------######----
--SS-----------------#####-#---#-#----------------------------------------------------------------------TT----TT----TT-----SS--#------####--SSS----######--SF
---M--------gg------######-#-E-#-#----kkk---------------kkk-g-----------ggg------------------gg-ggg-----TT----TT----TT-----SS--#---gg#####-------r-######---#
XXXXXXXXXXXXXXXXXXXXXXXXXXXXXXXXXXXXXXXXXXXXXXXXXXXXXXXXXXXXXXXXXXXXXXXXXXXXXXXX---XXXXXXXXXXXXXXXXXXXXXXXXXXXXXXXXXXXXXX--XX--XXXXXXXXXXX-------XXXXXXXX----
XXXXXXXXXXXXXXXXXXXXXXXXXXXXXXXXXXXXXXXXXXXXXXXXXXXXXXXXXXXXXXXXXXXXXXXXXXXXXXXX---XXXXXXXXXXXXXXXXXXXXXXXXXXXXXXXXXXXXXX--XX--XXXXXXXXXXX-------XXXXXXXX----
