-------------------------------------------------------------------------------------------------------------------------------------------------------------
-------------------------------------------------------------------------------------------------------------------------------------------------------------
-------------------------------------------------------------------------------------------------------------------------------------------------------------
SSSSSSSSSSSSSSSSSSSSSSSSSSSSSSSSSSSSSSSSSSSSSSSSSSSSSSSSSSSSSSSSSSSSSSSSSSSSSSSSSSSSSSSSSSSSSSSSSSSSSSSSSSSSSSSSSSSSSSSSSSSSSSSSSSSSSSSSSS----SSSSSSSSSSS----
SSSSS--SSSS--------------------------S--SSSSSS--SSSS-----SSSSSS--SSSS-----SSSS--SS-SSSSSS--SSSSSS--SS---------------SSSS-------------------------------------
SSSSS--SSSS--------------------------S--SSSSSS--SSSS-----SSSSSS--SSSS-----SSSS--SS-SSSSSS--SSSSSS--SS---------------SSSS-------------------------------------
---SS---S----SS-----------------------------SS---S----SS-----SS---S----SS---SS---S-----SS---S--SS---------------------------o---------------SS-------------SS
---SS---S----SS-----------------------------SS---S----SS-----SS---S----SS---SS---S-----SS---S--SS------------------------------------------------------------
---SS---S----SS-----------------------------SS---S----SS-----SS---S----SS---SS---S-----SS---S--SS---------------------------S--------------------------------
oooSS---SoU--SC---------------C---------ooooSS---SoU--SC-ooooSS---SoU--SC-ooSS---S-ooooSS---SoUSS---------------------------S--------------------------------
SSSSS---SSS--SSQ--------#-#----------S--SSSSSS---SSS--SS-SSSSSS---SSS--SS-SSSS---S-SSSSSS---SSSSS-------------TT----SSSS----------------##-------------##----
----------------------#-#-#-#---#----S------------------------------------------------------------------TT----TT-----------------------###------------###----
--------------------#-#-#-#-#---#-#--S------------------------------------------------------------------TT----TT----------------------####--SS-------####--SF
---M--------------#-#-#-#-#-#-E-#-#---------------------------------------------------------------------TT----TT---------------------#####----------#####---#
XXXXXXXXXXXXXXXXXXXXXXXXXXXXXXXXXXXXXXXXXXXXXXXXXXXXXXXXXXXXXXXXXXXXXXXXXXXXXXXXXXXXXXXXXXXXXXXXXXXXXXXXXXXXXXXXXXXXXXXX---XX-XXXXXXXXXXXX----XXXXXXXXXXX----
XXXXXXXXXXXXXXXXXXXXXXXXXXXXXXXXXXXXXXXXXXXXXXXXXXXXXXXXXXXXXXXXXXXXXXXXXXXXXXXXXXXXXXXXXXXXXXXXXXXXXXXXXXXXXXXXXXXXXXXX---XX-XXXXXXXXXXXX----XXXXXXXXXXX----
