-------------------------------------------------------------------------------------------------------------------------------------------------------------
-------------------------------------------------------------------------------------------------------------------------------------------------------------
-------------------------------------------------------------------------------------------------------------------------------------------------------------
SSSSSSSSSSSSSSSSSSSSSSSSSSSSSSSSSSSSSSSSSSSSSSSSSSSSSSSSSSSSSSSSSSSSSSSSSSSSSSSS--SSSSSSLSSSSSSSSSSSSSSSSSSSSSSSSSSSSSSS-SSSSSSSSSSSSSSSSS---------SSSSSS----
SSSS-S--SSSS------SSSS-----------------------SSSS-SSSSSS--SSS--SSSSSS------SSSS------------SSSSSS--S---------------------SSS---------------------------------
SSSS-S--SSSS------SSSS-----------------------SSSS-SSSSSS--SSS--SSSSSS------SSSS------------SSSSSS--S---------------------SSS---------------------------------
--SS-S---S----SS-------------------------oooo--SS-----SS---SS----SS----SS----------oooooo------SS-------------------------------ooooo-------SSS------------SS
--SS-S---S----SS-------------------------------SS-----SS---SS----SS----SS----------------------SS------------------------------------------------------------
--SS-S---S----SS-----------------------S-SSSS--SS-----SS---SS----SS----SS----------SSSSSS------SS-------------------------------SSSSS------------------------
ooSS-S---SoU--SC-------------C---------SoS--SooSS-ooooSS---SS--ooSSoU--SC----------SSSSSS--ooooSS-------------------------------SSSSS------------SS----------
SSSS-S---SSS--SS--SSSS-#-#-------------SSS--SSSSS-SSSSSS---SS--SSSSSS--SS--SSSS------------SSSSSS-------------TT---------SSS------------##-------------##----
-----------------------#-#-#---#------------------------------------------------------------------------TT----TT-----------------------###------------###----
-----------------------#-#-#---#-#----------------------------------------------------------------------TT----TT----TT----------------####--SSS------####--SF
---M---------g---------#-#-#-E-#-#-----kk---------------kk----------------g-------------------g--g------TT----TT-g--TT---------------#####-------r--#####---#
XXXXXXXXXXXXXXXXXXXXXX-XXXXXXXXXXXXXXXXXXXXXXXXXXXXXXXXXXXXXXXXXXXXXXXXXXXXXXXX---XXXXXXXXXXXXXXXXXXXXXXXXXXXXXXXXXXXXXX-XXX---XXXXXXXXXXX-------XXXXXXXX----
XXXXXXXXXXXXXXXXXXXXXX-XXXXXXXXXXXXXXXXXXXXXXXXXXXXXXXXXXXXXXXXXXXXXXXXXXXXXXXX---XXXXXXXXXXXXXXXXXXXXXXXXXXXXXXXXXXXXXX-XXX---XXXXXXXXXXX-------XXXXXXXX----
