-------------------------------------------------------------------------------------------------------------------------------------------------------------
-------------------------------------------------------------------------------------------------------------------------------------------------------------
-------------------------------------------------------------------------------------------------------------------------------------------------------------
SSSSSSSSSSSSSSSSSSSSSSSSSSSSSSSSSSSSSSSSSSSSSSSSSSSSSSSSSSSSSSSSSSSSSSSSSSSSSSSSS-SSSSSSSSSSSSSSSLSSSSSSSSSSSSSSSSSSSSSSSSSSSSSSSSSSSSSSSS-----SSSSSSSSSSSSSS
SSSSSS--SSSS------------------------SSS--SSSSSS--SSSSSSS--SSSSS--SSSS------SSSSSS--SSSSS--SS------------------------SSS--------------------------------------
SSSSSS--SSSS------------------------SSS--SSSSSS--SSSSSSS--SSSSS--SSSS------SSSSSS--SSSSS--SS------------------------SSS--------------------------------------
----SS---S---------------------------S-------SS---S---SS-----SS---S----SS------SS---S-SS---Soooooo------------------------------------------SSS--------------
----SS---S---------------------------S-------SS---S---SS-----SS---S----SS------SS---S-SS---S-----------------------------------------------------------------
----SS---S---------------------------S-------SS---S---SS-----SS---S----SS------SS---S-SS---SSSSSSS-----------------------------------------------------------
ooooSS---SoU-------------------------S---ooooSS---SoooSS--oooSS---SoU--SC--ooooSS---SoSS---SSSSSSS-----------------------------------------------------------
SSSSSS---SSS--------------TT---------SS--SSSSSS---SSSSSS--SSSSS---SSS--SS--SSSSSS---SSSS---S------------------------SSS-----------------##------------###----
--------------------TT----TT----------S-----------------------------------------------------------------T------TT---------SS-----------###-----------####--SS
--------------------TT----TT----TT----S------------------------------------------------------------------------TT---T-----SS----------####--SSS-----#####--SF
---M----------------TT----TT-g--TT-----------------------k------------------------------------g----------------TT---------SS---------#####---------######--S#
XXXXXXXXXXXXXXXXXXXXXXXXXXXXXXXXXXXXXXXXXXXXXXXXXXXXXXXXXXXXXXXXXXXXXXXXXXXXXXXXX-XXXXXXXXXXXXXXXXXXXXXXXXXXXXXXXXXXXXX---XX--XXXXXXXXXXXX-----XXXXXXXXXX--XX
XXXXXXXXXXXXXXXXXXXXXXXXXXXXXXXXXXXXXXXXXXXXXXXXXXXXXXXXXXXXXXXXXXXXXXXXXXXXXXXXX-XXXXXXXXXXXXXXXXXXXXXXXXXXXXXXXXXXXXX---XX--XXXXXXXXXXXX-----XXXXXXXXXX--XX
