-------------------------------------------------------------------------------------------------------------------------------------------------------------
-------------------------------------------------------------------------------------------------------------------------------------------------------------
-------------------------------------------------------------------------------------------------------------------------------------------------------------
SSSSSSSSSSLSSSSSSSSSSSSSSSSSSSSSSSSSSSSSSSSSSSSSSSSSSSSSSSSSSSSSSSSSSSSSSSSSSSSS---SSSSSSSSSSSSSSLSSSSSSSSSSSSSSSSSSSSSSS-SSSSSSSSSSSSSSSS----SSSSSSSSSSS----
SSSSS--SS-----------------------------SS--SSSSSS--SSSSSS--SSSS--SSSS--SSSS-SSS-----S------SSSS----------------------SSSS----------------------S--------------
SSSSS--SS-----------------------------SS--SSSSSS--SSSSSS--SSSS--SSSS--SSSS-SSS-----S------SSSS----------------------SSSS----------------------S--------------
---SS---Soo-------------------------SS--------SS---S--SS---SSS---SSS---S----SS--------SS----SSoooo------------------------------------------SS-------------SS
---SS---S---------------------------SS--------SS---S--SS---SSS---SSS---S----SS--------SS----SS---------------------------------------------------------------
---SS---SSS-------------------------SS--------SS---S--SS---SSS---SSS---S----SS--------SS----SSSSSS-----------------------------------------------------------
oooSS---SSS-------------------------SS----ooooSS---SoUSS---SSS---SSS---SoU-oSS-----U--SC---oSSSSSS-----------------------------------------------------------
SSSSS---S-----------------##--------SSSS--SSSSSS---SSSSS---SSS---SSS---SSS-SSS-----S--SS--SSSS----------T-----------SSSS----------------##-------------##----
------------------------TT##----TT----SS----------------------------------------------------------------T------TT---------SS-----------###------------###----
------------------------TT##----TT----SS-----------------------------------------------------------------------TT---T-----SS----------####--SS-------####--SF
---M--------gg----------TT##----TT----kkk---------------kkk-g-----------ggg------------------gg-ggg------------TT---T-----SS-------gg#####-------r--#####---#
XXXXXXXXXXXXXXXXXXXXXXXXXXXXXXXXXXXXXXXXXXXXXXXXXXXXXXXXXXXXXXXXXXXXXXXXXXXXXXXX---XXXXXXXXXXXXXXXXXXXXXXXXXXXXXXXXXXXXX--XX--XXXXXXXXXXXX----XXXXXXXXXXX----
XXXXXXXXXXXXXXXXXXXXXXXXXXXXXXXXXXXXXXXXXXXXXXXXXXXXXXXXXXXXXXXXXXXXXXXXXXXXXXXX---XXXXXXXXXXXXXXXXXXXXXXXXXXXXXXXXXXXXX--XX--XXXXXXXXXXXX----XXXXXXXXXXX----
