-------------------------------------------------------------------------------------------------------------------------------------------------------------
-------------------------------------------------------------------------------------------------------------------------------------------------------------
-------------------------------------------------------------------------------------------------------------------------------------------------------------
SSSSSSSSSSSSLSSSSSSSSSSSSSSSSSSSSSSSSSSSSSSSSSSSSSSSSSSSSSSSSSSSSSSSSSSSSSSSSSSS--SSSSSSSSSSSSSSSSSSSSSSSSSSSSSSSSSSSSSS-SSSSSSSSSSSSSSSSS--SSSSSSSSSSSSS----
SSSSS--SSSS---------------------S--SSSSSSSSSSSSS---SSSSSS--SSSS------SSSS-----SS--SSSSSS--SSSS------SSSS-----------------------------------------------------
SSSSS--SSSS---------------------S--SSSSSSSSSSSSS---SSSSSS--SSSS------SSSS-----SS--SSSSSS--SSSS------SSSS-----------------------------------------------------
---SS---S--oo--------------------------SS---SSSS-------SS---S----SS---------SS--------SS---S----SS---S-----------------------------------------------------SS
---SS---S------------------------------SS---SSSS-------SS---S----SS---------SS--------SS---S----SS---S-------------------------------------------------------
---SS---S--SS--------------------------SS---SSSS-------SS---S----SS---------SS--------SS---S----SS---S-------------------------------------------------------
oooSS---SoUSS----------------------ooooSSoooSSSS---ooooSS---SoU--SC---------SS----ooooSS---SoU--SC---SoU-----------------------------------------------------
SSSSS---SSS---------------------S--SSSSSSSSSSSSS---SSSSSS---SSS--SS--SSSS---SSSS--SSSSSS---SSS--SS---SSS------TT------------------------##----------#--##----
--------------------------TT----S---------------------------------------------SS------------------------TT----TT----------SS-----------###---------##-###----
--------------------------TT---TS---------------------------------------------SS------------------------TT----TT----TT----SS----------####--------#######--SF
---M---------g------------TT---T-------kk---------------kk----------------g-------------------g--g------TT----TT-g--TT----SS---------#####-------r#######---#
XXXXXXXXXXXXXXXXXXXXXXXXXXXXXXXXXXXXXXXXXXXXXXXXXXXXXXXXXXXXXXXXXXXXXXXXXXXXXXXX--XXXXXXXXXXXXXXXXXXXXXXXXXXXXXXXXXXXXXX--XX--XXXXXXXXXXXX--XXXXXXXXXXXXX----
XXXXXXXXXXXXXXXXXXXXXXXXXXXXXXXXXXXXXXXXXXXXXXXXXXXXXXXXXXXXXXXXXXXXXXXXXXXXXXXX--XXXXXXXXXXXXXXXXXXXXXXXXXXXXXXXXXXXXXX--XX--XXXXXXXXXXXX--XXXXXXXXXXXXX----
