-------------------------------------------------------------------------------------------------------------------------------------------------------------
-------------------------------------------------------------------------------------------------------------------------------------------------------------
-------------------------------------------------------------------------------------------------------------------------------------------------------------
SSSSSSSSSSSSSSSSSSSSSSSSSSSSSSSSSSSSSSSSSSSSSSSSSSSSSSSSSSSSSSSSSSSSSSSSSSSSSSSS---SSSSSSSSSSSSSSSSSSSSSSSSSSSSSSSSSSSSSS-SSSSSSSSSSSSSSSS-----------SSSS----
SSSSSS--SSSS------SSSS----------SS--SSSSSS--SSSS---SSSSSS--SSSS------SSSSSSSSS-----S-------SSSSSS--SSS-------------------------------------------------------
SSSSSS--SSSS------SSSS----------SS--SSSSSS--SSSS---SSSSSS--SSSS------SSSSSSSSS-----S-------SSSSSS--SSS-------------------------------------------------------
----SS---S----SS--------------SS--------SS---S----S----SS---S----SS-------SSSS--------SS-------SS---S---------------------------------------SSS------------SS
----SS---S----SS--------------SS--------SS---S----S----SS---S----SS-------SSSS--------SS-------SS---S--------------------------------------------------------
----SS---S----SS--------------SS--------SS---S----S----SS---S----SS-------SSSS--------SS-------SS---S--------------------------------------------------------
ooooSS---SoU--SC--------------SS----ooooSS---SoU--SooooSS---SoU--SC----oooSSSS-----U--SC---ooooSS---So-------------------------------------------SSSS--------
SSSSSS---SSS--SS--SSSS---#-#--SSSS--SSSSSS---SSS--SSSSSSS---SSS--SS--SSSSSSSSS-----S--SS---SSSSSS---SS--T-----TT------------------------##-------------##----
-----------------------#-#-#----SS----------------------------------------------------------------------TT----TT-----------S-----------###------------###----
-----------------------#-#-#----SS----------------------------------------------------------------------TT----TT----TT-----S----------####--SSS------####--SF
---M--------gg---------#-#-#----------kkk---------------kkk-g-----------ggg------------------gg-ggg-----TT----TT----TT-----S-------gg#####-------r---####---#
XXXXXXXXXXXXXXXXXXXXXXXXXXXXXXXXXXXXXXXXXXXXXXXXXXXXXXXXXXXXXXXXXXXXXXXXXXXXXXXX---XXXXXXXXXXXXXXXXXXXXXXXXXXXXXXXXXXXXXX--X--XXXXXXXXXXXX-------XXXXXXXX----
XXXXXXXXXXXXXXXXXXXXXXXXXXXXXXXXXXXXXXXXXXXXXXXXXXXXXXXXXXXXXXXXXXXXXXXXXXXXXXXX---XXXXXXXXXXXXXXXXXXXXXXXXXXXXXXXXXXXXXX--X--XXXXXXXXXXXX-------XXXXXXXX----
