-------------------------------------------------------------------------------------------------------------------------------------------------------------
-------------------------------------------------------------------------------------------------------------------------------------------------------------
-------------------------------------------------------------------------------------------------------------------------------------------------------------
SSSSSSSSSSSSSSSSSSSSSSSSSSSSSSSSSSSSSSSSSSSSSSSSSSSSSSSSSSSSSSSSSSSSSSSSSSSSSSSSS-SSSSSSSSSSSSSSSSSSSSSSSSSSSSSSSSSSSSSSSSSSSSSSSSSSSSSSSS-------------------
SSSSS--SSSS----S----------------SS--SSSSSS--SSSSSS--SSSS------SSSSSSS------SSSS-------SS--SSSS---------------------------------------------------------------
SSSSS--SSSS----S----------------SS--SSSSSS--SSSSSS--SSSS------SSSSSSS------SSSS-------SS--SSSS---------------------------------------------------------------
---SS---S----SSS------------------------SS---S--SS---S----SS-----SS----SS----------oooSS---S----SS------------------------------------------SSS--------------
---SS---S----SSS------------------------SS---S--SS---S----SS-----SS----SS-------------SS---S----SS-----------------------------------------------------------
---SS---S----SSS------------------------SS---S--SS---S----SS-----SS----SS----------SSSSS---S----SS-----------------------------------------------------------
oooSS---SoU--SCS--------------C-----ooooSS---SooSS---SoU--SC-----SSoU--SC----------SSSSS---SoU--SC-----------------------------------------------SSSSSSU-----
SSSSS---SSS--SSS--------#-#-----SS--SSSSSS---SSSSS---SSS--SS--SSSSSSS--SS--SSSS-------SS---SSS--SS------------TT------------------------##-------------------
----------------------#-#-#-#---SS----------------------------------------------------------------------TT----TT-----------SS----------###-------------------
--------------------#-#-#-#-#---SS----------------------------------------------------------------------TT----TT----TT-----SS---------####--SSS-------------F
---M--------------#-#-#-#-#-#gE--------------------------k------------------------------------g---------TT----TT----TT-----SS--------#####------------------#
XXXXXXXXXXXXXXXXXXXXXXXXXXXXXXXXXXXXXXXXXXXXXXXXXXXXXXXXXXXXXXXXXXXXXXXXXXXXXXX---XXXXXXXXXXXXXXXXXXXXXXXXXXXXXXXXXXXXXXX--XX--XXXXXXXXXXX-------XXXXXXXX--X-
XXXXXXXXXXXXXXXXXXXXXXXXXXXXXXXXXXXXXXXXXXXXXXXXXXXXXXXXXXXXXXXXXXXXXXXXXXXXXXX---XXXXXXXXXXXXXXXXXXXXXXXXXXXXXXXXXXXXXXX--XX--XXXXXXXXXXX-------XXXXXXXX--XX
