-------------------------------------------------------------------------------------------------------------------------------------------------------------
-------------------------------------------------------------------------------------------------------------------------------------------------------------
-------------------------------------------------------------------------------------------------------------------------------------------------------------
SSSSSSSSSSSSSSSSSSSSSSSSSSSSSSSSSSSSSSSSSSSSSSSSSSSSSSSSSSSSSSSSSSSSSSSSSSSSSSSSSSSSSSSSSSSSSSSSSLSSSSSSSSSSSSSSSSSSSSSSSSSSSSSSSSSSSSSSSS------------------S
SSSSS--SSSS--------------------------SS--SSSSSS--SSSS----SS--SSSSSS--SSSS-----SS--SSSSSS--SS-----------------------------------------------------------------
SSSSS--SSSS--------------------------SS--SSSSSS--SSSS----SS--SSSSSS--SSSS-----SS--SSSSSS--SS-----------------------------------------------------------------
-SSSS---S---------------------------S--------SS---S----SS--------SS---S----SSS--------SS---Soooooo------------------------------------------SSS--------------
-SSSS---S---------------------------S--------SS---S----SS--------SS---S----SSS--------SS---S-----------------------------------------------------------------
-SSSS---S---------------------------S--------SS---S----SS--------SS---S----SSS--------SS---SSSSSSS-----------------------------------------------------------
oSSSS---SoU-------------------------S----ooooSS---SoU--SS----ooooSS---SoU--SCS----ooooSS---SSSSSSS-----------------------------------------------SSSSSSU-----
SSSSS---SSS---------------TT--------SSS--SSSSSS---SSS--SSSS--SSSSSS---SSS--SSSSS--SSSSSS---S--------------------------------------------##-------------------
--------------------TT----TT---------SS------------------SS-------------------SS-------------------------------TT----------SS----------###-------------------
--------------------TT----TT----TT---SS------------------SS-------------------SS-------------------------------TT---TT-----SS---------####--SSS-------------F
---M----------------TT----TT----TT-----------------------------------------------------------------------------TT---TT-----SS---------####------------------#
XXXXXXXXXXXXXXXXXXXXXXXXXXXXXXXXXXXXXXXXXXXXXXXXXXXXXXXXXXXXXXXXXXXXXXXXXXXXXXXXXXXXXXXXXXXXXXXXXXXXXXXXXXXXXXXXXXXXXXXXX--XX--XXXXXXXXXXX-------XXXXXXXX--XX
XXXXXXXXXXXXXXXXXXXXXXXXXXXXXXXXXXXXXXXXXXXXXXXXXXXXXXXXXXXXXXXXXXXXXXXXXXXXXXXXXXXXXXXXXXXXXXXXXXXXXXXXXXXXXXXXXXXXXXXXX--XX--XXXXXXXXXXX-------XXXXXXXX--XX
