-------------------------------------------------------------------------------------------------------------------------------------------------------------
-------------------------------------------------------------------------------------------------------------------------------------------------------------
-------------------------------------------------------------------------------------------------------------------------------------------------------------
SSSSSSSSSSSSLSSSSSSSSSSSSSSSSSSSSSSSSSSSSSSSSSSSSSSSSSSSSSSSSSSSSSSSSSSSSSSSSSSS---SSSSSSSSSSSSSSSSSSSSSSSSSSSSSSSSSSSSSS-SSSSSSSSSSSSSSSS--------------S-SSS
SSSSS--SSS----------------------SS--SSSSSS--SSSSSS--SSSS---SS--SSSSS--SSS-----SS---SSSSS--SSSS------SS-------------------------------------------------------
SSSSS--SSS----------------------SS--SSSSSS--SSSSSS--SSSS---SS--SSSSS--SSS-----SS---SSSSS--SSSS------SS-------------------------------------------------------
---SS---S-ooo---------------------------SS---S--SS---S----SSS---S-SS---S----SS--------SS---S----SS------------------------------------------SSS--------------
---SS---S-------------------------------SS---S--SS---S----SSS---S-SS---S----SS--------SS---S----SS-----------------------------------------------------------
---SS---S-SSS---------------------------SS---S--SS---S----SSS---S-SS---S----SS--------SS---S----SS-----------------------------------------------------------
oooSS---SoSSS-----------------------ooooSS---SoUSS---SoU--SSS---SoSS---So---SS-----oooSS---SoU--SC-----------------------------------------------SSSSSSU-----
SSSSS---SS----------------------SS--SSSSSS---SSSSS---SSS--SSS---SSSS---SS---SSSS---SSSSS---SSS--SS--SS--T-----TT------------------------##--------------#----
--------------------------TT----SS--------------------------------------------SS------------------------TT----TT-----------SS----------###--------------#--SS
--------------------------TT----SS--------------------------------------------SS------------------------TT----TT----TT-----SS---------####--SSS---------#--SF
---M--------gg------------TT----------kkk---------------kkk-g-----------ggg------------------gg-ggg-----TT----TT----TT-----SS------gg#####-------r------#--S#
XXXXXXXXXXXXXXXXXXXXXXXXXXXXXXXXXXXXXXXXXXXXXXXXXXXXXXXXXXXXXXXXXXXXXXXXXXXXXXXX---XXXXXXXXXXXXXXXXXXXXXXXXXXXXXXXXXXXXXX--XX--XXXXXXXXXXX-------XXXXXXXX--XX
XXXXXXXXXXXXXXXXXXXXXXXXXXXXXXXXXXXXXXXXXXXXXXXXXXXXXXXXXXXXXXXXXXXXXXXXXXXXXXXX---XXXXXXXXXXXXXXXXXXXXXXXXXXXXXXXXXXXXXX--XX--XXXXXXXXXXX-------XXXXXXXX--XX
