-------------------------------------------------------------------------------------------------------------------------------------------------------------
-------------------------------------------------------------------------------------------------------------------------------------------------------------
-------------------------------------------------------------------------------------------------------------------------------------------------------------
SSSSSSSSSSSSSSSSSSSSSSSSSSSSSSSSSSSSSSSSSSSSSSSSSSSSSSSSSSSSSSSSSSSSSSSSSSSSSSSSSSSSSSSSSSSSSSSSSSSSSSSSSSSSSSSSSSSSSSSSSSSSSSSSSSSSSSSSSS-SSSSSSSSSSSSSS-SSS
SSSSSS--SSSS-----------------------SSSSSS--SSSS------SSSSSSSSS--SSSSSSSSS--SSSS------SSS--SSSS------SSSS-----------------------------------------------------
SSSSSS--SSSS-----------------------SSSSSS--SSSS------SSSSSSSSS--SSSSSSSSS--SSSS------SSS--SSSS------SSSS-----------------------------------------------------
----SS---S-----------------------------SS---S----SS---------SS---S-----SS---S---------SS---S----SS-----------------------------------------------------------
----SS---S-----------------------------SS---S----SS---------SS---S-----SS---S---------SS---S----SS-----------------------------------------------------------
----SS---S-----------------------------SS---S----SS---------SS---S-----SS---S---------SS---S----SS-----------------------------------------------------------
ooooSS---SoU-----------------------ooooSS---SoU--SC------oooSS---SoooooSS---SoU------oSS---SoU--SC-----------------------------------------------------------
SSSSSS---SSS--------------TT-------SSSSSS---SSS--SS--SSSSSSSSS---SSSSSSSS---SSS------SSS---SSS--SS--SSSS------TT------------------------##-------------##----
--------------------TT----TT----------------------------------------------------------------------------------TT-----------S-----------###------------###--SS
--------------------TT----TT----TT----------------------------------------------------------------------------TT----TT-----S----------####-----------####--SF
---M----------------TT----TT----TT----------------------------------------------------------------------------TT----TT-----S---------#####----------#####--S#
XXXXXXXXXXXXXXXXXXXXXXXXXXXXXXXXXXXXXXXXXXXXXXXXXXXXXXXXXXXXXXXXXXXXXXXXXXXXXXXXX---XXXXXXXXXXXXXXXXXXXX---XXXXXXXXXXXXXX--X--XXXXXXXXXXXX---XXXXXXXXXXXX--XX
XXXXXXXXXXXXXXXXXXXXXXXXXXXXXXXXXXXXXXXXXXXXXXXXXXXXXXXXXXXXXXXXXXXXXXXXXXXXXXXXX---XXXXXXXXXXXXXXXXXXXX---XXXXXXXXXXXXXX--X--XXXXXXXXXXXX---XXXXXXXXXXXX--XX
