-------------------------------------------------------------------------------------------------------------------------------------------------------------
-------------------------------------------------------------------------------------------------------------------------------------------------------------
-------------------------------------------------------------------------------------------------------------------------------------------------------------
SSSSSSSSSSSSSSSSSSSSSSSSSSSSSSSSSSSSSSSSSSSSSSSSSSSSSSSSSSSSSSSSSSSSSSSSSSSSSSSSS-SSSSSSSSSSSSSSSSSSSSSSSSSSSSSSSSSSSSSSSSSSSSSSSSSSSSSSSS-------------------
SSSSSS--SSSS------SSSS--------------------------------SSS--SSSS--SSSS------SSSS---------SSSSS--SSSS------SS--------------------------------------------------
SSSSSS--SSSS------SSSS--------------------------------SSS--SSSS--SSSS------SSSS---------SSSSS--SSSS------SS--------------------------------------------------
----SS---S----SS-------------------------oooo-------SS-SS---S-----S----SS----------ooooo---SS---S----SS-------------------------------------SSS--------------
----SS---S----SS------------------------------------SS-SS---S-----S----SS------------------SS---S----SS------------------------------------------------------
----SS---S----SS-----------------------S-SSSS-U-----SS-SS---S-----S----SS----------SSSSS---SS---S----SS------------------------------------------------------
ooooSS---SoU--SC-------------C---------SoS--SoS-----SSoSS---SoU---SoU--SC----------SSSSSoooSS---SoU--SC------------------------------------------SSSSSSU-----
SSSSSS---SSS--SS--SSSS---#-------------SSS--SSS-----SSSSS---SSS---SSS--SS--SSSS---------SSSSS---SSS--SS--SS-----#-----------------------##-------------------
-------------------------#-#---#------------------------------------------------------------------------T------##---------SS-----------###-------------------
-------------------------#-#---#-#----------------------------------------------------------------------------###--TT-----SS----------####--SSS-------------F
---M---------------------#-#-g-#-#-----------------------k------------------------------------g--------------####--TT-----SS---------#####------------------#
XXXXXXXXXXXXXXXXXXXXXX--XXXXXXXXXXXXXXXXXXXXXXXXXXXXXXXXXXXXXXXXXXXXXXXXXXXXXXX---XXXXXXXXXXXXXXXXXXXXXXXXXXXXXXXXXXXXXX--XX--XXXXXXXXXXXX-------XXXXXXXX--X-
XXXXXXXXXXXXXXXXXXXXXX--XXXXXXXXXXXXXXXXXXXXXXXXXXXXXXXXXXXXXXXXXXXXXXXXXXXXXXX---XXXXXXXXXXXXXXXXXXXXXXXXXXXXXXXXXXXXXX--XX--XXXXXXXXXXXX-------XXXXXXXX--XX
