-------------------------------------------------------------------------------------------------------------------------------------------------------------
-------------------------------------------------------------------------------------------------------------------------------------------------------------
-------------------------------------------------------------------------------------------------------------------------------------------------------------
SSSSSSSSSSSSLSSSSSSSSSSSSSSSSSSSSSSSSSSSSSSSSSSSSSSSSSSSSSSSSSSSSSSSSSSSSSSSSSSS--SSSSSSLSSSSSSSLSSSSSSSSSSSSSSSSSSSSSSS-SSSSSSSSSSSSSSSSS-SSSSSSSSSSSSSS----
SSSS--SS-----------------------SS--SSSSSS--SSSSSS--SSSSSS--SSSS------S-----SSSS------------------------------------------------------------------------------
SSSS--SS-----------------------SS--SSSSSS--SSSSSS--SSSSSS--SSSS------S-----SSSS------------------------------------------------------------------------------
--SS---Sooooo-----------------S--------SS---S----------SS---S----SS----SS----------oooooo--oooooo----------------------------------------------------------SS
--SS---S----------------------S--------SS---S----------SS---S----SS----SS------------------------------------------------------------------------------------
--SS---SSSSSS-----------------S--------SS---S----------SS---S----SS----SS----------SSSSSS--SSSSSS------------------------------------------------------------
ooSS---SSSSSS-----------------S----ooooSS---SoU----ooooSS---SoU--SC----SC----------SSSSSS--SSSSSS------------------------------------------------------------
SSSS---S----------------------SSS--SSSSSS---SSSSS--SSSSSS---SSS--SS--S-SS--SSSS-------------------------------------TT------------------##-------------##----
--------------------------TT---SS--------------SS-------------------------------------------------------T-----TT----TT-----SS----------###------------###----
--------------------------TT---SS--------------SS-------------------------------------------------------------TT----TT-----SS---------####-----------####--SF
---M---------g------------TT-----------kk---------------kk----------------g-------------------g--g------------TT-g--TT-----SS--------#####-------r--#####---#
XXXXXXXXXXXXXXXXXXXXXXXXXXXXXXXXXXXXXXXXXXXXXXXXXXXXXXXXXXXXXXXXXXXXXXXXXXXXXXX---XXXXXXXXXXXXXXXXXXXXXXXXXXXXXXXXXXXXXX---XX--XXXXXXXXXXX---XXXXXXXXXXXX----
XXXXXXXXXXXXXXXXXXXXXXXXXXXXXXXXXXXXXXXXXXXXXXXXXXXXXXXXXXXXXXXXXXXXXXXXXXXXXXX---XXXXXXXXXXXXXXXXXXXXXXXXXXXXXXXXXXXXXX---XX--XXXXXXXXXXX---XXXXXXXXXXXX----
