SSSSSSSSSSSSSSSSSSSXXXSSSSSXXXXXXXXXXXXXXXXXXXXXXXXSSXXXXXXXXXXXXXXXXXXXXXXXXXSSL-SSSSSSSLSSSSSSSSSSSSSSSSSSSSSSSSSSSSSSSSSSSXXXXXXXXXXXXXXXXXXXXXXXXXXXXXXX-
-------------------------------------------------------------------------------------------------------------------------------------------------------------
-------------------------------------------------------------------------------------------------------------------------------------------------------------
SSSSSSSSSSSSSSSSSSSSSSSSSSSSSSSSSSSSSSSSSSSSSSSSSSSSSSSSSSSSSSSSSSSSSSSSSSSSSSSSS-SSSSSSSSSSSSSSSSSSSSSSSSSSSSSSSSSSSSSSSSSSSSSSSSSSSSSSSS-----SSSSSSSSSS----
SSSSS--SSSSSS--SSSS--------------------SSSSSSS--SSSS----SSSS--SSSSS--SSSS---SSS---SSSSSS--SSSS----SSS--------------SSSS-SSSS---------------------------------
SSSSS--SSSSSS--SSSS--------------------SSSSSSS--SSSS----SSSS--SSSSS--SSSS---SSS---SSSSSS--SSSS----SSS--------------SSSS-SSSS---------------------------------
---SS---S--SS---S-----------------------SS--SS---S----SS--SS---S-SS---S----S-SS---S---SS---S----SS------------------------------ooo---------SSS------------SS
---SS---S--SS---S-----------------------SS--SS---S----SS--SS---S-SS---S----S-SS---S---SS---S----SS-----------------------------------------------------------
---SS---S--SS---S-----------------------SS--SS---S----SS--SS---S-SS---S----S-SS---S---SS---S----SS------------------------------SSS--------------------------
oooSS---SoUSS---SoU--------------------oSSooSS---SoU--SCooSS---SoSS---SoU--SoSS---SoUoSS---SoU--SC------------------------------SSS--------------------------
SSSSS---SSSSS---SSS----##-------TT-----SSSSSSS---SSS--SSSSSS---SSSS---SSS--SSSS---SSSSSS---SSS--SSSSS----------##--SSSS-SSSS------------##-------------##----
----------------------###-TT----TT----------------------------------------------------------------------TT----###----------------------###------------###----
---------------------####-TT----TT----T-----------------------------------------------------------------TT----###---T-----------------####--SSS------####--SF
---M----------------#####-TT-g--TT----T------------------k------------------------------------g---------TT----###--------------------#####----------#####---#
XXXXXXXXXXXXXXXXXXXXXXXXXXXXXXXXXXXXXXXXXXXXXXXXXXXXXXXXXXXXXXXXXXXXXXXXXXXXXXXXX-XXXXXXXXXXXXXXXXXXXXXXXXXXXXXXXXXXXXX-XXXX---XXXXXXXXXXX-----XXXXXXXXXX----
XXXXXXXXXXXXXXXXXXXXXXXXXXXXXXXXXXXXXXXXXXXXXXXXXXXXXXXXXXXXXXXXXXXXXXXXXXXXXXXXX-XXXXXXXXXXXXXXXXXXXXXXXXXXXXXXXXXXXXX-XXXX---XXXXXXXXXXX-----XXXXXXXXXX----
