SSSSSSSSSSSSSSSSSSSSSS---------------------------------------------------------------------------------------------------------------------------------------
SSSSSSS--SSSS----SSSSS--SSSSSSSSSSSSSL---------SS----SSSSSSSSSSSS--------------------------------SSSSSSSSSSS-------------------SSSSSSSSSSSSSSS----SSSSSSSSSSS
SSSSSSS--SSSS-------SS--SSSS-------------------SSSSSS--SS--SSSSSS-------------SS--SSSSSSSSSSSSSSSSSSSSS--SSSSSSS---------------SSSSSS--SSSS------------------
SS---SS---S----SS---SSSSSSSS----------SSSSSSSSSSSSSSS--SS--SSSSSSSSSSSSSSSSSSSSS----SSSS-----SSSSSSSSSS--SSS----SSSSSSSS-SSSSSSSSSSSS--SSSS---SSSS-----------
SS---SS---S----SS---SS----------ooooooSSS--SSSSSSSSSSSS--------SSSSS--SSSS----SS----SSSS-----SSSS----SS---S---------------------S--SS---S----SSS-------------
-----SS---S----SSoooSS----------------SSS--SSSSSS--SSSS--------SSSSS--SSSS-----------S----SS---SS----SS---S---------------------S--SS---S----SSS-------------
SSoooSS---SoU--SCSSSSS----------SSSSSS-SS---S--SS--SSSS--------SS-SS---S----SS-------S----SS---SS----SS---S---------------------S--SS---S----S---------------
SSSSSSS---SSS--SS---------------SSSSSS-SS---S--SS--SSSS----ooooSS-SS---S----SS-------S----SS---SSooooSS---So--------------------SooSS---SoU--S---------------
SS----------------------SSSS-----------SS---S--SSooSSSSSS--SSSSSS-SS---S----SSoo-----SoU--SC-ooSSSSSSSS---SS--------------------SSSSS---SSS--S------#-#------
SS-------------------------------------SS---SoU--SSSS--SS--------oSS---SoU--SCSS-----SSS--SS-SSSS-------------------------------------------------#-#-#-#----
SS-------------------------------------SS---SSS--------SS--------SSS---SSS--SS--------------------------------SS------------------------------SS--#-#-#-#----
SSS-------------------SS--------------------------------------------------------------------------------T-----SS-----------SS---------------------#-#-#-#----
SSS-----------------##SSXXXX---XXXXXXX---------XX----XXXXXXXXXXXX--------------------------------XXXXXXXXXXX--SS----TT-----SS--XXXXXXXXXXXXXXX----XXXXXXX--XF
SSSM---------g-----###SSXXXX---XXXXXXX-kk------XXXXXXXXXkkXXXXXXX---------g---XX--XXXXXXXXXXXXgXXgXXXXXXXXXX--XX-g--TT-----SS--XXXXXXXXXXXXXXX---rXXXXXXX--X#
--XXXXXXXXXXXXXXX-####XXXXXXXXXXXXXXXXXSSXXXXXXXXXXXXXXXXXXXXXXXXXXXXXXXXXXXXXX------XXXXXXXXXXXXXXXXXXXXXXXXXXXXooooSS--------XXXXXXXXXXS--------XXXXXXX--SS
--XXXXXXXXXXXXXXX#####XXXXXXXXXXXXXXXXXSSXXXXXXXXXXXXXXXXXXXXXXXXXXXXXXXXXXXXXX------XXXXXXXXXXXXXXXXXXXXXXXXXXXXSSSSSS--------XXXXXXXXXXS--------XXXXXXX--SS
