SSSSSSSSSSSSSSSSSSSSSSSSSSSSSSSSSSSSSSS------------------SSSSSSSSSSSSSSSSSSSSSSSSSSSSSSSSSSSSSSSSSSSSSSSSSSSSSSSSSSSSSSSSSSSSSSSSSSSSSSSS---SSSSSSSSSSSSSS---
SSSSSS--SSSSSSSSS--SSSS--SSSS-SSSS--SSSSSSSSSSSSSSSSSSSSSSSSSS--SSSS-------SS--SSSSSSSSSSSSS--SSSSSSSS--SS------SSSS-SSS--SSSS--SSSSSS--SSSSSSSS------SSSSSSS
SSSSSS--SSSSSSSSS--SSSS--SSSS-SSSS--SSSSSS--SSSSSSSS--SSSSSSSS--SSSS-------SS--SSSSSSSSSSSSS--SSSSSSSS--SS------SSSS-SSS--SSSS--SSSSSS--SSSSSSSS------SSSSSS-
----SS---S-----SS---SSS---S-----SS---S-SSS--SSSSSSSS--SSS---SS---S----SS-SS--------SS-SS--SS---S----SS------SS-------SSS---S--------SS---SSSSS----SS------SS-
----SS---S-----SS---SSS---S-----SS---S--SS---S----SS---S----SS---S----SS-SS--------SS-SS--SS---S----SS------SS-------SSS---S--------SS------SS----SS---------
----SS---S-----SS---SSS---S-----SS---S--SS---S----SS---S----SS---S----SS-SS--------SS-SS--SS---S----SS------SS-------SSS---S--------SS------SS----SS---------
ooooSS---SoUoooSS---SSS---SoU-ooSS---So-SS---S----SS---S-oooSS---SoU--SC-SS----ooooSSoSSooSS---SooooSS--oU--SC-------SSS---SoU--ooooSS------SSoU--SC---------
SSSSSS---SSSSSSSS---SSS---SSS-SSSS---SSoSS---SoUooSS---SoSSSSS---SSS--SS-SSSS--SSSSSSSSSSSSS---SSSSSSS--SS--SS--SSSS-SSS---SSS--SSSSSS------SSSS--SS--SSSS---
---------------------------------------SSS---SSSSSSS---SS------------------SS------------------------------------------------------------SSS--------------SS-
---------------------------------------------------------------------------SS--------------------------------------------------------------------------------
-------------------------------------------------------------------------------------------------------------------------------------------------------------
#---------------------####-#---#------------------------------------------------------------------------TT----TT-----------------------#SS------------SS---S-
#-#-----------------######-#---#-#----------------------------------------TT----------------------------TT----TT----------------------##SS------------SS---SF
#-#M---------------#######-#-E-#-#----------------------------------------TT----------------------------TT----TT---------------T-----###SS------------SS---S#
XXXXXXXXXXXXXXXXXXXXXXXXXXXXXXXXXXXXXXXXXXXXXXXXXXXXXXXXXXXXXXXXXXXXXXXXXXXXXXXXX---XXXXXXXXXXXXXXXXXXXXXXXXXXXXXXXXXXX--------TXXXXXXXXSC--------ooooSS---So
XXXXXXXXXXXXXXXXXXXXXXXXXXXXXXXXXXXXXXXXXXXXXXXXXXXXXXXXXXXXXXXXXXXXXXXXXXXXXXXXX---XXXXXXXXXXXXXXXXXXXXXXXXXXXXXXXXXXX--------TXXXXXXXXSS-----S--SSSSSS---SS
