XXXXXXXXXXXXXXXXXXXXXXXXXXXXXXXXXXX----------------------------------------------------------------------SSSSSSSSSSSSSSSS-SS#-#-#-#-#--#-#-#-#-#-SSSSSSS####-
XXXXXXXXXXXXXXXXXXXXXXXXXXXXXXXXXXX------------SSS-------------S------------------------------------------SS----SSSS-SSS--SS#-#-#-#-#-E#-#-#-#-#-SSSS--S####-
-----------------------------------------------SSSSSSSSSSSSSSSSSSSSSSSSSSSSSSSSS---SSSSSSSSSSSSSSSSSSSSSS-SS----SSSS-SSS--SSXXXXXXXXXXXXXXXXXXXXXSSSS--SXXXX-
SSSSSSSSSSSSSSSSSSSSSSSSSSSSSSSSSSSSSSSSSSSSSSSSSSSSSSSS--SSSS-SSSSSSSSSS--SSSSS---SSSSSSSSSSSS--SSSSS--S-SSSS--------SS---SXXXXXXXXXXXXXXXXXXXXX--SS---SSSSS
SSSS--SSSSSS--SSS------------------SSSSSS--SSSS-SSSSSSSS--SSSS-SSSSSSSSSS--SSSSS---SSSSSSSSSSSS--SSSSS--SoSSSS--------SS---S---------------------------------
SSSS--SSSSSS--SSS------------------SSSSSS--SSSS-SS----SS---S---S--SS---SS---S--S----S--SS----SS---S-SS---SSSSS--------SS---S---------------------------------
SS--------SS---S-----------------------SS---S---SS----SS---S---S--SS---SS---S--S----S--SS----SS---S-SS------SC-------oSS---S----oooooo------SSS--------------
SS--------SS---S-----------------------SS---S--oSS----SS---S---S--SS---SS---S--S----S--SS----SS---S-SS------SS--SSSS-SSS---S---------------------------------
SS--------SS---S-----------------------SS---S--SSSooooSS---SoU-SooSSoooSS---SoUS----SooSSooooSS---SoSS--------------------------SSSSSS-----------------------
SS----ooooSS---So------------------ooooSS---SoU---SSSSSS---SSS--SSSSSSSSS---SSSS----SSSSSSSSSSS---SSSS--------------------------SSSSSS-----------------------
SSSS--SSSSSS---SS--------#-#-----##SSSSSS---SSS---------------------------------------------------------T------TT-----------------------##------------##-----
--SS-------------------#-#-#-#--###---------------------------------------------------------------------T------TT----------S-----------###-----------###---SS
--SS-----------------#-#-#-#-#-####------------XXX-------------X-----------------------------------------T-----TT---TT-----S----------####--SSS-----####---SF
---M--------gg-----#-#-#-#-#-#-####---kkk------XXXXXXXXXkkkXgXXXXXXXXXXXgggXXXXX---XXXXXXXXXXggXgggXXXXXXT-----TT---TT-----S-------gg-####-------r-#####---S#
XXXXXXXXXXXXXXXXXXXXXXXXXXXXXXXXXXXXXXXXXXXXXXXXXXXXXXXXXXXXXXXXXXXXXXXXXX-SSSS------SSSSXXXXXXXXXXXXXXXXXXXXXXXXXXXXXXXX--X---XXXXXXXXXXX------XXXXXXXXX--XX
XXXXXXXXXXXXXXXXXXXXXXXXXXXXXXXXXXXXXXXXXXXXXXXXXXXXXXXXXXXXXXXXXXXXXXXXXX-SSSS------SSSSXXXXXXXXXXXXXXXXXXXXXXXXXXXXXXXX--X---XXXXXXXXXXX------XXXXXXXXX--XX
