-------------------------------------------------------------------------------------------------------------------------------------------------------------
-------------------------------------------------------------------------------------------------------------------------------------------------------------
-------------------------------------------------------------------------------------------------------------------------------------------------------------
SSSSSSSSSSSSSSSSSSSSSSSSSSSSSSSSSSSSSSSSSSSSSSSSSSSSSSSSSSSSSSSSSSSSSSSSSSSSSSSSSSSSSSSSSSSSSSSSSSSSSSSSSSSSSSSSSSSSSSSSSSSSSSSSSSSSSSSSSS--------SSSSSSSSSSS
SSSSS--SSSS----------------------S--SSSSSS--SSSSS-SSSSSS--SSSS-SSSSSS-SSSS-SSS--SSSS-----S--SSSSSS--SSSS---------------S---S---------------------------------
SSSSS--SSSS----------------------S--SSSSSS--SSSSS-SSSSSS--SSSS-SSSSSS-SSSS-SSS--SSSS-----S--SSSSSS--SSSS---------------S---S---------------------------------
---SS---S----S--------------------------SS---S--------SS---S-------SS---SS--SS---S----SS--------SS---S--------------------------ooooo-------SSS--------------
---SS---S----S--------------------------SS---S--------SS---S-------SS---SS--SS---S----SS--------SS---S-------------------------------------------------------
---SS---S----S--------------------------SS---S--------SS---S-------SS---SS--SS---S----SS--------SS---S--------------------------SSSSS------------------------
oooSS---SoU--S----------------------ooooSS---SoU--ooooSS---SoU-ooooSS-ooSS-oSS---SoU--SC----ooooSS---SoU------------------------SSSSS------------S-----------
SSSSS---SSS--S--------##-TT------S--SSSSSS---SSS--SSSSSS---SSS-SSSSSS-SSSS-SSS---SSS--SS-S--SSSSSS---SSS------TT-------S---S------------##-------------------
---------------------###-TT------S-------------------------------------------------------S---------------T----TT-----------------------###-----------------S-
--------------------####-TT----TTS-------------------------------------------------------S---------------T----TT----TT----------------####--SSS-----TT-----SF
---M---------------#####-TT----TT------------------------------------------------------------------------T----TT----TT---------------#####----------TT-----S#
XXXXXXXXXXXXXXXXXXXXXXXXXXXXXXXXXXXXXXXXXXXXXXXXXXXXXXXXXXXXXXXXXXXXXXXXXXXXXXXXXXXXXXXXXXXXXXXXXXXXXXXXXXXXXXXXXXXXXXXX---X---XXXXXXXXXXX-------XXXXXXXX--XX
XXXXXXXXXXXXXXXXXXXXXXXXXXXXXXXXXXXXXXXXXXXXXXXXXXXXXXXXXXXXXXXXXXXXXXXXXXXXXXXXXXXXXXXXXXXXXXXXXXXXXXXXXXXXXXXXXXXXXXXX---X---XXXXXXXXXXX-------XXXXXXXX--XX
