-------------------------------------------------------------------------------------------------------------------------------------------------------------
-------------------------------------------------------------------------------------------------------------------------------------------------------------
-------------------------------------------------------------------------------------------------------------------------------------------------------------
SSSSSSSSSSSSSSSSSSSSSSSSSSSSSSSSSSSSSSSSSSSSSSSSSSSSSSSSSSSSSSSSSSSSSSSSSSSSSSSSSSSSSSSSSSSSSSSSSSSSSSSSSSSSSSSSSSSSSSSSSSSSSSSSSSSSSLSSSSSSSSSSSSSSS--------
SSSSS--SSSS----SS--SS--------------SSSSSS--SSSS---SSSSSS--SSSSS--SSSSSSSSSSSSS--SSSS-----SSSSS--SSS----------------------SSS---------------------------------
SSSSS--SSSS----SS--SS--------------SSSSSS--SSSS---SSSSSS--SSSSS--SSSSSSSSSSSSS--SSSS-----SSSSS--SSS----------------------SSS---------------------------------
---SS---S----SSSS---S---------------S--SS---S---------SS---S-SS---S---SS----SS---S----SS----SS---S------------------------------oooooo-----------------------
---SS---S----SSSS---S---------------S--SS---S---------SS---S-SS---S---SS----SS---S----SS----SS---S-----------------------------------------------------------
---SS---S----SSSS---S---------------S--SS---S---------SS---S-SS---S---SS----SS---S----SS----SS---S------------------------------SSSSSS-----------------------
oooSS---SoU--SCSS---S---------------SooSS---SoU---ooooSS---SoSS---SoooSSooooSS---SoU--SC--ooSS---So-----------------------------SSSSSS---------------SSSU----
SSSSS---SSS--SSSS---S----TT---------SSSSS---SSS---SSSSSS---SSSS---SSSSSSSSSSSS---SSS--SS--SSSS---SS-----------TT---------SSS---------------------------------
-------------------------TT-----------------------------------------------------------------------------TT----TT------------------------SS-------------------
-------------------------TT----TT-----------------------------------------------------------------------TT----TT----TT------------------SS----------#-------F
---M---------------------TT----TT-----------------------------------------------------------------------TT----TT----TT------------------SS---------##-------#
XXXXXXXXXXXXXXXXXXXXXXXXXXXXXXXXXXXXXXXXXXXXXXXXXXXXXXXXXXXXXXXXXXXXXXXXXXXXXXXXXXXXXXXXXXXXXXXXXXXXXXXXXXXXXXXXXXXXXXXXXXXX---XXXXXXXX-XX--XXXXXXXXXXXXXX--X
XXXXXXXXXXXXXXXXXXXXXXXXXXXXXXXXXXXXXXXXXXXXXXXXXXXXXXXXXXXXXXXXXXXXXXXXXXXXXXXXXXXXXXXXXXXXXXXXXXXXXXXXXXXXXXXXXXXXXXXXXXXX---XXXXXXXX-XX--XXXXXXXXXXXXXX--X
