-------------------------------------------------------------------------------------------------------------------------------------------------------------
-------------------------------------------------------------------------------------------------------------------------------------------------------------
-------------------------------------------------------------------------------------------------------------------------------------------------------------
SSSSSSSSSSSSSSSSSSSSSSSSSSSSSSSSSSSSSSSSSSSSSSSSSSSSSSSSSSSSSSSSSSSSSSSSSSSSSSSSSSSSSSSSSSSSSSSSSSSSSSSSSSSSSSSSSSSSSSSSSSSSSSSSSSSSSSSSSS----------------SSS
SSSSS--SSSSSSS--SSSS-----------------SSSS--SSSSS--SSSSSS--SSSS--SSSS---SS--SSSS---SSSSSS--SSSSSSSS--SS--------------------SS---------------------------------
SSSSS--SSSSSSS--SSSS-----------------SSSS--SSSSS--SSSSSS--SSSS--SSSS---SS--SSSS---SSSSSS--SSSSSSSS--SS--------------------SS---------------------------------
---SS---S---SS---S---------------------SS---S---------SS---S-S---S----SSS---S----S----SS---S----SS---S--------------------------ooooo-------SSS--------------
---SS---S---SS---S---------------------SS---S---------SS---S-S---S----SSS---S----S----SS---S----SS---S-------------------------------------------------------
---SS---S---SS---S---------------------SS---S---------SS---S-S---S----SSS---S----S----SS---S----SS---S--------------------------SSSSS------------------------
oooSS---SoooSS---SoU---------C-------ooSS---SoU---ooooSS---SoS---SoU--SSS---SoU--SooooSS---SooooSS---S--------------------------SSSSS------------SSSSSSU-----
SSSSS---SSSSSS---SSS---#-#-----------SSSS---SSSS--SSSSSS---SSS---SSS--SSS---SSS--SSSSSSS---SSSSSSS---S--------TT----------SS------------##-------------------
---------------------#-#-#-#---#---------------S--------------------------------------------------------------TT-----------------------###------------------S
---------------------#-#-#-#---#-#-------------S--------------------------------------------------------TT----TT----TT----------------####--SSS-------------F
---M-----------------#-#-#-#-E-#-#----------------------------------------------------------------------TT----TT----TT---------------#####------------------#
XXXXXXXXXXXXXXXXXXXXXXXXXXXXXXXXXXXXXXXXXXXXXXXXXXXXXXXXXXXXXXXXXXXXXXXXXXXXXXXXXXXXXXXXXXXXXXXXXXXXXXXXXXXXXXXXXXXXXXXXX-XX---XXXXXXXXXXX-------XXXXXXXX---X
XXXXXXXXXXXXXXXXXXXXXXXXXXXXXXXXXXXXXXXXXXXXXXXXXXXXXXXXXXXXXXXXXXXXXXXXXXXXXXXXXXXXXXXXXXXXXXXXXXXXXXXXXXXXXXXXXXXXXXXXX-XX---XXXXXXXXXXX-------XXXXXXXX---X
