-------------------------------------------------------------------------------------------------------------------------------------------------------------
-------------------------------------------------------------------------------------------------------------------------------------------------------------
-------------------------------------------------------------------------------------------------------------------------------------------------------------
SSSSSSSSSSSSSSSSSSSSSSSSSSSSSSSSSSSSSSSSSSSSSSSSSSSSSSSSSSSSSSSSSSSSSSSSSSSSSSSSSSSSSSSSSSSSSSSSSSSSSSSSSSSSSSSSSSSSSSSSSSSSSSSSSSSSSSSSSS-------SSSSSSSSSSSS
SSSSS--SSSSSS--SSS----------------------SSSSSS--SSSS-----SSSSS-SSSSSS--SSSSSSS--SSSS-SSSS--SSSSSSSS------SSSS------------------SSSSSS------------------------
SSSSS--SSSSSS--SSS----------------------SSSSSS--SSSS-----SSSSS-SSSSSS--SSSSSSS--SSSS-SSSS--SSSSSSSS------SSSS------------------SSSSSS------------------------
---SS---S-SSS---S---------------------------SS---S----SS----SS-----SS---S---SS---S-----SS---S---S----SS----------------------------SS-------SSS--------------
---SS---S-SSS---S---------------------------SS---S----SS----SS-----SS---S---SS---S-----SS---S---S----SS----------------------------SS------------------------
---SS---S-SSS---S---------------------------SS---S----SS----SS-----SS---S---SS---S-----SS---S---S----SS----------------------------SS------------------------
oooSS---SoSSS---So------------C---------ooooSS---SoU--SC--ooSS-ooooSS---SoUoSS---SoU-ooSS---SoU-SoU--SC------------------------ooooSS------------------------
SSSSS---SSSSS---SS------#-#-------------SSSSSS---SSS--SS--SSSS-SSSSSS---SSSSSS---SSS-SSSS---SSS-SSS--SS--SSSS-TT---------------SSSSSS---##-------------------
----------------------#-#-#-#---TT----------------------------------------------------------------------------TT-----------SS----------###-----------------SS
--------------------#-#-#-#-#---TT----------------------------------------------------------------------------TT----TT-----SS---------####--SSS-----TT-----SF
---M--------------#-#-#-#-#-#-E-TT----------------------------------------------------------------------------TT----TT-----SS--------#####----------TT-----S#
XXXXXXXXXXXXXXXXXXXXXXXXXXXXXXXXXXXXXXXXXXXXXXXXXXXXXXXXXXXXXXXXXXXXXXXXXXXXXXXXXXXXXXXXXXXXXXXXXXXXXXXXXXXXX-XXXXXXXXXXX--XX-XXXXXXXXXXXX-------XXXXXXXX--XX
XXXXXXXXXXXXXXXXXXXXXXXXXXXXXXXXXXXXXXXXXXXXXXXXXXXXXXXXXXXXXXXXXXXXXXXXXXXXXXXXXXXXXXXXXXXXXXXXXXXXXXXXXXXXX-XXXXXXXXXXX--XX-XXXXXXXXXXXX-------XXXXXXXX--XX
