-------------------------------------------------------------------------------------------------------------------------------------------------------------
-------------------------------------------------------------------------------------------------------------------------------------------------------------
-------------------------------------------------------------------------------------------------------------------------------------------------------------
SSSSSSSSSSSSSSSSSSSSSSSSSSSSSSSSSSSSSSSSSSSSSSSSSSSSSSSSSSSSSSSSSSSSSSSSSSSSSSSSSSSSSSSSSSSSSSSSSSSSSSSSSSSSSSSSSSSSSSSSSSSSSSSSSSSSSSSSSSSSS--------------SS
SSSSSS--SSSSSSS--SSS---------------------------SS--SSSSSS--SSSS---SSSS--SSSSSS--SSSS------SSSSSSS--SSSS-------------------------------SSSS-------------------
SSSSSS--SSSSSSS--SSS---------------------------SS--SSSSSS--SSSS---SSSS--SSSSSS--SSSS------SSSSSSS--SSSS-------------------------------SSSS-------------------
-SS-SS---S---SS---S----------------------oooo-S--------SS---S----S--SS------SS---S----SS-----SSSS----S----------------------------SS---------SSS-------------
-SS-SS---S---SS---S---------------------------S--------SS---S----S--SS------SS---S----SS-----SSSS----S----------------------------SS-------------------------
-SS-SS---S---SS---S--------------------S-SSSS-S--------SS---S----S--SS------SS---S----SS-----SSSS----S----------------------------SS-------------------------
oSSoSS---SoUoSS---So---------C---------SoS--SoS----ooooSS---SoU--SooSS--ooooSS---SoU--SC----oSSSS----So---------------------------SC--------------SSSSSSU----
SSSSSS---SSSSSS---SS---#-#-------------SSS--SSSSS--SSSSSS---SSS--SSSSS--SSSSSS---SSS--SS--SSSSSSS----SS-------TT------------------SS--SSSS-------------------
----------------------##-#-#---#---------------SS-------------------------------------------------------TT----TT-----------SS-------------------------------S
---------------------###-#-#---#-#-------------SS-------------------------------------------------------TT----TT----TT-----SS----------------SSS------------F
---M----------------####-#-#-E-#-#----------------------------------------------------------------------TT----TT----TT-----SS-------------------------------#
XXXXXXXXXXXXXXXXXXXXXXXXXXXXXXXXXXXXXXXXXXXXXXXXXXXXXXXXXXXXXXXXXXXXXXXXXXXXXXXXXXXXXXXXXXXXXXXXXXXXXXXXXXXXXXXXXXXXXXXXX--XX--XXXXXXXXXXX--------XXXXXXXX--X
XXXXXXXXXXXXXXXXXXXXXXXXXXXXXXXXXXXXXXXXXXXXXXXXXXXXXXXXXXXXXXXXXXXXXXXXXXXXXXXXXXXXXXXXXXXXXXXXXXXXXXXXXXXXXXXXXXXXXXXXX--XX--XXXXXXXXXXX--------XXXXXXXX--X
