-------------------------------------------------------------------------------------------------------------------------------------------------------------
-------------------------------------------------------------------------------------------------------------------------------------------------------------
-------------------------------------------------------------------------------------------------------------------------------------------------------------
SSSSSSSSSSSSSSSSSSSSSSSSSSSSSSSSSSSSSSSSSSSSSSSSSSSSSSSSSSSSSSSSSSSSSSSSSSSSSSSSSSSSSSSSSSSSSSSSSSSSSSSSSSSSSSSSSSSSSSSSSSSSSSSSSSSSSSSSSS-------------------
--SS--SSSSSS--SS-------------------SSSSSS--SSSS---SSSSSS--SSSS---SSS--SSSS----SS--SSSSSS--SSSS---------------------------------SSSSSS------------------------
--SS--SSSSSS--SS-------------------SSSSSS--SSSS---SSSSSS--SSSS---SSS--SSSS----SS--SSSSSS--SSSS---------------------------------SSSSSS------------------------
SS--------SS---S-----------------------SS---S---------SS---S----S-SS---S----SS--------SS---S---------------------------------------SS-------SSS--------------
SS--------SS---S-----------------------SS---S---------SS---S----S-SS---S----SS--------SS---S---------------------------------------SS------------------------
SS--------SS---S-----------------------SS---S---------SS---S----S-SS---S----SS--------SS---S---------------------------------------SS------------------------
SS----ooooSS---S-------------------ooooSS---SoU---ooooSS---SoU--SoSS---SoU--SS----ooooSS---SoU---------------------------------ooooSS------------SSSSSSU-----
SSSS--SSSSSS---S----------TT-------SSSSSS---SSS---SSSSSS---SSS--SSSS---SSS--SSSS--SSSSSS---SSS----------------TT---------------SSSSSS---##-------------------
--SS----------------TT----TT--------------------------------------------------SS------------------------TT----TT-----------SS----------###-------------------
--SS----------------TT----TT----TT--------------------------------------------SS------------------------TT----TT----TT-----SS---------####--SSS-------------F
---M----------------TT----TT----TT----------------------------------------------------------------------TT----TT----TT-----SS---------####------------------#
XXXXXXXXXXXXXXXXXXXXXXXXXXXXXXXXXXXXXXXXXXXXXXXXXXXXXXXXXXXXXXXXXXXXXXXXXXXXXXXXXXXXXXXXXXXXXXXXXXXXXXXXXXXXXXXXXXXXXXXXX--XX--XXXXXXXXXXX-------XXXXXXXX--X-
XXXXXXXXXXXXXXXXXXXXXXXXXXXXXXXXXXXXXXXXXXXXXXXXXXXXXXXXXXXXXXXXXXXXXXXXXXXXXXXXXXXXXXXXXXXXXXXXXXXXXXXXXXXXXXXXXXXXXXXXX--XX--XXXXXXXXXXX-------XXXXXXXX--XX
