-------------------------------------------------------------------------------------------------------------------------------------------------------------
-------------------------------------------------------------------------------------------------------------------------------------------------------------
-------------------------------------------------------------------------------------------------------------------------------------------------------------
SSSSSSSSSSSSSSSSSSSSSSSSSSSSSSSSSSSSSSSSSSSSSSSSSSSSSSSSSSSSSSSSSSSSSSSSSSSSSSSSSSSSSSSSSSSSSSSSSSSSSSSSSSSSSSSSSSSSSSSSSSSSSSSSSSSSSLSSSSSSSSSSSSSSSSSSSSSSS
SSSSS--SSSS------SSS----------------SS--SSSSSS--SSSS-----SSSS--SSSS--SSSS---SSSSS--SSSSS--SSSS------SS-S-----------------------------------------------------
SSSSS--SSSS------SSS----------------SS--SSSSSS--SSSS-----SSSS--SSSS--SSSS---SSSSS--SSSSS--SSSS------SS-S-----------------------------------------------------
---SS---S----SS-----------------------------SS---S----SS---SS---SSS---S----S---SS---S-SS---S----SS------------------------------oooooo-----------------------
---SS---S----SS-----------------------------SS---S----SS---SS---SSS---S----S---SS---S-SS---S----SS-----------------------------------------------------------
---SS---S----SS-----------------------------SS---S----SS---SS---SSS---S----S---SS---S-SS---S----SS------------------------------SSSSSS-----------------------
oooSS---SoU--SC-------------------------ooooSS---SoU--SC--oSS---SSS---SoU--SoooSS---SoSS---SoU--SC------------------------------SSSSSS-----------------------
SSSSS---SSS--SS--SSS-----TT---------SS--SSSSSS---SSS--SS--SSS---SSS---SSS--SSSSSS---SSSS---SSS--SS--SS--------TT---------------------------------------------
--------------------T----TT-----TT--SS------------------------------------------------------------------------TT-----------S-------------------------------SS
--------------------T----TT-----TT--SS------------------------------------------------------------------TT----TT----TT-----S------------------------TT-----SF
---M----------------T----TT-----TT----------------------------------------------------------------------TT----TT----TT-----S------------------------TT-----S#
XXXXXXXXXXXXXXXXXXXXXXXXXXXXXXXXXXXXXXXXXXXXXXXXXXXXXXXXXXXXXXXXXXXXXXXXXXXXXXXXXXXXXXXXXXXXXXXXXXXXXXXXXXXXXXXXXXXXXXXXX--X---XXXXXXXXXXXXX-----XXXXXXXX--XX
XXXXXXXXXXXXXXXXXXXXXXXXXXXXXXXXXXXXXXXXXXXXXXXXXXXXXXXXXXXXXXXXXXXXXXXXXXXXXXXXXXXXXXXXXXXXXXXXXXXXXXXXXXXXXXXXXXXXXXXXX--X---XXXXXXXXXXXXX-----XXXXXXXX--XX
