-------------------------------------------------------------------------------------------------------------------------------------------------------------
-------------------------------------------------------------------------------------------------------------------------------------------------------------
-------------------------------------------------------------------------------------------------------------------------------------------------------------
SSSSSSSSSSSSSSSSSSSSSSSSSSSSSSSSSSSSSSSSSSSSSSSSSSSSSSSSSSSSSSSSSSSSSSSSSSSSSSSSSSSSSSSSSSSSSSSSSSSSSSSSSSSSSSSSSSSSSSSSSSSSSSSSSSSSSSSSSS-------------------
SSSSS--SSSS------SS-------------------SS--SSSSSS--SSSSSS--SSSS---SSS--SSSS----SS-------SS--SSSSSS--SS----------------------S---------------------------------
SSSSS--SSSS------SS-------------------SS--SSSSSS--SSSSSS--SSSS---SSS--SSSS----SS-------SS--SSSSSS--SS----------------------S---------------------------------
---SS---S----SS---------------------SS--------SS---S--SS---S----S-SS---S----SS------oooSS---S--SS---S----------------------S----------------SSS--------------
---SS---S----SS---------------------SS--------SS---S--SS---S----S-SS---S----SS---------SS---S--SS---S----------------------S---------------------------------
---SS---S----SS---------------------SS--------SS---S--SS---S----S-SS---S----SS------SSSSS---S--SS---S----------------------S---------------------------------
oooSS---SoU--SC---------------------SS----ooooSS---SooSS---SoU--SoSS---SoU--SC------SSSSS---SooSS---S----------------------S----------------------SSSSSSU----
SSSSS---SSS--SS--SS----#--##-----#--SSSS--SSSSSS---SSSSS---SSS--SSSS---SSS--SSSS-------SS---SSSSS---S---------TT-----------S------------##-------------------
----------------------##-###----##----SS----------------------------------------------------------------TT----TT-----------S-----------###-------------------
---------------------#######---###----SS----------------------------------------------------------------TT----TT----TT-----S----------####--SSS-------------F
---M----------------########--####----------------------------------------------------------------------TT----TT----TT-----S---------#####------------------#
XXXXXXXXXXXXXXXXXXXXXXXXXXXXXXXXXXXXXXXXXXXXXXXXXXXXXXXXXXXXXXXXXXXXXXXXXXXXXXXX---XXXXXXXXXXXXXXXXXXXXXXXXXXXXXXXXXXXXXX--X--XXXXXXXXXXXX--------XXXXXXXX--X
XXXXXXXXXXXXXXXXXXXXXXXXXXXXXXXXXXXXXXXXXXXXXXXXXXXXXXXXXXXXXXXXXXXXXXXXXXXXXXXX---XXXXXXXXXXXXXXXXXXXXXXXXXXXXXXXXXXXXXX--X--XXXXXXXXXXXX--------XXXXXXXX--X
