-------------------------------------------------------------------------------------------------------------------------------------------------------------
-------------------------------------------------------------------------------------------------------------------------------------------------------------
-------------------------------------------------------------------------------------------------------------------------------------------------------------
SSSSSSSSSSSLSSSSSSSSSSSSSSSSSSSSSSSSSSSSSSSSSSSSSSSSSSSSSSSSSSSSSSSSSSSSSSSSSSSSSSSSSSSSLSSSSSSSSSSSSSSSSSSSSSSSSSSSSSSSSSSSSSSSSSSSSSSSSS------------------S
SSSS----------------------------SS--SSSSSS--SSSS-SSSSSSSS--SSSS---SSS------SSSS------------SSS--SSS----------------------------------------------------------
SSSS----------------------------SS--SSSSSS--SSSS-SSSSSSSS--SSSS---SSS------SSSS------------SSS--SSS----------------------------------------------------------
--SS--oooooo------------------SS--------SS---S-------SSSS---S----S-SS--SS----------oooooo---SS---S------------------------------------------SSS--------------
--SS--------------------------SS--------SS---S-------SSSS---S----S-SS--SS-------------------SS---S-----------------------------------------------------------
--SS--SSSSSS------------------SS--------SS---S-------SSSS---S----S-SS--SS----------SSSSSS---SS---S-----------------------------------------------------------
ooSS--SSSSSS------------------SS----ooooSS---SoU-ooooSSSS---SoU--SoSS--SC----------SSSSSS--oSS---S-----------------------------------------------SSSSSSU-----
SSSS--------------------------SSSS--SSSSSS---SSS-SSSSSSSS---SSS--SSSS--SS--SSSS------------SSS---S------------TT------------------------##-------------------
-------------------------TT-----SS----------------------------------------------------------------------TT----TT-----------SS----------###-------------------
-------------------------TT-----SS----------------------------------------------------------------------TT----TT----TT-----SS---------####--SSS-------------F
---M---------------------TT-----------------------------------------------------------------------------TT----TT----TT-----SS--------#####------------------#
XXXXXXXXXXXXXXXXXXXXXXXXXXXXXXXXXXXXXXXXXXXXXXXXXXXXXXXXXXXXXXXXXXXXXXXXXXXXXXX---XXXXXXXXXXXXXXXXXXXXXXXXXXXXXXXXXXXXXXX--XX--XXXXXXXXXXX-------XXXXXXXX--XX
XXXXXXXXXXXXXXXXXXXXXXXXXXXXXXXXXXXXXXXXXXXXXXXXXXXXXXXXXXXXXXXXXXXXXXXXXXXXXXX---XXXXXXXXXXXXXXXXXXXXXXXXXXXXXXXXXXXXXXX--XX--XXXXXXXXXXX-------XXXXXXXX--XX
