-------------------------------------------------------------------------------------------------------------------------------------------------------------
-------------------------------------------------------------------------------------------------------------------------------------------------------------
-------------------------------------------------------------------------------------------------------------------------------------------------------------
SSSSSSSSSSSSSSSSSSSSSSSSSSSSSSSSSSSSSSSSSSSSSSSSSSSSSSSSSSSSSSSSSSSSSSSSSSSSSSSSSSSSSSSSSSSSSSSSSSSSSSSSSSSSSSSSSSSSSSSSSSSSSSSSSSSSSSSSSS-------SSSSSSSSSSSS
--SS--SSSSSS--SSS------------------------SSSSSS--SSSSSSSSSSSSS--SSSS--SSSS------SSSSSSSS--SSSS------SSSS------------SSS--------------------------------------
--SS--SSSSSS--SSS------------------------SSSSSS--SSSSSSSSSSSSS--SSSS--SSSS------SSSSSSSS--SSSS------SSSS------------SSS--------------------------------------
SS--------SS---S-----------------------------SS-------SS----SS---S-S---S----SS--------SS---S----SS----------o--------S----------------------SSS--------------
SS--------SS---S-----------------------------SS-------SS----SS---S-S---S----SS--------SS---S----SS-------------------S---------------------------------------
SS--------SS---S-----------------------------SS-------SS----SS---S-S---S----SS--------SS---S----SS----------S--------S---------------------------------------
SS----ooooSS---So------------------------ooooSS---ooooSSooooSS---SoS---SoU--SC------ooSS---SoU--SC----------S--------So--------------------------------------
SSSS--SSSSSS---SS-------#-#--------------SSSSSS---SSSSSSSSSSSS---SSS---SSS--SS--SSSSSSSS---SSS--SS--SSSS------TT-----SS-----------------##-------------------
--SS------------------#-#-#-----------------------------------------------------------------------------------TT----------SS-----------###-----------------SS
--SS----------------#-#-#-#-----------------------------------------------------------------------------------TT----------SS----------####--SSS-----TT-----SF
---M--------------#-#-#-#-#-----------------------------------------------------------------------------------TT----------SS---------#####----------TT-----S#
XXXXXXXXXXXXXXXXXXXXXXXXXXXXXXXXXXXXXXXXXXXXXXXXXXXXXXXXXXXXXXXXXXXXXXXXXXXXXXXXXXXXXXXXXXXXXXXXXXXXXXXX---XXXXXXXXXXXXX--XX--XXXXXXXXXXXX-------XXXXXXXX--XX
XXXXXXXXXXXXXXXXXXXXXXXXXXXXXXXXXXXXXXXXXXXXXXXXXXXXXXXXXXXXXXXXXXXXXXXXXXXXXXXXXXXXXXXXXXXXXXXXXXXXXXXX---XXXXXXXXXXXXX--XX--XXXXXXXXXXXX-------XXXXXXXX--XX
