-------------------------------------------------------------------------------------------------------------------------------------------------------------
-------------------------------------------------------------------------------------------------------------------------------------------------------------
-------------------------------------------------------------------------------------------------------------------------------------------------------------
SSSSSSSSSSSSSSSSSSSSSSSSSSSSSSSSSSSSSSSSSSSSSSSSSSSSSSSSSSSSSSSSSSSSSSSSSSSSSSSSSSSSSSSSSSSSSSSSSSSSSSSSSSSSSSSSSSSSSSSSSSSSSSSSSSSSSSSSSS-----------------SS
SSSSSS--SSSS------SSSS-------------------SSSSSS--SSSS------SSSS-SSS--SSSS----SSS------SSSS--SSSSSS--SSSS-----------------------------------------------------
SSSSSS--SSSS------SSSS-------------------SSSSSS--SSSS------SSSS-SSS--SSSS----SSS------SSSS--SSSSSS--SSSS-----------------------------------------------------
-SS-SS---S----SS-----------------------------SS---S----SS--------SS---S----SS-SS----ooSS--------SS---S--------------------------------------SSS--------------
-SS-SS---S----SS-----------------------------SS---S----SS--------SS---S----SS-SS------SS--------SS---S-------------------------------------------------------
-SS-SS---S----SS-----------------------S-----SS---S----SS--------SS---S----SS-SS----SSSS--------SS---S-------------------------------------------------------
oSSoSS---SoU--SC-------------C---------S-ooooSS---SoU--SC-------oSS---SoU--SCoSS----SSSS----ooooSS---SoU-----------------------------------------SSSSSSU-----
SSSSSS---SSS--SS--SSSS---#-------------S-SSSSSS---SSS--SS--SSSS-SSS---SSS--SSSSS------SSSS--SSSSSS---SSS------TT------------------------##-------------------
-------------------------#-#---#--------------------------------------------------------SS--------------------TT----------SS-----------###------------------S
-------------------------#-#---#-#------------------------------------------------------SS--------------------TT----T-----SS----------####--SSS-------------F
---M---------------------#-#-E-#-#----------------------------------------------------------------------------TT----T-----SS---------#####------------------#
XXXXXXXXXXXXXXXXXXXXXX---XXXXXXXXXXXXXXXXXXXXXXXXXXXXXXXXXXXXXX-XXXXXXXXXXXXXXXX---XXXXXXXXXXXXXXXXXXXXXXXXXXXXXXXXXXXXX--XX--XXXXXXXXXXXX-------XXXXXXXX---X
XXXXXXXXXXXXXXXXXXXXXX---XXXXXXXXXXXXXXXXXXXXXXXXXXXXXXXXXXXXXX-XXXXXXXXXXXXXXXX---XXXXXXXXXXXXXXXXXXXXXXXXXXXXXXXXXXXXX--XX--XXXXXXXXXXXX-------XXXXXXXX---X
