-------------------------------------------------------------------------------------------------------------------------------------------------------------
-------------------------------------------------------------------------------------------------------------------------------------------------------------
-------------------------------------------------------------------------------------------------------------------------------------------------------------
SSSSSSSSSSSSSSSSSSSSSSSSSSSSSSSSSSSSSSSSSSSSSSSSSSSSSSSSSSSSSSSSSSSSSSSSSSSSSSSSSSSSSSSSSSSSSSSSLSSSSSSSSSSSSSSSSSSSSSSSSSSSSSSSSSSSSSSSSS---SSS-------------
--SS--SSSSSS--SSSS-----------------------------SS--SSSSSS--SSSS--SSSS------SSSS------------------------------------------------------------------------------
--SS--SSSSSS--SSSS-----------------------------SS--SSSSSS--SSSS--SSSS------SSSS------------------------------------------------------------------------------
SS--------SS---S-------------------------ooooSS--------SS---S-----S----SS----------ooooo---oooooo-------------------------------------------S----------------
SS--------SS---S-----------------------------SS--------SS---S-----S----SS------------------------------------------------------------------------------------
SS--------SS---S-----------------------S-SSSSSS--------SS---S-----S----SS----------SSSSS---SSSSSS------------------------------------------------------------
SS----ooooSS---SoU-----------C---------SoS--SSS----ooooSS---SoU---SoU--SC----------SSSSS---SSSSSS-------------------------------------------------SSSSSSU----
SSSS--SSSSSS---SSS-----#-#-------------SSS--SSSSS--SSSSSS---SSS---SSS--SS--SSSS---------------------------------------------------------##-------------------
--SS-----------------#-#-#-#---#---------------SS-------------------------------------------------------------TT----------SS-----------###-------------------
--SS---------------#-#-#-#-#---#-#-------------SS-------------------------------------------------------------TT---TT-----SS----------####--S---------------F
---M---------------#-#-#-#-#-E-#-#----------------------------------------------------------------------------TT---TT-----SS---------#####------------------#
XXXXXXXXXXXXXXXXXXXXXXXXXXXXXXXXXXXXXXXXXXXXXXXXXXXXXXXXXXXXXXXXXXXXXXXXXXXXXXX---XXXXXX--XXXXXXXXXXXXXXXXXXXXXXXXXXXXXX--XX--XXXXXXXXXXXX--------XXXXXXXX--X
XXXXXXXXXXXXXXXXXXXXXXXXXXXXXXXXXXXXXXXXXXXXXXXXXXXXXXXXXXXXXXXXXXXXXXXXXXXXXXX---XXXXXX--XXXXXXXXXXXXXXXXXXXXXXXXXXXXXX--XX--XXXXXXXXXXXX--------XXXXXXXX--X
