-------------------------------------------------------------------------------------------------------------------------------------------------------------
-------------------------------------------------------------------------------------------------------------------------------------------------------------
-------------------------------------------------------------------------------------------------------------------------------------------------------------
SSSSSSSSSSSLSSSSSSSSSSSSSSSSSSSSSSSSSSSSSSSSSSSSSSSSSSSSSSSSSSSSSSSSSSSSSSSSSSSSSSSSSSSSSSSSSSSSSSSSSSSSSSSSSSSSSSSSSSSSSSSSSSSSSSSSSSSSSS-------SSSSSSSSSSSS
SSSS------------------------------------SSSSSS--SSSS------SSSSSS--SSSSSSS------SSSS--SSSS--SSS---------------------------------------------------------------
SSSS------------------------------------SSSSSS--SSSS------SSSSSS--SSSSSSS------SSSS--SSSS--SSS---------------------------------------------------------------
--SS--oooooo--------------------------------SS---S----SS------SS---S--S----SS----------SS---S-----------------------------------------------SSS--------------
--SS----------------------------------------SS---S----SS------SS---S--S----SS----------SS---S----------------------------------------------------------------
--SS--SSSSSS--------------------------------SS---S----SS------SS---S--S----SS----------SS---S----------------------------------------------------------------
ooSS--SSSSSS----------------------------ooooSS---SoU--SC------SS---So-SoU--SC--------ooSS---So---------------------------------------------------------------
SSSS------------------------------------SSSSSS---SSS--SS--SSSSSS---SS-SSS--SS--SSSS--SSSS---SS----------------TT------------------------##-------------------
-------------------------TT-----TT----------------------------------------------------------------------TT----TT----------SS-----------###-----------------S-
-------------------------TT-----TT----------------------------------------------------------------------TT----TT----T-----SS----------####--SSS-----TT-----SF
---M---------------------TT-----TT----------------------------------------------------------------------TT----TT----T-----SS---------#####----------TT-----S#
XXXX-XXXXXXXXXXXXXXXXXXXXXXXXXXXXXXXXXXXXXXXXXXXXXXXXXXXXXXXXXXXXXXXXXXXXXXXXXXXXXX--XXXXXXXXXXXXXXXXXXXXXXXXXXXXXXXXXXX--XX--XXXXXXXXXXXX-------XXXXXXXX--XX
XXXX-XXXXXXXXXXXXXXXXXXXXXXXXXXXXXXXXXXXXXXXXXXXXXXXXXXXXXXXXXXXXXXXXXXXXXXXXXXXXXX--XXXXXXXXXXXXXXXXXXXXXXXXXXXXXXXXXXX--XX--XXXXXXXXXXXX-------XXXXXXXX--XX
