-------------------------------------------------------------------------------------------------------------------------------------------------------------
-------------------------------------------------------------------------------------------------------------------------------------------------------------
-------------------------------------------------------------------------------------------------------------------------------------------------------------
SSSSSSSSSSSSSSSSSSSSSSSSSSSSSSSSSSSSSSSSSSSSSSSSSSSSSSSSSSSSSSSSSSSSSSSSSSSSSSSSSSSSSSSSSSLSSSSSSSSSSSSSSSSSSSSSSSSSSSSSSSSSSSSSSSSSSLSSSSSSSSSSSSSSS--------
--SS--SSSSSS--SS-------------------------------SS--SSSSSS--SSSS--SSSSSSSS--SSSS-------------------------------------SSSS-------------------------------------
--SS--SSSSSS--SS-------------------------------SS--SSSSSS--SSSS--SSSSSSSS--SSSS-------------------------------------SSSS-------------------------------------
SS--------SS---S-------------------------ooooSS--------SS---SSS---S----SS---S--------oooooo-------------------------------------oooooo-----------------------
SS--------SS---S-----------------------------SS--------SS---SSS---S----SS---S--------------------------------------------------------------------------------
SS--------SS---S-----------------------S-SSSSSS--------SS---SSS---S----SS---S--------SSSSSS-------------------------------------SSSSSS-----------------------
SS----ooooSS---S-------------C---------SoS--SSS----ooooSS---SSS---SooooSS---SoU------SSSSSS-------------------------------------SSSSSS---------------SSU-----
SSSS--SSSSSS---S-------#-#-------------SSS--SSSSS--SSSSSS---SSS---SSSSSSS---SSS-------------------------------TT----SSSS-------------------------------------
--SS-----------------#-#-#-#---#---------------SS-------------------------------------------------------TT----TT-----------S-----------------------TT--------
--SS---------------#-#-#-#-#---#-#-------------SS-------------------------------------------------------TT----TT-----------S-----------------------TT-------F
---M-------------#-#-#-#-#-#-E-#-#----------------------------------------------------------------------TT----TT-----------S-----------------------TT-------#
XXXXXXXXXXXXXXXXXXXXXXXXXXXXXXXXXXXXXXXXXXXXXXXXXXXXXXXXXXXXXXXXXXXXXXXXXXXXXXXXX---XXXXXXXXXXXXXXXXXXXXXXXXXXXXXXXXXXXX---X---XXXXXXXXXXXXXXXXXXXXXXXXXX--X-
XXXXXXXXXXXXXXXXXXXXXXXXXXXXXXXXXXXXXXXXXXXXXXXXXXXXXXXXXXXXXXXXXXXXXXXXXXXXXXXXX---XXXXXXXXXXXXXXXXXXXXXXXXXXXXXXXXXXXX---X---XXXXXXXXXXXXXXXXXXXXXXXXXX--XX
