-------------------------------------------------------------------------------------------------------------------------------------------------------------
-------------------------------------------------------------------------------------------------------------------------------------------------------------
-------------------------------------------------------------------------------------------------------------------------------------------------------------
SSSSSSSSSSSSSSSSSSSSSSSSSSSSSSSSSSSSSSSSSSSSSSSSSSSSSSSSSSSSSSSSSSSSSSSSSSSSSSSSSSSSSSSSSSSSSSSSSSSSSSSSSSSSSSSSSSSSSSSSSSSSSSSSSSSSSSSSSS-------------------
SSSSS--SSSS------SSSS------------------SS--SSSSSSS--SSSS--SSSS--SSSSSS------SSSS--------SSSSS--SSSS------SSSS------------------------------------------------
SSSSS--SSSS------SSSS------------------SS--SSSSSSS--SSSS--SSSS--SSSSSS------SSSS--------SSSSS--SSSS------SSSS------------------------------------------------
---SS---S----SS------------------------SS---S---SS---S------SS---S-S----SS----------oooo---SS---S----SS-------------------------------------SSS--------------
---SS---S----SS------------------------SS---S---SS---S------SS---S-S----SS-----------------SS---S----SS------------------------------------------------------
---SS---S----SS------------------------SS---S---SS---S------SS---S-S----SS----------SSSS---SS---S----SS------------------------------------------------------
oooSS---SoU--SC------------------------SS---SoUoSS---SoU--ooSS---SoSoU--SC----------SSSSoooSS---SoU--SC------------------------------------------SSSSSSU-----
SSSSS---SSS--SS--SSSS-----------TT-----SS---SSSSSS---SSS--SSSS---SSSSS--SS--SSSS--------SSSSS---SSS--SS--SSSS--#------------------------##-------------------
--------------------------TT----TT-----------------------------------------------------------------------------#-----------SS----------###-------------------
--------------------------TT----TT----T------------------------------------------------------------------------#----TT-----SS---------####--SSS-------------F
---M----------------------TT----TT----T------------------------------------------------------------------------#----TT-----SS--------#####------------------#
XXXXXXXXXXXXXXXXXXXXX---XXXXXXXXXXXXXXXXXXXXXXXXXXXXXXXXXXXXXXXXXXXXXXXXXXXXXXXX---XXXXXXXXXXXXXXXXXXXXXXXXXX--XXXXXXXXXX--XX--XXXXXXXXXXX-------XXXXXXXX--X-
XXXXXXXXXXXXXXXXXXXXX---XXXXXXXXXXXXXXXXXXXXXXXXXXXXXXXXXXXXXXXXXXXXXXXXXXXXXXXX---XXXXXXXXXXXXXXXXXXXXXXXXXX--XXXXXXXXXX--XX--XXXXXXXXXXX-------XXXXXXXX--XX
