-------------------------------------------------------------------------------------------------------------------------------------------------------------
-------------------------------------------------------------------------------------------------------------------------------------------------------------
-------------------------------------------------------------------------------------------------------------------------------------------------------------
SSSSSSSSSSSSSSSSSSSSSSSSSSSSSSSSSSSSSSSSSSSSSSSSSSSSSSSSSSSSSSSSSSSSSSSSSSSSSSSSSSSSSSSSSSSSSSSSSSSSSSSSSSSSSSSSSSSSSSSSSSSSSSSSSSSSSSSSSS-------------------
SSSSS--SSSS------SS--------------------S--SSSSSS--SSSSSSS--SSSS------SS----SSSS-------SS--SSSS------SSSS-----------------------------------------------------
SSSSS--SSSS------SS--------------------S--SSSSSS--SSSSSSS--SSSS------SS----SSSS-------SS--SSSS------SSSS-----------------------------------------------------
---SS---S----SS------------------------S------SS---S---SS---S----SS----SS----------oooSS---S----SS----------oo------------------------------SSS--------------
---SS---S----SS------------------------S------SS---S---SS---S----SS----SS-------------SS---S----SS-----------------------------------------------------------
---SS---S----SS------------------------S------SS---S---SS---S----SS----SS----------SSSSS---S----SS----------SS-----------------------------------------------
oooSS---SoU--SC---------------C--------S--ooooSS---SoooSS---SoU--SC----SC----------SSSSS---SoU--SC----------SS-----------------------------------SSSSSSU-----
SSSSS---SSS--SS--SS-----#-#------------S--SSSSSS---SSSSSS---SSS--SS--SSSS--SSSS-------SS---SSS--SS--SSSS------TT------------------------##-------------------
----------------------#-#-#-#---#-----------------------------------------------------------------------------TT-----------SS----------###-------------------
--------------------#-#-#-#-#---#-#---------------------------------------------------------------------------TT----TT-----SS---------####--SSS-------------F
---M----------------#-#-#-#-#-E-#-#---------------------------------------------------------------------------TT----TT-----SS--------#####------------------#
XXXXXXXXXXXXXXXXXXXXXXXXXXXXXXXXXXXXXXXXXXXXXXXXXXXXXXXXXXXXXXXXXXXXXXXXXXXXXXX---XXXXXXXXXXXXXXXXXXXXXX---XXXXXXXXXXXXXX--XX--XXXXXXXXXXX-------XXXXXXXX--X-
XXXXXXXXXXXXXXXXXXXXXXXXXXXXXXXXXXXXXXXXXXXXXXXXXXXXXXXXXXXXXXXXXXXXXXXXXXXXXXX---XXXXXXXXXXXXXXXXXXXXXX---XXXXXXXXXXXXXX--XX--XXXXXXXXXXX-------XXXXXXXX--XX
