#-#-#-#---#-#---####SSSSSSSSSSS#####-#-#-#-#---####S--#############-#-#-#-#---#-#-#-#-#---#-#S-#-#-#-#-#SSSSSSSSSSSS#-#-#-#-#--#-#-#-#-#---#TTSSSSSSSSSSSSSSS
#-#-#-#-E-#-#--#####SSSSS--SSSS#####-#-#-#-#-E-####S-##############-#-#-#-#-E-#-#-#-#-#-E-#-#S-#-#-#-#-#SSSSSS--SSSS#-#-#-#-#--#-#-#-#-#-E-#TT-SSSSSS--SSSS--
XXXXXXXXXXXXXXXXXXXXSSSSS--SSSSXXXXXXXXXXXXXXXXXXXXSXXXXXXXXXXXXXXXXXXXXXXXXXXXXXXXXXXXXXXXXXSXXXXXXXXXXSSSSSS--SSSSXXXXXXXXXXXXXXXXXXXXXXXXXX-SSSSSS--SSSS--
XXXXXXXXXXXXXXXXXXXX---SS---S--XXXXXXXXXXXXXXXXXXXXSXXXXXXXXXXXXXXXXXXXXXXXXXXXXXXXXXXXXXXXXXSXXXXXXXXXX----SS---S--XXXXXXXXXXXXXXXXXXXXXXXXXX-----SS---S----
SSSSS--SSSSSSSSSSSSSSSSSSSS--------SSSSSS--SSSSSS--SSSSSS--SSSSS-SSS--SSSSSSSSSSSSSSSSSSSSSSS--SSSSSSSSSSSSS------SSSSSSSSSSSSSSSSSS-------------------------
SSSSS--SSSSS-----------------------SSSSSS--SSSSSS--SSSSSS--SSSSS-SSS--SSSSSSSS--SSSSSSSSSSSSS--SS----------S-------------------SSSSS-------------------------
---SS---S-SS---------------------------SS---S--SS---S--SS---S-SS--SS---S-SSSSS--SSSS--SS---SS---S---------------------------------SS--------SSS--------------
---SS---S-SS---------------------------SS---S--SS---S--SS---S-SS--SS---S----SS---S----SS---SS---S---------------------------------SS-------------------------
---SS---S-SS---------------------------SS---S--SS---S--SS---S-SS--SS---S----SS---S----SS---SS---S---------------------------------SS-------------------------
oooSS---SoSS-----------------------ooooSS---SooSS---SoUSS---SoSS-oSS---So---SS---S--ooSSoooSS---S------------------------------oooSS-------------------------
SSSSS---SSSS--------------------TT-SSSSSS---SSSSS---SSSSS---SSSS-SSS---SSoooSS---SoUSSSSSSSSS---S-------------TT---------------SSSSS----##-------------------
------------QQ--------#-#--T----TT---------------------------------------SSSSS---SSS--------------------TT----TT-----------------------###------------------S
--------------------#-#-#-#T----TT----------------------------------------------------------------TT----TT----TT-----------S----------####--SSS-----TT------F
---M--------------#-#-#-#-#T----TT----------------------------------------------------------------TT----TT----TT----TT-----S---------#####----------TT------#
XXXXXXXXXXXX----#-#-#-#-#-#XXXXXXXXXXXXXXXXXXXXXXXXXXXXXXXXXXXXXXXXXXXXXX-----------XXXXXXXXXXXXX-TT----TT-XXXXXXX--TT-----S---XXXXXXXXXXX------XXXXXXXXX---X
XXXXXXXXXXXXXXXXXXXXXXXXXXXXXXXXXXXXXXXXXXXXXXXXXXXXXXXXXXXXXXXXXXXXXXXXXXXXXXXXXXXXXXXXXXXXXXXXXXXXXXXXXXXXXXXXXXXXXXXXX--X---XXXXXXXXXXX------XXXXXXXXX---X
