-#-#-#-#-E-#-#####SSSSSSSSSSSSSSSSSSSSSSSSSS#-#-#-#-#-#-E-#-#-#-#-#-#-E-#SSSSSSSSSSSSSSSSSS#-#-#-#-#-E-##-#-#-#-#-#-E-SSSS---######-#-#-#-E-#-#SSSSSS--#####-
XXXXXXXXXXXXXXXXXXSSSSS--SSSSSSSSSSSSS--SSSSXXXXXXXXXXXXXXXXXXXXXXXXXXXXXSSSSSS-SSSSSS--SSSXXXXXXXXXXXXXXXXXXXXXXXXXXXSSSSXXXXXXXXXXXXXXXXXXXXXSSSSSSXXXXXXX-
XXXXXXXXXXXXXXXXXXSSSSS--SSSSSSSSSSSSS--SSSSXXXXXXXXXXXXXXXXXXXXXXXXXXXXXSSSSSS-SSSSSS--SSSXXXXXXXXXXXXXXXXXXXXXXXXXXXSSSSXXXXXXXXXXXXXXXXXXXXXSSSSSSXXXXXXX-
SSSSSSSSSSSSSSSSSSSSSSSSSSSSSSSSSSSSSSSSSSSSSSSSSSSSSSSSSSSSSSSSSSSSSSSSSSSSSSSSSSSSSSSSSSSSSSSSSSSSSSSSSSSSSSSSSSSSSSSSSSSSSSSSSSSSSLSSSS-------SSSSSSSSSSSS
SSSSS--SSSSS--SSSS-----------S--SSSSSS--SSSSS--SS--SSSSSS--SSS--SSSSSSSSS--SSSS---SSSSSS--SSSSSSS--S-----------------SSS---S---------------------------------
SSSSS--SSSSS--SSSS-----------S--SSSSSS--SSSSS--SS--SSSSSS--SSS--SSSSSSSSS--SSSS---SSSSSS--SSSSSSS--S-----------------SSS---S---------------------------------
---SS---S-SS---S--------------------SS---S--SSS--------SS---SS---S-----SS---S----S----SS---S---SS-------------------------------oooooo------SSS--------------
---SS---S-SS---S--------------------SS---S--SSS--------SS---SS---S-----SS---S----S----SS---S---SS------------------------------------------------------------
---SS---S-SS---S--------------------SS---S--SSS--------SS---SS---S-----SS---S----S----SS---S---SS-------------------------------SSSSSS-----------------------
oooSS---SoSS---SoU--------------ooooSS---SoUSSS----ooooSS---SS---SoUoooSS---SoU--SooooSS---SoUoSS-------------------------------SSSSSS-----------------------
SSSSS---SSSS---SSS-------#-#-S--SSSSSS---SSSSSSSS--SSSSSS---SS---SSSSSSSS---SSS--SSSSSSS---SSSSSS-------------TT-----SSS---S------------##-------------------
-----------------------#-#-#-S-----------------SS-------------------------------------------------------TT----TT-----------------------###-----------------SS
---------------------#-#-#-#-S-----------------SS-------------------------------------------------------TT----TT----T------------------###--SSS-----TT-----SF
---M---------------#-#-#-#-#----------------------------------------------------------------------------TT----TT----T------------------###----------TT-----S#
XXXXXXXXXXXXXXXXXXXXXXXXXXXXXXXXXXXXXXXXXXXXXXXXXXXXXXXXXXXXXXXXXXXXXXXXXXXXXXXXXXXXXXXXXXXXXXXXXXXXXXXXXXXXXXXXXXXXXXXX---X---XXXXXXXXXXX-------XXXXXXXX--XX
XXXXXXXXXXXXXXXXXXXXXXXXXXXXXXXXXXXXXXXXXXXXXXXXXXXXXXXXXXXXXXXXXXXXXXXXXXXXXXXXXXXXXXXXXXXXXXXXXXXXXXXXXXXXXXXXXXXXXXXX---X---XXXXXXXXXXX-------XXXXXXXX--XX
