-------------------------------------------------------------------------------------------------------------------------------------------------------------
-------------------------------------------------------------------------------------------------------------------------------------------------------------
-------------------------------------------------------------------------------------------------------------------------------------------------------------
SSSSSSSSSSSLSSSSSSSSSSSSSSSSSSSSSSSSSSSSSSSSSSSSSSSSSSSSSSSSSSSSSSSSSSSSSSSSSSSS--SSSSSSSSSSSSSSSSSSSSSSSSSSSSSSSSSSSSSSSSSSSSSSSSSSSSSSSS-------------------
SSSSS--SSS----------------------------SSS--SSSS---SSSSSS--SSSSSS--SSSSSSS--SSSS----SSSSS--SSSS------SSS------------------------SSSSSS------------------------
SSSSS--SSS----------------------------SSS--SSSS---SSSSSS--SSSSSS--SSSSSSS--SSSS----SSSSS--SSSS------SSS------------------------SSSSSS------------------------
---SS---S-oo---------------------------SS---S----S----SS---SS-SS---S---SS---S-------SSSS---S----SS---SS----------------------------SS-------SSS--------------
---SS---S------------------------------SS---S----S----SS---SS-SS---S---SS---S-------SSSS---S----SS---SS----------------------------SS------------------------
---SS---S-SS---------------------------SS---S----S----SS---SS-SS---S---SS---S-------SSSS---S----SS---SS----------------------------SS------------------------
oooSS---SoSS--------------------------oSS---SoU--SooooSS---SSoSS---SoooSS---SoU----oSSSS---SoU--SC---SS------------------------ooooSS------------SSSSSSSU----
SSSSS---SS----------------------TT----SSS---SSS--SSSSSSS---SSSSS---SSSSSS---SSS----SSSSS---SSS--SS--SSS-------TT---------------SSSSSS---##-------------------
-------------------------TTT----TT-----------------------------------------g----------------------------TT----TT-----------S-----------###-------------------
-------------------------TTT----TT-----------------------------------------------------------------------T----TT----TT-----S----------####--SSS-------------F
---M---------g-----------TTT----TT-----kk---------------kk-----k---------gg-------------------g--g-------T----TT----TT-----S----------####------------------#
XXXXXXXXXXXXXXXXXXXXXXXXXXXXXXXXXXXXXXXXXXXXXXXXXXXXXXXXXXXXXXXXXXXXXXXXXXXXXXXX---XXXXXXXXXXXXXXXXXXXXXXXXXXXXXXXXXXXXXX--X--XXXXXXXXXXXX-------XXXXXXXXX--X
XXXXXXXXXXXXXXXXXXXXXXXXXXXXXXXXXXXXXXXXXXXXXXXXXXXXXXXXXXXXXXXXXXXXXXXXXXXXXXXX---XXXXXXXXXXXXXXXXXXXXXXXXXXXXXXXXXXXXXX--X--XXXXXXXXXXXX-------XXXXXXXXX--X
