-------------------------------------------------------------------------------------------------------------------------------------------------------------
-------------------------------------------------------------------------------------------------------------------------------------------------------------
-------------------------------------------------------------------------------------------------------------------------------------------------------------
SSSSSSSSSSSSSSSSSSSSSSSSSSSSSSSSSSSSSSSSSSSSSSSSSSSSSSSSSSSSSSSSSSSSSSSSSSSSSSSS---SSSSSSSSSSSSSSSSSSSSSSSSSSSSSSSSSSSSSS-SSSSSSSSSSSSSSSS-SSSSSSSSS---------
--SS--SSSSSS--SSSSSSS---------------SSSSS--SSSSSS--SSSSSS--SSSS--SSSS-----SSSS-----SSSS--SSSSS--SSSSSSS-------------------------------------SSSS-------------
--SS--SSSSSS--SSSSSSS---------------SSSSS--SSSSSS--SSSSSS--SSSS--SSSS---g-SSSS-----SSSS--SSSSS--SSSSSSS-------------------------------------SSSS-------------
SS--------SS---S-----------------------SS---S--SS---S--SS----SS---S----SS---SS------SSS---S-SS---S---S-------------------------------------------------------
SS--------SS---S-----------------------SS---S--SS---S--SS----SS---S----SS---SS------SSS---S-SS---S---S-------------------------------------------------------
SS--------SS---S-----------------------SS---S--SS---S--SS----SS---S----SS---SS------SSS---S-SS---S---S-------------------------------------------------------
SS----ooooSS---So-------------------oooSS---SooSS---SoUSS--ooSS---SoU--SC-ooSS------SSS---SoSS---SoU-So---------------------------------------------SSSSU----
SSSS--SSSSSS---SSSSSS----TT---------SSSSS---SSSSS---SSSSS--SSSS---SSS--SS-SSSS------SSS---SSSS---SSS-SS-T-----TT-------------------------#--SSSS-------------
--SS------------------#--TT------------------------------------------------g----------------------------TT----TT----T------SS-----------##-------------------
--SS-----------------##--TT----TT-----------------------------------------------------------------------TT----TT----TT-----SS----------###------------------F
---M--------gg-------##--TT----TT------kk---------------kk-gg-----------ggg-------------------ggggg-----TT----TT----TT-----SS-----ggg-####-------r----------#
XXXXXXXXXXXXXXXXXXXXXXXXXXXXXXXXXXXXXXXXXXXXXXXXXXXXXXXXXXXXXXXXXXXXXXXXXXXXXXXX---XXXXXXXXXXXXXXXXXXXXXXXXXXXXXXXXXXXXXX--XX--XXXXXXXXXXX-XXXXX---XXXXXXX--X
XXXXXXXXXXXXXXXXXXXXXXXXXXXXXXXXXXXXXXXXXXXXXXXXXXXXXXXXXXXXXXXXXXXXXXXXXXXXXXXX---XXXXXXXXXXXXXXXXXXXXXXXXXXXXXXXXXXXXXX--XX--XXXXXXXXXXX-XXXXX---XXXXXXX--X
