-------------------------------------------------------------------------------------------------------------------------------------------------------------
-------------------------------------------------------------------------------------------------------------------------------------------------------------
-------------------------------------------------------------------------------------------------------------------------------------------------------------
SSSSSSSSSSSSSSSSSSSSSSSSSSSSSSSSSSSSSSSSSSSSSSSSSSSSSSSSSSSSSSSSSSSSSSSSSSSSSSSSSSSSSSSSSSSSSSSSSSSSSSSSSSSSSSSSSSSSSSSSSSSSSSSSSSSSSSSSSS-------------------
--SS--SSSSSS--SSSS-----------------SS-SS--SSSSSS--SSSS-SS--SSS--SSSS---SS--SSSSSS---------SSSS--SSSS-S-------------------------------------------------------
--SS--SSSSSS--SSSS-----------------SS-SS--SSSSSS--SSSS-SS--SSS--SSSS---SS--SSSSSS---------SSSS--SSSS-S-------------------------------------------------------
SS--------SS---S---------------------S--------SS---S---SS---SS---S----SSS---S--------ooooo--SS---S---S--------------------------ooo---------SSS--------------
SS--------SS---S---------------------S--------SS---S---SS---SS---S----SSS---S---------------SS---S---S-------------------------------------------------------
SS--------SS---S---------------------S--------SS---S---SS---SS---S----SSS---S--------SSSSS--SS---S---S--------------------------SSS--------------------------
SS----ooooSS---SoU-------------------S----ooooSS---SoU-SS---SS---SoU--SSS---SoU------SSSSSooSS---SoU-S--------------------------SSS--------------SSSSSSU-----
SSSS--SSSSSS---SSS------#-#--------SSSSS--SSSSSS---SSS-SS---SS---SSS--SSS---SSSSS---------SSSS---SSS-S--------TT-------------------------#-------------------
--SS------------------#-#-#------#----SS----------------------------------------------------------------TT----TT-----------S------------##-------------------
--SS----------------#-#-#-#-----##----SS----------------------------------------------------------------TT----TT----TT-----S-----------###--SSS-------------F
---M----------------#-#-#-#----###----------------------------------------------------------------------TT----TT----TT-----S----------####------------------#
XXXXXXXXXXXXXXXXXXXXXXXXXXXXXXXXXXXXXXXXXXXXXXXXXXXXXXXXXXXXXXXXXXXXXXXXXXXXXXXXX---XXXXXXXXXXXXXXXXXXXXXXXXXXXXXXXXXXXXX--X---XXXXXXXXXXX-------XXXXXXXX--X-
XXXXXXXXXXXXXXXXXXXXXXXXXXXXXXXXXXXXXXXXXXXXXXXXXXXXXXXXXXXXXXXXXXXXXXXXXXXXXXXXX---XXXXXXXXXXXXXXXXXXXXXXXXXXXXXXXXXXXXX--X---XXXXXXXXXXX-------XXXXXXXX--XX
