-------------------------------------------------------------------------------------------------------------------------------------------------------------
-------------------------------------------------------------------------------------------------------------------------------------------------------------
-------------------------------------------------------------------------------------------------------------------------------------------------------------
SSSSSSSSSSLSSSSSSSSSSSSSSSSSSSSSSSSSSSSSSSSSSSSSSSSSSSSSSSSSSSSSSSSSSSSSSSSSSSSSS-S-SSSSSSSSSSSSLSSSSSSSSSSSSSSSSSSSSSSSSSSSSSSSSSSSSLSSSS-------------------
SSSSS--SS-----------------------------SS--SSSSSS--SSSSSSSSSSSSSS--SSSSSSS--SSSS---S-SSS--SSSS-----------------------S---SSSS---------------------------------
SSSSS--SS-----------------------------SS--SSSSSS--SSSSSSSSSSSSSS--SSSSSSg--SSSS---S-SSS--SSSS-----------------------S---SSSS---------------------------------
SS-SS---Soo-------------------------SS--------SS---S--SSS--SS-SS---S---SS---S--------SS---SSSoooo--------------------S----------oooooo------SSS--------------
SS-SS---S---------------------------SS--------SS---S--SSS--SS-SS---S---SS---S--------SS---SSS------------------------S---------------------------------------
SS-SS---SSS-------------------------SS--------SS---S--SSS--SS-SS---S---SS---S--------SS---SSSSSSS--------------------S----------SSSSSS-----------------------
SSoSS---SSS-------------------------SS----ooooSS---SooSSSooSSoSS---SoUoSS---SoU---o-oSS---SSSSSSS--------------------C----------SSSSSS-----------SSSSSSU-----
SSSSS---S---------------------------SSSS--SSSSSS---SSSSSSSSSSSSS---SSSSSS---SSS---S-SSS---SSS------------------T-----S--SSSS------------##-------------------
------------------------TTSS----TT----SS----------------------------------------------------------------------TT-----------------------###-------------------
------------------------TTSS----TT----SS----------------------------------------------------------------------TT----T------------------###--SSS-------------F
---M--------------------TTSS----TT-----------------------k---------------gg-----------------------------------TT-----------------------###------------------#
XXXXXXXXXXXXXXXXXXXXXXXXXXXXXXXXXXXXXXXXXXXXXXXXXXXXXXXXXXXXXXXXXXXXXXXXXXXXXXXXX-X-XXXXXXXXXXXXXXXXXXXXXXXXXXXXXXXXXXXXXXXX---XXXXXXXXXXX-------XXXXXXXX--X-
XXXXXXXXXXXXXXXXXXXXXXXXXXXXXXXXXXXXXXXXXXXXXXXXXXXXXXXXXXXXXXXXXXXXXXXXXXXXXXXXX-X-XXXXXXXXXXXXXXXXXXXXXXXXXXXXXXXXXXXXXXXX---XXXXXXXXXXX-------XXXXXXXX--XX
