-------------------------------------------------------------------------------------------------------------------------------------------------------------
-------------------------------------------------------------------------------------------------------------------------------------------------------------
-------------------------------------------------------------------------------------------------------------------------------------------------------------
SSSSSSSSSSSSSSSSSSSSSSSSSSSSSSSSSSSSSSSSSSSSSSSSSSSSSSSSSSSSSSSSSSSSSSSSSSSSSSSS---SSSSSSSSSSSSSSSSSSSSSSSSSSSSSSSSSSSSSS-SSSSSSSSSSSSSSSS-------------------
SSSSS--SSSS---------------------------------SSSS--SSSSSSS------SS--SSSSSS--SSSS----SSSSSS--SSSSSSS--SS-------------------------------------------------------
SSSSS--SSSS---------------------------------SSSS--SSSSSSS------SS--SSSSSg--SSSS----SSSSSS--SSSSSSS--SS-------------------------------------------------------
---SS---S--------------------------------ooo--SS---S-SSSS----SS--------SS---S----------SS---S---SS---S--------------------------------------SSS--------------
---SS---S-------------------------------------SS---S-SSSS----SS--------SS---S----------SS---S---SS---S-------------------------------------------------------
---SS---S------------------------------S-SSS--SS---S-SSSS----SS--------SS---S----------SS---S---SS---S-------------------------------------------------------
oooSS---SoU------------------C---------SoS--ooSS---SoSSSS----SS----ooooSS---So-----ooooSS---SoooSS---S-------------------------------------------SSSSSSSU----
SSSSS---SSS------------#-#-------------SSS--SSSS---SSSSSS----SSSS--SSSSSS---SSS----SSSSSS---SSSSSS---S--T-----TT------------------------##-------------------
----------------------##-#-#---#-------------------------------SS----------g----------------------------TT----TT----T-----SS-----------###-------------------
---------------------###-#-#---#-#-----------------------------SS---------------------------------------TT----TT----TT----SS----------####--SSS-------------F
---M--------gg------####-#-#-E-#-#-----kk---------------kk-gg-----------ggg-------------------ggggg-----TT----TT----TT----SS------ggg#####-------r----------#
XXXXXXXXXXXXXXXXXXXXXXXXXXXXXXXXXXXXXXXXXXXXXXXXXXXXXXXXXXXXXXXXXXXXXXXXXXXXXXX----XXXXXXXXXXXXXXXXXXXXXXXXXXXXXXXXXXXXX--XX--XXXXXXXXXXXX-------XXXXXXXXX--X
XXXXXXXXXXXXXXXXXXXXXXXXXXXXXXXXXXXXXXXXXXXXXXXXXXXXXXXXXXXXXXXXXXXXXXXXXXXXXXX----XXXXXXXXXXXXXXXXXXXXXXXXXXXXXXXXXXXXX--XX--XXXXXXXXXXXX-------XXXXXXXXX--X
