-------------------------------------------------------------------------------------------------------------------------------------------------------------
-------------------------------------------------------------------------------------------------------------------------------------------------------------
-------------------------------------------------------------------------------------------------------------------------------------------------------------
SSSSSSSSSSSSSSSSSSSSSSSSSSSSSSSSSSSSSSSSSSSSSSSSSSSSSSSSSSSSSSSSSSSSSSSSSSSSSSSSS-S-SSSSSSSSSSSSSSSSSSSSSSSSSSSSSSSSSSSSSSSSSSSSSSSSSSSSSSSS-----------------
SSSSS--SSSSSSSS--SSSS--------------------------SS--SSSSSSSSSS--S-SSSS------SSSS--------S--SSSS---------------------------------------------------------------
SSSSS--SSSSSSSS--SSSS--------------------------SS--SSSSSSSSSS--S-SSSS---g--SSSS--------S--SSSS---------------------------------------------------------------
---SS---S----SS---S----------------------oooo-S--------SS-SSS-----S----SS-----------oooS---S----S--------------------------------------------SSS-------------
---SS---S----SS---S---------------------------S--------SS-SSS-----S----SS--------------S---S----S------------------------------------------------------------
---SS---S----SS---S--------------------S-SSSS-S--------SS-SSS-----S----SS-----------SSSS---S----S------------------------------------------------------------
oooSS---SooooSS---SoU--------C---------SoS--SoS----ooooSS-SSS-----SoU--SC-----------SSSS---SoU--S-------------------------------------------------SSSSSSU----
SSSSS---SSSSSSS---SSS--#-#-------------SSS--SSSSS--SSSSSS-SSS-----SSS--SS--SSSS--------S---SSS--S-------------TT---------------------------------------------
-----------------------#-#-#---#---------------SS-------------------------------------------------------TT----TT-----------SS-----------#S-------------------
-----------------------#-#-#---#-#-------------SS-------------------------------------------------------TT----TT----TT-----SS----------##S---SSS------------F
---M-------------------#-#-#-E-#-#-----------------------k---------------gg-----------------------------TT----TT----TT-----SS---------###S------------------#
XXXXXXXXXXXXXXXXXXXXXXXXXXXXXXXXXXXXXXXXXXXXXXXXXXXXXXXXXXXXXXXXXXXXXXXXXXXXXXX---X-XXXXXXXXXXXXXXXXXXXXXXXXXXXXXXXXXXXXX--XX--XXXXXXXXXXX--------XXXXXXXX--X
XXXXXXXXXXXXXXXXXXXXXXXXXXXXXXXXXXXXXXXXXXXXXXXXXXXXXXXXXXXXXXXXXXXXXXXXXXXXXXX---X-XXXXXXXXXXXXXXXXXXXXXXXXXXXXXXXXXXXXX--XX--XXXXXXXXXXX--------XXXXXXXX--X
