-------------------------------------------------------------------------------------------------------------------------------------------------------------
-------------------------------------------------------------------------------------------------------------------------------------------------------------
-------------------------------------------------------------------------------------------------------------------------------------------------------------
SSSSSSSSSSSSSSSSSSSSSSSSSSSSSSSSSSSSSSSSSSSSSSSSSSSSSSSSSSSSSSSSSSSSSSSSSSSSSSSSSSSSSSSSSSSSSSSSSSSSSSSSSSSSSSSSSSSSSSSSSSSSSSSSSSSSSSSSSS--------SSSSSSSSSSS
SSSSS--SSSS-----------------------------SSSSSS--SSSS------SSSSS--SSSS------SSSS---SSSSS--SSSS--SSSS------SSSSS-----------------------------------------------
SSSSS--SSSS-----------------------------SSSSSS--SSSS------SSSSS--SSSS------SSSS---SSSSS--SSSS--SSSS------SSSSS-----------------------------------------------
---SS---S-----------------------------------SS---S----SS------S---S----SS------------SS---SSS---S----SS-------------------------------------SSS--------------
---SS---S-----------------------------------SS---S----SS------S---S----SS------------SS---SSS---S----SS------------------------------------------------------
---SS---S-----------------------------------SS---S----SS------S---S----SS------------SS---SSS---S----SS------------------------------------------------------
oooSS---SoU-----------------------------ooooSS---SoU--SC------S---SoU--SC---------oooSS---SSS---SoU--SC------------------------------------------S-----------
SSSSS---SSS-QQQQ--------#-#-----TT------SSSSSS---SSS--SS--SSSSS---SSS--SS--SSSS---SSSSS---SSS---SSS--SS--SSSS-TT------------------------##-------------------
----------------------#-#-#T----TT----------------------------------------------------------------------------TT-----------SS----------###-----------------SS
--------------------#-#-#-#T----TT----TT----------------------------------------------------------------------TT----TT-----SS---------####--SSS-----TT-----SF
---M--------------#-#-#-#-#T----TT----TT----------------------------------------------------------------------TT----TT-----SS--------#####----------TT-----S#
XXXXXXXXXXXXXXXXXXXXXXXXXXXXXXXXXXXXXXXXXXXXXXXXXXXXXXXXXXXXXXXXXXXXXXXXXXXXXXX---XXXXXXXXXXXXXXXXXXXXXXXXXXXXXXXXXXXXXXX--XX--XXXXXXXXXXX-------XXXXXXXX--XX
XXXXXXXXXXXXXXXXXXXXXXXXXXXXXXXXXXXXXXXXXXXXXXXXXXXXXXXXXXXXXXXXXXXXXXXXXXXXXXX---XXXXXXXXXXXXXXXXXXXXXXXXXXXXXXXXXXXXXXX--XX--XXXXXXXXXXX-------XXXXXXXX--XX
