-------------------------------------------------------------------------------------------------------------------------------------------------------------
-------------------------------------------------------------------------------------------------------------------------------------------------------------
-------------------------------------------------------------------------------------------------------------------------------------------------------------
SSSSSSSSSSSSLSSSSSSSSSSSSSSSSSSSSSSSSSSSSSSSSSSSSSSSSSSSSSSSSSSSSSSSSSSSSSSSSSSS--SSSSSSSSSSSSSSSSSSSSSSSSSSSSSSSSSSSSSSSSSSSSSSSSSSSSSSSS-------SSSSSSSSSSSS
SSSS--SSSS-------------------------SSSSSS--SSSS---SSSSSS--SSSSS--SSSS------SSSS---SSSSSS--SSSS------SSSS--------------------------SSS--S---------------------
SSSS--SSSS-------------------------SSSSSS--SSSS---SSSSSS--SSSSS--SSSS------SSSS---SSSSSS--SSSS------SSSS--------------------------SSS--S---------------------
--SS---SSSooo--------------------------SS---S---------SS---S-SS---S----SS-------------SS---S----SS---S-----------------------------SS-------SSS--------------
--SS---SSS-----------------------------SS---S---------SS---S-SS---S----SS-------------SS---S----SS---S-----------------------------SS------------------------
--SS---SSSSSS--------------------------SS---S---------SS---S-SS---S----SS-------------SS---S----SS---S-----------------------------SS------------------------
ooSS---SSSSSS----------------------ooooSS---SoU---ooooSS---SoSS---SoU--SC---------ooooSS---SoU--SC---SoU--------------------------oSS------------------------
SSSS---SSS----------------------T--SSSSSS---SSS---SSSSSS---SSSS---SSS--SS--SSSS---SSSSSS---SSS--SS---SSS------TT------------------SSS---##-------------------
--------------------------TT----T------------------------------------------g----------------------------TT----TT-----------SS-----------##-----------------SS
--------------------------TT----T-----------------------------------------------------------------------TT----TT----TT-----SS-----------##--SSS-----TT-----SF
---M---------g------------TT----T------kk---------------kk-----k---------gg-------------------g--g------TT----TT----TT-----SS-----------##----------TT-----S#
XXXXXXXXXXXXXXXXXXXXXXXXXXXXXXXXXXXXXXXXXXXXXXXXXXXXXXXXXXXXXXXXXXXXXXXXXXXXXXX---XXXXXXXXXXXXXXXXXXXXXXXXXXXXXXXXXXXXXXX--XX--XXXXXXXXXXX-------XXXXXXXX--XX
XXXXXXXXXXXXXXXXXXXXXXXXXXXXXXXXXXXXXXXXXXXXXXXXXXXXXXXXXXXXXXXXXXXXXXXXXXXXXXX---XXXXXXXXXXXXXXXXXXXXXXXXXXXXXXXXXXXXXXX--XX--XXXXXXXXXXX-------XXXXXXXX--XX
