-------------------------------------------------------------------------------------------------------------------------------------------------------------
-------------------------------------------------------------------------------------------------------------------------------------------------------------
-------------------------------------------------------------------------------------------------------------------------------------------------------------
SSSSSSSSSSSSLSSSSSSSSSSSSSSSSSSSSSSSSSSSSSSSSSSSSSSSSSSSSSSSSSSSSSSSSSSSSSSSSSSSS-S-SSSSSSSSSSSSSSSSSSSSSSSSSSSSSSSSSSSSSSSSSSSSSSSSSSSSSS-------------------
SSSSS--SSSS---------------------------SS--SSSSSS--SSSSSS--SSSSS--SSSS------SSSS-----SSSS--SSSS------SSSS-----------------------------------------------------
SSSSS--SSSS---------------------------SS--SSSSSS--SSSSSS--SSSSS--SSSS---g--SSSS-----SSSS--SSSS------SSSS-----------------------------------------------------
---SS---S--oo-----------------------SS--------SS---S--SS---S-SS---S----SS-----------S-SS---S----SS------------------------------------------SSSS-------------
---SS---S---------------------------SS--------SS---S--SS---S-SS---S----SS-----------S-SS---S----SS-----------------------------------------------------------
---SS---S--SS-----------------U-----SS--------SS---S--SS---S-SS---S----SS-----------S-SS---S----SS-----------------------------------------------------------
oooSS---SoUSS----------------oS-----SS----ooooSS---SooSS---SoSS---SoU--SC-----------SoSS---SoU--SC------------------------------------------------SSSSSSU----
SSSSS---SSS------------------SS-----SSSS--SSSSSS---SSSSS---SSSS---SSS--SS--SSSS-----SSSS---SSS--SS--SSSS------TT------------------------##-------------------
--------------------------TT----------SS----------------------------------------------------------------------TT-----------S-----------###-------------------
--------------------------TT----------SS----------------------------------------------------------------------TT----TT-----S----------####--SSSS------------F
---M----------------------TT-----------------------------k---------------gg-----------------------------------TT----TT-----S---------#####------------------#
XXXXXXXXXXXXXXXXXXXXXXXXXXXXXXXXXXXXXXXXXXXXXXXXXXXXXXXXXXXXXXXXXXXXXXXXXXXXXXX---X-XXXXXXXXXXXXXXXXXXXX---XXXXXXXXXXXXXX--X--XXXXXXXXXXXX--------XXXXXXXX--X
XXXXXXXXXXXXXXXXXXXXXXXXXXXXXXXXXXXXXXXXXXXXXXXXXXXXXXXXXXXXXXXXXXXXXXXXXXXXXXX---X-XXXXXXXXXXXXXXXXXXXX---XXXXXXXXXXXXXX--X--XXXXXXXXXXXX--------XXXXXXXX--X
