-------------------------------------------------------------------------------------------------------------------------------------------------------------
-------------------------------------------------------------------------------------------------------------------------------------------------------------
-------------------------------------------------------------------------------------------------------------------------------------------------------------
SSSSSSSSSSSSSSSSSSSSSSSSSSSS---SSSSSSSSSSSSSSSSSSSSSSSSSSSSSSSSSSSSSSSSSSSSSSSSS---SSSSSLSSSSSSSSSSSSSSSSSSSSSSSSSSSSSSSS-SSSSSSSSSSSSSSSS-------------------
SSSSSS--SSSS---------------------SSSSSS--SSSSSS--SSSS-----SSSSSS--SSS------SSSS-------------SSSSSS--SSSS-----------------------------------------------------
SSSSSS--SSSS---------------------SSSSSS--SSSSSS--SSSS-----SSSSSS--SSS---g--SSSS-------------SSSSSS--SSSS-----------------------------------------------------
----SS---S---------------------------SS---S--SS---S----SS-----SS---S---SS----------oooooo-------SS---S--------------------------------------SSS--------------
----SS---S---------------------------SS---S--SS---S----SS-----SS---S---SS-----------------------SS---S-------------------------------------------------------
----SS---S---------------------------SS---S--SS---S----SS-----SS---S---SS----------SSSSSS-------SS---S-------------------------------------------------------
ooooSS---SoU---------------------ooooSS---SooSS---SoU--SC-ooooSS---So--SC----------SSSSSS---ooooSS---SoU-----------------------------------------SSSSSSU-----
SSSSSS---SSSQQQQ--------#-#------SSSSSS---SSSSS---SSS--SS-SSSSSS---SS--SS--SSSS-------------SSSSSS---SSST-----TT-------------------------#-------------------
----------------------#-#-#------------------------------------------------g----------------------------T-----TT----T------SS-----------##-------------------
--------------------#-#-#-#------------------------------------------------------------------------------T----TT----TT-----SS----------###--SSS-------------F
---M--------gg----#-#-#-#-#------------kk---------------kk-gg-----------ggg-------------------ggggg------T----TT----TT-----SS-----ggg-####-------r----------#
XXXXXXXXXXXXXXXXXXXXXXXXXXXXXXXXXXXXXXXXXXXXXXXXXXXXXXXXXXXXXXXXXXXXXXXXXXXXXXX----XXXXXXXXXXXXXXXXXXXXXXXXXXXXXXXXXXXXXX--XX--XXXXXXXXXXX-------XXXXXXXX--X-
XXXXXXXXXXXXXXXXXXXXXXXXXXXXXXXXXXXXXXXXXXXXXXXXXXXXXXXXXXXXXXXXXXXXXXXXXXXXXXX----XXXXXXXXXXXXXXXXXXXXXXXXXXXXXXXXXXXXXX--XX--XXXXXXXXXXX-------XXXXXXXX--XX
