-------------------------------------------------------------------------------------------------------------------------------------------------------------
-------------------------------------------------------------------------------------------------------------------------------------------------------------
-------------------------------------------------------------------------------------------------------------------------------------------------------------
SSSSSSSSSSSSSSSSSSSSSSSSSSSSSSSSSSSSSSSSSSSSSSSSSSSSSSSSSSSSSSSSSSSSSSSSSSSLSSSS--SSSSSSSSSSSSSSSSSSSSSSSSSSSSSSSSSSSSSSSSSSSSSSSSSSSLSSSSS------------------
--SS--SSSSSS--SSSS--------------SS--SSSSSS--SSSS-S--SSSS------SSSS----------SS----SS-SSSS--SSSS--------------------------------------------------------------
--SS--SSSSSS--SSSS--------------SS--SSSSSS--SSSS-S--SSSS------SSSS----------SS----SS-SSSS--SSSS--------------------------------------------------------------
SS--------SS---S--------------SS--------SS---S---S---S----SS----------ooooooSS---------SS---S-----------------------------------oooooo-------SSS-------------
SS--------SS---S--------------SS--------SS---S---S---S----SS----------------SS---------SS---S----------------------------------------------------------------
SS--------SS---S--------------SS--------SS---S---S---S----SS----------SSSSSSSS---------SS---S-----------------------------------SSSSSS-----------------------
SS----ooooSS---SoU------------SS----ooooSS---SoU-S---SoU--SC----------SSSSSSSS----oU-ooSS---SoU---------------------------------SSSSSS------------SSSSSSU----
SSSS--SSSSSS---SSS-------#-#--SSSS--SSSSSS---SSS-S---SSS--SS--SSSS----------SS----SS-SSSS---SSS---------------TT---------------------------------------------
--SS-------------------#-#-#----SS-----------------------------------------g----------------------------TT----TT----------SS---------------------------------
--SS-----------------#-#-#-#----SS----------------------------------------------------------------------TT----TT----TT----SS-----------------SSS------------F
---M---------g-----#-#-#-#-#-----------kk---------------kk-----k---------gg-------------------g--g------TT----TT----TT----SS--------------------------------#
XXXXXXXXXXXXXXXXXXXXXXXXXXXXXXXXXXXXXXXXXXXXXXXXXXXXXXXXXXXXXXXXXX---XXXXXXXXXXX--XXXXXXXXXXXXXXXXXXXXXXXXXXXXXXXXXXXXXX--XX---XXXXXXXXXXXX-------XXXXXXXX--X
XXXXXXXXXXXXXXXXXXXXXXXXXXXXXXXXXXXXXXXXXXXXXXXXXXXXXXXXXXXXXXXXXX---XXXXXXXXXXX--XXXXXXXXXXXXXXXXXXXXXXXXXXXXXXXXXXXXXX--XX---XXXXXXXXXXXX-------XXXXXXXX--X
