-------------------------------------------------------------------------------------------------------------------------------------------------------------
-------------------------------------------------------------------------------------------------------------------------------------------------------------
-------------------------------------------------------------------------------------------------------------------------------------------------------------
SSSSSSSSSSSSSSSSSSSSSSSSSSSSSSSSSSSSSSSSSSSSSSSSSSSSSSSSSSSSSSSSSSSSSSSSSSSSSSSSSSSSSSSSSSSSSSSSSSSSSSSSSSSSSSSSSSSSSSSSSSSSSSSSSSSSSSSSSS-------------------
SSSSS--SSSS-------------------------------------------SS--SSSS--SSSSSSSSS--SSSS---SSSSSS--SSSS---------------------------------------------------------------
SSSSS--SSSS-------------------------------------------SS--SSSS--SSSSSSSSS--SSSS---SSSSSS--SSSS---------------------------------------------------------------
---SS---S--------------------------------oooo-------SSSS----SS---S-----SS---S---------SS---S----S-------------------------------------------SSS--------------
---SS---S-------------------------------------------SSSS----SS---S-----SS---S---------SS---S----S------------------------------------------------------------
---SS---S------------------------------S-SSSS-U-----SSSS----SS---S-----SS---S---------SS---S----S------------------------------------------------------------
oooSS---SoU------------------C---------SoS--SoS-----SSSS---oSS---SoooooSS---SoU---ooooSS---SoU--S-------------------------------------------------SSSSSSU----
SSSSS---SSS--QQQ--------#-#------------SSS--SSS-----SSSS---SSS---SSSSSSSS---SSS---SSSSSS---SSS--S-------------TT-------------------------#-------------------
----------------------#-#-##---#------------------------------------------------------------------------TT----TT-----------SS-----------##-------------------
--------------------#-#-#-##---#-#----------------------------------------------------------------------TT----TT----TT-----SS----------###--SSS-------------F
---M--------------#-#-#-#-##-E-#-#----------------------------------------------------------------------TT----TT----TT-----SS---------####------------------#
XXXXXXXXXXXXXXXXXXXXXXXXXXXXXXXXXXXXXXXXXXXXXXXXXXXXXXXXXXXXXXXXXXXXXXXXXXXXXXXXXXXXXXXXXXXXXXXXXXXXXXXXXXXXXXXXXXXXXXXXX--XX--XXXXXXXXXXX--------XXXXXXXX--X
XXXXXXXXXXXXXXXXXXXXXXXXXXXXXXXXXXXXXXXXXXXXXXXXXXXXXXXXXXXXXXXXXXXXXXXXXXXXXXXXXXXXXXXXXXXXXXXXXXXXXXXXXXXXXXXXXXXXXXXXX--XX--XXXXXXXXXXX--------XXXXXXXX--X
