-------------------------------------------------------------------------------------------------------------------------------------------------------------
-------------------------------------------------------------------------------------------------------------------------------------------------------------
-------------------------------------------------------------------------------------------------------------------------------------------------------------
SSSSSSSSSSSSSSSSSSSSSSSSSSSSSSSSSSSSSSSSSSSSSSSSSSSSSSSSSSSSSSSSSSSSSSSSSSSSSSSSSSSSSSSSSSSSSSSSSSSSSSSSSSSSSSSSSSSSSSSSSSSSSSSSSSSSSSSSSS-------------------
SSSSSS--SSSSSSSS-----------------------SS--SSSSSS--SSSS------SSS--SSSS------SSSS-------SS--SSSS---------------------------SS---------------------------------
SSSSSS--SSSSSSSS-----------------------SS--SSSSSS--SSSS------SSS--SSSS------SSSS-------SS--SSSS---------------------------SS---------------------------------
----SS---S----SS---------------------SS--------SS---S----SS--SSS---S----SS----------oooSS---S-S---------------------------------ooo---------SSS--------------
----SS---S----SS---------------------SS--------SS---S----SS--SSS---S----SS-------------SS---S-S--------------------------------------------------------------
----SS---S----SS---------------------SS--------SS---S----SS--SSS---S----SS----------SSSSS---S-S---------------------------------SSS--------------------------
ooooSS---SoUooSS---------------------SS----ooooSS---SoU--SC--SSS---SoU--SC----------SSSSS---SoS---------------------------------SSS--------------SSSSSSU-----
SSSSSS---SSSSSSS---------TT----------SSSS--SSSSSS---SSS--SS--SSS---SSS--SS--SSSS-------SS---SSS---------------TT----------SS------------##-------------------
-------------------TT----TT------------SS---------------------------------------------------------------TT----TT-----------------------###-------------------
-------------------TT----TT----T-------SS---------------------------------------------------------------TT----TT----TT----------------####--SSS-------------F
---M---------------TT----TT----T------------------------------------------------------------------------TT----TT----TT---------------#####------------------#
XXXXXXXXXXXXXXXXXXXXXXXXXXXXXXXXXXXXXXXXXXXXXXXXXXXXXXXXXXXXXXXXXXXXXXXXXXXXXXXX---XXXXXXXXXXXXXXXXXXXXXXXXXXXXXXXXXXXXXX-XX---XXXXXXXXXXX-------XXXXXXXX--X-
XXXXXXXXXXXXXXXXXXXXXXXXXXXXXXXXXXXXXXXXXXXXXXXXXXXXXXXXXXXXXXXXXXXXXXXXXXXXXXXX---XXXXXXXXXXXXXXXXXXXXXXXXXXXXXXXXXXXXXX-XX---XXXXXXXXXXX-------XXXXXXXX--XX
