-------------------------------------------------------------------------------------------------------------------------------------------------------------
-------------------------------------------------------------------------------------------------------------------------------------------------------------
-------------------------------------------------------------------------------------------------------------------------------------------------------------
SSSSSSSSSSSSSSSSSSSSSSSSSSSSSSSSSSSSSSSSSSSSSSSSSSSSSSSSSSSSSSSSSSSSSSSSSSSSSSSS--SSSSSSSSSSSSSSLSSSSSSSSSSSSSSSSSSSSSSSSSSSSSSSSSSSSSSSSS-------------------
SSSSS--SSSS---------------------------SSSSSSSS--SSSS-----SSSSSS--SSSS------SSSS------------------------------------------------------------------------------
SSSSS--SSSS---------------------------SSSSSSSS--SSSS-----SSSSSS--SSSS------SSSS------------------------------------------------------------------------------
SS-SS---S----SS------------------------S----SS---S----SS-----SS---S----SS------------oooo--oooooo-------------------------------------------SSS--------------
SS-SS---S----SS------------------------S----SS---S----SS-----SS---S----SS------------------------------------------------------------------------------------
SS-SS---S----SS------------------------S----SS---S----SS-----SS---S----SS------------SSSS--SSSSSS------------------------------------------------------------
SSoSS---SoU--SC------------------------SooooSS---SoU--SC-ooooSS---SoU--SC------------SSSS--SSSSSS------------------------------------------------SSSSSSU-----
SSSSS---SSS--SS-----------TT-----------SSSSSSS---SSS--SS-SSSSSS---SSS--SS--SSSS----------------------------------------------------------#-------------------
--------------------TT----TT-----------------------------------------------g----------------------------T-----TT-----------SS-----------##-------------------
--------------------TT----TT----TT----------------------------------------------------------------------------TT----TT-----SS----------###--SSS-------------F
---M---------g------TT----TT----TT-----kk---------------kk-----k---------gg-------------------g--g------------TT----TT-----SS---------####------------------#
XXXXXXXXXXXXXXXXXXXXXXXXXXXXXXXXXXXXXXXXXXXXXXXXXXXXXXXXXXXXXXXXXXXXXXXXXXXXXXX-----XXXXX-XXXXXXXXXXXXXXXXXXXXXXXXXXXXXXX--XX--XXXXXXXXXXX-------XXXXXXXX--X-
XXXXXXXXXXXXXXXXXXXXXXXXXXXXXXXXXXXXXXXXXXXXXXXXXXXXXXXXXXXXXXXXXXXXXXXXXXXXXXX-----XXXXX-XXXXXXXXXXXXXXXXXXXXXXXXXXXXXXX--XX--XXXXXXXXXXX-------XXXXXXXX--XX
