-------------------------------------------------------------------------------------------------------------------------------------------------------------
-------------------------------------------------------------------------------------------------------------------------------------------------------------
-------------------------------------------------------------------------------------------------------------------------------------------------------------
SSSSSSSSSSSSSSSSSSSSSSSSSSSSSSSSSSSSSSSSSSSSSSSSSSSSSSSSSSSSSSSSSSSSSSSSSSSSSSSS---SSSSSSSLSSSSSSSSSSSSSSSSSSSSSSSSSSSSSS-SSSSSSSSSSSSSSSS-----------------SS
SSSSSS--SSSS--------------------S--SSSSSS--SSSSS--SSSS---------SS--SSSSSS--SSSSS------------------------------------SSSS-------SSSSSS------------------------
SSSSSS--SSSS--------------------S--SSSSSS--SSSSS--SSSS---------SS--SSSSSg--SSSSS------------------------------------SSSS-------SSSSSS------------------------
----SS---S-----------------------------SS---S-SS---S---------SS--------SS---S--------oooooo----------------------------------------SS-------SSS--------------
----SS---S-----------------------------SS---S-SS---S---------SS--------SS---S------------------------------------------------------SS------------------------
----SS---S-----------------------------SS---S-SS---S---U-----SS--------SS---S--------SSSSSS----------------------------------------SS------------------------
ooooSS---SoU-----------------------ooooSS---SoSS---SoUoS-----SS----ooooSS---So-------SSSSSS------------------------------------ooooSS------------SSSSSSU-----
SSSSSS---SSS-------------TT-----S--SSSSSS---SSSS---SSSSS-----SSSS--SSSSSS---SSSS------------------------T-----TT----SSSS-------SSSSSS---##-------------------
-------------------TT----TT-----S------------------------------SS----------g----------------------------TT----TT----T------SS----------###------------------S
-------------------TT----TT----TS------------------------------SS---------------------------------------TT----TT----T------SS---------####--SSS-------------F
---M--------gg-----TT----TT----T-------kk---------------kk-gg-----------ggg-------------------ggggg-----TT----TT----T------SS-----ggg-####-------r----------#
XXXXXXXXXXXXXXXXXXXXXXXXXXXXXXXXXXXXXXXXXXXXXXXXXXXXXXXXXXXXXXXXXXXXXXXXXXXXXXXX----XXXXXXXXXXXXXXXXXXXXXXXXXXXXXXXXXXXX---XX-XXXXXXXXXXXX-------XXXXXXXX---X
XXXXXXXXXXXXXXXXXXXXXXXXXXXXXXXXXXXXXXXXXXXXXXXXXXXXXXXXXXXXXXXXXXXXXXXXXXXXXXXX----XXXXXXXXXXXXXXXXXXXXXXXXXXXXXXXXXXXX---XX-XXXXXXXXXXXX-------XXXXXXXX---X
