-------------------------------------------------------------------------------------------------------------------------------------------------------------
-------------------------------------------------------------------------------------------------------------------------------------------------------------
-------------------------------------------------------------------------------------------------------------------------------------------------------------
SSSSSSSSSSSSLSSSSSSSSSSSSSSSSSSSSSSSSSSSSSSSSSSSSSSSSSSSSSSSSSSSSSSSSSSSSSSSSSSSS-S-SSSSLSSSSSSSSSSSSSSSSSSSSSSSSSSSSSSSSSSSSSSSSSSSSSSSSS--------SSSSSSSSSSS
SSSS--------------------------------SSSSS--SSSS----SSSSS--SSSS---SSSS------SSSS-------------SSSSSS--SSSS-----------------------------------------------------
SSSS--------------------------------SSSSS--SSSS----SSSSS--SSSS---SSSS---g--SSSS-------------SSSSSS--SSSS-----------------------------------------------------
--SS---oooooo--------------------------SS---S----SS---SS---S----S-S----SS-----------ooooo-------SS---S----S---------------------------------SSS--------------
--SS-----------------------------------SS---S----SS---SS---S----S-S----SS-----------------------SS---S----S--------------------------------------------------
--SS---SSSSSS--------------------------SS---S----SS---SS---S----S-S----SS-----------SSSSS-------SS---S----S--------------------------------------------------
ooSS---SSSSSS-----------------------oooSS---SoU--SCoooSS---SoU--S-SoU--SC-----------SSSSS---ooooSS---SoU--S--------------------------------------S-----------
SSSS----------------------------TT--SSSSS---SSS--SSSSSSS---SSS--S-SSS--SS--SSSS-------------SSSSSS---SSS--S---TT------------------------##-------------------
--------------------------TT----TT----------------------------------------------------------------------------TT-----------SS----------###-----------------SS
--------------------------TT----TT----------------------------------------------------------------------------TT----TT-----SS---------####--SSS-----TT-----SF
---M----------------------TT----TT-----------------------k---------------gg-----------------------------------TT----TT-----SS--------#####----------TT-----S#
XXXXX-XXXXXXXXXXXXXXXXXXXXXXXXXXXXXXXXXXXXXXXXXXXXXXXXXXXXXXXXXXXXXXXXXXXXXXXXX---X-XXXXXXXXXXXXXXXXXXXXXXXXXXXXXXXXXXXXX--XX--XXXXXXXXXXX-------XXXXXXXX--XX
XXXXX-XXXXXXXXXXXXXXXXXXXXXXXXXXXXXXXXXXXXXXXXXXXXXXXXXXXXXXXXXXXXXXXXXXXXXXXXX---X-XXXXXXXXXXXXXXXXXXXXXXXXXXXXXXXXXXXXX--XX--XXXXXXXXXXX-------XXXXXXXX--XX
