SSSSSSSSSSSSSSXXXXXXXXXXXXXXXXXXXXXXXXXXXXXXXXSSSSSSSSSSSSSSSSSSSSSSSSSSSSSSSSSS--SSSSSSSSSSSSSSSSSSSSSSSSSSSSSSSSSSSSSSSSSSSSSSSSSSSSSS------------SSSSSSSS-
SSSSS--SSSS---XXXXXXXXXXXXXXXXXXXXXXXXXXXXXXXXSSSSSSSSSSSS--SSSSSSSSSS--SSSSSSSS--SSSSSSS--SSSS----SSSSSS--SSSS--SSSSSS--SSSS--SSSSSSSSSSSSSSSSSSSSSSSSS-SSS-
SSSSS--SSSS-----------------------------------SSSSSSSSSSSS--SSSSSSSSSS--SSS---SS--SSSSSSS--SSSS----SSSSSS--SSSS--SSSSSS--SSSS--SSSSSSSSS-SSSSSS--SSSSSSS-SSS-
---SS---S----SSSSSSSSSSSSSSSSSSSSSSSSSSSSSSSSS----SS----SS---S------SS---S----SS--SS---SS---S----SSS---SS---S--------SS---SSS---S-----SS-SSSSSS--SSS---------
---SS---S----S------------------S--SSSSSS--SSS----SS----SS---S------SS---S----SS--SS---SS---S----SSS---SS---S--------SS---SSS---S-----SS-----SS---S----------
---SS---S----S------------------S--SSSSSS--SSS----SS----SS---S------SS---S-oooSS--SS---SS---S----SSX---SS---S--------SS---SSS---S-----SS-----SS---S----------
oooSS---SoU--S-------------------------SS---S-ooooSSooooSS---SoUooooSS---SoSSSSS--SSoooSS---SoU--SCXoooSS---SoU--ooooSS---SSS---SoooooSS-----SS---S----------
SSSSS---SSS--S-------------------------SS---S-SS--------------SSSS----------SSSS--SSSSSS---S----S------------------------------------------------------------
---------------------------------------SS---S-SS---SSSSSS----------SSSSSS-------------SS---S----S------------------------------------------------------------
-----------------------------------ooooSS---SoSS---SSSSSS----------SSSSSS-------------SS---SoU--S----------------------------------------------------SSU-----
--------------QQ--------#-#-----S--SSSSSS---SS----------------------------------------SS---SSS--S-------------TT------------------------##-------------------
#---------------------#-#-#-#---S------------------------------------------g----------------------------TT----TT-----------SS----------###-------------------
#-#-----------------#-#-#-#-#--TS-----------------------------------------------------------------------TT----TT----TT-----SS---------####--SS------#-------F
#-#M---------g----#-#-#-#-#-#--T-------kk---------------kk-----k---------gg-------------------g--g------TT----TT----TT-----SS--------#####---------##-------#
XXXXXXXXXXXXXXXXXXXXXXXXXXXXXXXXXXXXXXXXXXXXXXSS--XXXXXXXXXXXX--##XXXXXXXXXX-TT-------XXXXXXXXXXXXXXXXXXXXXXXXXXXXXXXXXXX--XX--XXXXXXXXXXX--------###XXXX--X-
XXXXXXXXXXXXXXXXXXXXXXXXXXXXXXXXXXXXXXXXXXXXXXSS--XXXXXXXXXXXX-###XXXXXXXXXX-TT-------XXXXXXXXXXXXXXXXXXXXXXXXXXXXXXXXXXX--XX--XXXXXXXXXXX-------####XXXX--XX
