SSSSXXXXXXXXXXXXXXXXXXXXXXSSSXXXXXXXXXXSSSSSSSSSSSSSSSSSSSSSSSSSSSSXXXXXXXXXXXXSX-X-XXXSSSSSSSSSSSSSSSSSXXXXXSSSSSSSSSSSSSSSXXXXXXXXXXXXXXXXXXXXXXXXXXXXXXXX-
-------------------------------------------------------------------------------------------------------------------------------------------------------------
-------------------------------------------------------------------------------------------------------------------------------------------------------------
SSSSSSSSSSSSSSSSSSSSSSSSSSSSSSSSSSSSSSSSSSSSSSSSSSSSSSSSSSSSSSSSSSSSSSSSSSSSSSSSS-S-SSSSSSSSSSSSSSSSSSSSSSSSSSSSSSSSSSSSSSSSSSSSSSSSSLSSSSSSSSSSSSSSSSS--SSSS
SSSS--SSSSSS--SS-------------------------SSSSSS--S-SSSSSS--SSSS-SSSS--SSSSSSSS-SS---SSSSS--SSSSSSS--SSSS------------------SS---------------------------------
SSSS--SSSSSS--SS-------------------------SSSSSS--S-SSSSSS--SSSS-SSSS--SSgSSSSS-SS---SSSSS--SSSSSSS--SSSS------------------SS---------------------------------
--SS------SS---S-----------------------------SS--------SS---S-----SS---S----SSS--------SS---SSSSSS---S--------------------------oooooo-----------------------
--SS------SS---S-----------------------------SS--------SS---S-----SS---S----SSS--------SS---SSSSSS---S-------------------------------------------------------
--SS------SS---S-----------------------------SS--------SS---S-----SS---S----SSS--------SS---SSSSSS---S--------------------------SSSSSS-----------------------
ooSS--ooooSS---S-------------------------ooooSS----ooooSS---SoU-ooSS---SooooSSS-----oooSS---SSSSSS---SoU------------------------SSSSSS-----------------SU----
SSSS--SSSSSS---S--------#-#-----TT-------SSSSSS----SSSSSS---SSS-SSSS---SSSSSSSSSS---SSSSS---SSSSSS---SSS------TT----------SS--------------------------#------
----------------------#-#-#-----TT---------------------------------------------SS-----------------------------TT------------------------#S-----------##------
--------------------#-#-#-#-----TT----TT---------------------------------------SS------------------------#----TT----TT------------------#S----------###-----F
---M--------------#-#-#-#-#-----TT----TT-----------------k---------------gg------------------------------#----TT----TT------------------#S---------####-----#
XXXXXXXXXXXXXXXXXXXXXXXXXXXXXXXXXXXXXXXXXXXXXXXXXXXXXXXXXXXXXXXXXXXXXXXXXXXXXXXXX-X-XXXXXXXXXXXXXXXXXXXXXXXXXXXXXXXXXXXXX-XX---XXXXXXXXXXX--XXXXXXXXXXXXX---X
XXXXXXXXXXXXXXXXXXXXXXXXXXXXXXXXXXXXXXXXXXXXXXXXXXXXXXXXXXXXXXXXXXXXXXXXXXXXXXXXX-X-XXXXXXXXXXXXXXXXXXXXXXXXXXXXXXXXXXXXX-XX---XXXXXXXXXXX--XXXXXXXXXXXXX---X
