#-#-#-#-#S#-#-#-#-#---####SSSSSSSSSSSSS-####-#-#-#-#-E-#-#SSSSSSSSSSSSSSSSSSSSSSSSSSSSSSSSSSSSSSSSSSSSSSSSSSSSSSSSSSSS###-#-#-#-#-E-#-#SSSSSSSSSSSSSS--#####-
#-#-#-#-#S#-#-#-#-#-E-####--SSSSSS--SSSSXXXXXXXXXXXXXXXXXXSSSSSSSS--SSSSSS-SSSSSS--SSSSSSSSSSSSS--S-SSSSSS--SSSSSSSSSSXXXXXXXXXXXXXXXXXSSSSSSSS--SSSSXXXXXXX-
XXXXXXXXXSXXXXXXXXXXXXXXXX--SSSSSS--SSSSXXXXXXXXXXXXXXXXXXSSSSSSSS--SSSSSS-SSSSSS--SSSSSSSSSSSSS--S-SSSSSS--SSSSSSSSSSXXXXXXXXXXXXXXXXXSSSSSSSS--SSSSXXXXXXX-
XXXXXXXXXSXXXXXXXXXXXXXXXXSS----SS---S-SSSSSSSSSSSSSSSSSSSSSSSSSSSSSSSSSSSSSSSSSSSSSSSSSSSSSSSSSSSSSSSSSSSSSSSSSSSSSSSSSSSSSSSSSSSSSSSSSSS-------------------
SSSSS--SSSSSS--SSSS-------------SS---S-SS--SSSS---SSSSSS-SSS-SS--SSSS--SS--SSSS----------SSSSS--SSS----------------------------SSSS--------------------------
SSSSS--SSSSSS--SSSS-------------SS---S-SS--SSSS---SSSSSS-SSS-SS--SSSS--SS--SSSS----------SSSSS--SSS----------------------------SSSS--------------------------
---SS---S--SS---S-----------ooooSS---SoSS---S---------SS--SS-SS---S----SS---S--------ooo--SSSS---S-------------------------------SS---------SSS--------------
---SS---S--SS---S-----------SSSSSS---SSSS---S---------SS--SS-SS---S----SS---S-------------SSSS---S-------------------------------SS--------------------------
---SS---S--SS---S----------------------SS---S---------SS--SS-SS---S----SS---S--------SSS--SSSS---S-------------------------------SS--------------------------
oooSS---SooSS---SoU---------------------S---SoU---ooooSS-oSS-SS---SoU--SS---SoU------SSS--SSSS---So------------------------------SS---------------SSSSSSU----
SSSSS---SSSSS---SSS-----####----TT------S---SSS---SSSSSS-SSS-SS---SSS--SS---SSS-----------SSSS---SS-----------TT-----------------SS-----##-------------------
-----------------------#####----TT----------------------------------------------------------------------TT----TT-----------SS----------###-------------------
----------------------######----TT----TX----------------------------------------------------------------TT----TT----TT-----SS---------####--SSS-------------F
---M-----------------#######----TT----TX----------------------------------------------------------------TT----TT----TT-----SS--------#####------------------#
XXXXXXXXXXXXXXXXXXXXXXXXXXXXXXXXXXXXXXXXXXXXXXXXXXXXXXXXXXXXXXXXXXXXXXXXXXXXXXXXX---XXXXXXXXXXXXXXXXXXXXXXXXXXXXXXXXXXXXX--XX--XXXXXXXXXXX--------XXXXXXXX--X
XXXXXXXXXXXXXXXXXXXXXXXXXXXXXXXXXXXXXXXXXXXXXXXXXXXXXXXXXXXXXXXXXXXXXXXXXXXXXXXXX---XXXXXXXXXXXXXXXXXXXXXXXXXXXXXXXXXXXXX--XX--XXXXXXXXXXX--------XXXXXXXX--X
