---------SSSSSSSSSSSSSSSSSSSSSSSSSSSSSSSSSSSSSSSSSSSSSSSSSSSSSSSSSS-----------SS---SSSSSSSSSSSSSSSSSSSSSSSSSSSSSSSSSSSSSS-SSSSSSSS--SSSSSS-SSSSSSSSSSSSSSSSSS
SSSSSSSSS--SS--SSSSSS--SSS--SSSSSS--SSSSSS-SS--SSSSSS--SSSSSSSS--SSSSSSSSSS---SS-----SSSS----SSSSSSSSSSS------SS--SSSSSSS-SS--SSSS--SSSS---SSSS--SSSS--SSSS--
SSSSS--SS--SS--SSSSSS--SSS--SSSSSS--SSSSSS-SS--SSSSSS--SSSSSSSS--SSSSSS--SSSSSSS-----SSSS----SSSSS----SS------SS--SSSSSSS-SS--SSSSSSSSSS---SSSS--SSSS--SSSS--
SSSSS--SSSS--------SS-----------SS---S--SSS--------SS---S----SS---SSSSS--SSSSS--------S----SS---SS----SS----SS--------S---SS---S--SS--SS-----SS---S----------
---SS---SSS--------SS-----------SS---S--SSS--------SS---S----SS---S--SS---SSSS--------S----SS---SS----SS----SS--------S---SS---S--SS--SS-----SS---S----------
---SS---SSS--------SS-----------SS---S--SSS--------SS---S----SS---S--SS-g-S-SS--------S----SS---SSooooSS----SS--------S---SS---S--SS--SS-----SS---S----------
---SS---SSS----ooooSS-------ooooSS---SooSSS----ooooSS---SooooSS---S--SS---S-SSoo------SoU--SCoooSSSSSSSS----SS----ooooSoo-SS---SoUSSooSS---ooSS---SoU--------
oooSS---SSSSS--SSSSSS--SSS--SSSSSS---SSSSSSSS--SSSSSS---SSSSSSS---SooSS---S-SSSS------SSS--SSSSSSS----------SSSS--SSSSSSS-SS---SSSSSSSSS---SSSS---SSS--SSSS--
SSSSS---S--SS------------------------------SS----------------------SSSS---SoSS--------------------------------SS------------------SS-------------------------
-----------SS------------------------------SS------------------------------SSS--------------------------------SS------------------SS-------------------------
------------------------#-#-----TT---------SSS---SSS--SS--------------------SS--------------------------T-----TT------------------------##-------------------
----------------------#-#-#T----TT-----------------------------------------g----------------------------TT----TT----T------------------###-----------------SS
XXXXXXXXX-----------#-#-#-#T----TT----------------------------------------------------------------------TT----TT----T-----------------####--SSS-----TT-----SF
XXXMXXXXX---gg----#-#-#-#-#T----TT-----kk---------------kk-gg-----------ggg-------------------ggggg-----TT----TT----TS------------ggg#####-------r--TT-----S#
XXXXXXXXXXXXXXXXXXXXXXXXXXXXXXXXXXXXXXXXXXXXXXXXXXXXXXXXXXXXXXXXXXXXXXXXXXXXXXX-----XXXXXXXXXXXXXXXXXXXXXXXXXXXXXXXXXS----------#XXXXXXXXX--------XXXXXXX--XX
XXXXXXXXXXXXXXXXXXXXXXXXXXXXXXXXXXXXXXXXXXXXXXXXXXXXXXXXXXXXXXXXXXXXXXXXXXXXXXX-----XXXXXXXXXXXXXXXXXXXXXXXXXXXXXXXXXS---------##XXXXXXXXX--------XXXXXXX--XX
