-------------------------------------------------------------------------------------------------------------------------------------------------------------
-------------------------------------------------------------------------------------------------------------------------------------------------------------
-------------------------------------------------------------------------------------------------------------------------------------------------------------
SSSSSSSSSSSSSSSSSSSSSSSSSSSSSSSSSSSSSSSSSSSSSSSSSSSSSSSSSSSSSSSSSSSSSSSSSSSSSSSS--SSSSSSSSSSSSSSSSSSSSSSSSSSSSSSSSSSSSSSSSSSSSSSSSSSSSSSSS------SSSSSSSSSSSSS
SSSS--SSSSSS--SSSS--------------SSSSSSSSSSSSSSSSS--SSSSSSS--SSSS------SS----SSSS------SSSSSSS--SSSS------SSSS--------------S---------------------------------
SSSS--SSSSSS--SSSS--------------SSSSSSSSSSSSSSSSS--SSSSSSS--SSSS------SS----SSSS------SSSSSSS--SSSS------SSSS--------------S---------------------------------
-SS-------SS---S--------------------SS----SS---SS---S---SS---S----SS----SS----------oo---SSSS---S----SS-------------------------ooooo-------SSS--------------
-SS-------SS---S--------------------SS----SS---SS---S---SS---S----SS----SS---------------SSSS---S----SS------------------------------------------------------
-SS-------SS---S--------------------SS----SS---SS---S---SS---S----SS----SS----------SS---SSSS---S----SS-------------------------SSSSS------------------------
oSS---ooooSS---SoU--------------ooooSSooooSSoooSS---SoUoSS---SoU--SC----SC----------SSoooSSSS---SoU--SC-------------------------SSSSS--------------------C---
SSSS--SSSSSS---SSS--------TT----SSSSSSSSSSSSSSSSS---SSSSSS---SSS--SS--SSSS--SSSS------SSSSSSS---SSS--SS--SSSS-TT-----------S------------##---------#-#-------
---S----------------TT----TT----------------------------------------------------------------------------T-----TT-----------------------###-------#-#-#-#---#-
---S----------------TT----TT----------------------------------------------------------------------------------TT----TT----------------####--SSS--#-#-#-#---#F
---M---------g------TT----TT-----------kk----------------k--------------ggg-----------------------------------TT----TT---------------#####-------#-#r#-#-E-##
XXXXXXXXXXXXXXXXXXXXXXXXXXXXXXXXXXXXXXXXXXXXXXXXXXXXXXXXXXXXXXXXXXXXXXXXXXXXXXXX---XXXXXXXXXXXXXXXXXXXXXXXXXXXXXXXXXXXXXX--X---XXXXXXXXXXX------XXXXXXXXXXXXX
XXXXXXXXXXXXXXXXXXXXXXXXXXXXXXXXXXXXXXXXXXXXXXXXXXXXXXXXXXXXXXXXXXXXXXXXXXXXXXXX---XXXXXXXXXXXXXXXXXXXXXXXXXXXXXXXXXXXXXX--X---XXXXXXXXXXX------XXXXXXXXXXXXX
