-------------------------------------------------------------------------------------------------------------------------------------------------------------
-------------------------------------------------------------------------------------------------------------------------------------------------------------
-------------------------------------------------------------------------------------------------------------------------------------------------------------
SSSSSSSSSSSSSSSSSSSSSSSSSSSSSSSSSSSSSSSSSSSSSSSSSSSSSSSSSSSSSSSSSSSSSSSSSSSSSSSS--SSSSSSSSSSSSSSSSSSSSSSSSSSSSSSSSSSSSSSSSSSSSSSSSSSSSSSSS-----------SSSS----
SSSSS--SSSSSS--SSSS--------------S--SSSSSS--SSSSSS--SSSS-SSSSS--SSSSSSSSS--SSSS------SSSSSSSSSS-SS--SSSS-----------SSSS--SSS-------SS--SS--------------------
SSSSS--SSSSSS--SSSS--------------S--SSSSSS--SSSSSS--SSSS-SSSSS--SSSSSSSSS--SSSS------SSSSSSSSSS-SS--SSSS-----------SSSS--SSS-------SS--SS--------------------
--SS-------SS---S-----------------------SS---S--SS---S------SS---S-----SS---S-----S----SS----SS-SS---S----SS----S---------------oooSS---S---SSS------------SS
--SS-------SS---S-----------------------SS---S--SS---S------SS---S-----SS---S-----S----SS----SS-SS---S----SS----S------------------SS---S--------------------
--SS-------SS---S-----------------------SS---S--SS---S------SS---S-----SS---S-----S----SS----SS-SS---S----SS----S---------------SSSSS---S--------------------
ooSS---ooooSS---SoU-----------------ooooSS---SooSS---SoU-oooSS---SoUoooSS---SoU---C--ooSSooooSS-SS---SoU--SC----C---------------SSSSS---S--------SSSS--------
SSSSS--SSSSSS---SSS----###TT-----S--SSSSSS---SSSSS---SSS-SSSSS---SSSSSSSS---SSS---S--SSSSSSSSSS-SS---SSS--SS--T#S--SSSS--SSS-------SS---S#-------------##----
----S-----------------####TT---TTS----------------------------------------------------------------------T-----##-------------------------#------------###----
----S----------------#####TT---TTS----------------------------------------------------------------------------##-------------------------#--SSS------####--SF
---M---------g-------#####TT---TT------kk----------------k--------------ggg-----------------------------------##----T--------------------#----------r####---#
XXXXXXXXXXXXXXXXXXXXXXXXXXXXXXXXXXXXXXXXXXXXXXXXXXXXXXXXXXXXXXXXXXXXXXXXXXXXXXXX--XXXXXXXXXXXXXXXXXXXXXXXXXXXXXXXXXXXXX--XXX---XXXXXXXXXXX-------XXXXXXXX----
XXXXXXXXXXXXXXXXXXXXXXXXXXXXXXXXXXXXXXXXXXXXXXXXXXXXXXXXXXXXXXXXXXXXXXXXXXXXXXXX--XXXXXXXXXXXXXXXXXXXXXXXXXXXXXXXXXXXXX--XXX---XXXXXXXXXXX-------XXXXXXXX----
