-------------------------------------------------------------------------------------------------------------------------------------------------------------
-------------------------------------------------------------------------------------------------------------------------------------------------------------
-------------------------------------------------------------------------------------------------------------------------------------------------------------
SSSSSSSSSSSSSSSSSSSSSSSSSSSSSSSSSSSSSSSSSSSSSSSSSSSSSSSSSSSSSSSSSSSSSSSSSSSSSSSS--SSSSSSSSSSSSSSSSSSSSSSSSSSSSSSSSSSSSSSSSSSSSSSSSSSSLSSSSSSS----------------
SSSS--SSSSSSSS--SSSS------------SSSSSS--SSSS-SSS--SSSSSSSSSSSSS--SSSSSSSS-SSSSSS---SSSSSS--SSSS-------------------------SSSS------------SS-------------------
SSSS--SSSSSSSS--SSSS------------SSSSSS--SSSS-SSS--SSSSSSSSSSSSS--SSSSSSSS-SSSSSS---SSSSSS--SSSS-------------------------SSSS------------SS-------------------
--SS---S----SS---S------------------SS---S----SS---S----SS---SS---S--S-SS-----SS-------SS---S-------------------------SS--------oooooo-------SS--------------
--SS---S----SS---S------------------SS---S----SS---S----SS---SS---S--S-SS-----SS-------SS---S-------------------------SS-------------------------------------
--SS---S----SS---S------------------SS---S----SS---S----SS---SS---S--S-SS-----SS-------SS---S-------------------------SS--------SSSSSS-----------------------
ooSS---SoUooSS---SoU------------ooooSS---SoU-oSS---SooooSSoooSS---SoUSoSS-ooooSS---ooooSS---SoU-----------------------SS--------SSSSSS-----------SSSSSSU-----
SSSS---SSSSSSS---SSS------TT----SSSSSS---SSS-SSS---SSSSSSSSSSSS---SSSSSSS-SSSSSS---SSSSSS---SSS---------------TT------SSSSSS------------SS-------------------
---------------------T----TT----------------------------------------------------------------------------TT----TT---------------------------------------------
---------------------T----TT----------------------------------------------------------------------------TT----TT-----------------------------SS-------------F
---M---------g-------T----TT-----------kk----------------k--------------ggg-----------------------------TT----TT----T-------------------------------r-------#
XXXXXXXXXXXXXXXXXXXXXXXXXXXXXXXXXXXXXXXXXXXXXXXXXXXXXXXXXXXXXXXXXXXXXXXXXXXXXXXX--XXXXXXXXXXXXXXXXXXXXXXXXXXXXXXXXXXXXXXXXXX---XXXXXXXXXXX-------XXXXXXXX--X-
XXXXXXXXXXXXXXXXXXXXXXXXXXXXXXXXXXXXXXXXXXXXXXXXXXXXXXXXXXXXXXXXXXXXXXXXXXXXXXXX--XXXXXXXXXXXXXXXXXXXXXXXXXXXXXXXXXXXXXXXXXX---XXXXXXXXXXX-------XXXXXXXX--XX
