-------------------------------------------------------------------------------------------------------------------------------------------------------------
-------------------------------------------------------------------------------------------------------------------------------------------------------------
-------------------------------------------------------------------------------------------------------------------------------------------------------------
SSSSSSSSSSSSSSSSSSSSSSSSSSSSSSSSSSSSSSSSSSSSSSSSSSSSSSSSSSSSSSSSSSSSSSSSSSSSSSSS--SSSSSSSSSSSSSSSSSSSSSSSSSSSSSSSSSSSSSSSSSSSSSSSSSSSSSSSSSSSSSSSSSSSSSSSSSSS
SSSS--SSSS--SSSSSS--SSS--------------SSSS--SSSSS--SSSSSSS--SSSS--SSS--SSSSSSSS-S---SSSSSS--SSSS-SS--SSSS-SSS--------------------------SSSS-------------------
SSSS--SSSS--SSSSSS--SSS--------------SSSS--SSSSS--SSSSSSS--SSSS--SSS--SSSSSSSS-S---SSSSSS--SSSS-SS--SSSS-SSS--------------------------SSSS-------------------
S-SS---S--------SS---S-----------------SS---S-SS---S---SS---S-----SS---S----SS---------SS---S---SS---S----------------------------SS-------------------------
S-SS---S--------SS---S-----------------SS---S-SS---S---SS---S-----SS---S----SS---------SS---S---SS---S----------------------------SS-------------------------
S-SS---S--------SS---S-----------------SS---S-SS---S---SS---S-----SS---S----SS---------SS---S---SS---S----------------------------SS-------------------------
SoSS---SoU--ooooSS---So--------------ooSS---SoSS---SoooSS---SoU--oSS---SoUooSS-----ooooSS---SoU-SS---SoU--------------------------SC-------------------------
SSSS---SSS--SSSSSS---SS---------TT---SSSS---SSSS---SSSSSS---SSS--SSS---SSSSSSS-S---SSSSSS---SSS-SS---SSS-SSS--TT------------------SS--SSSS------------##-----
S-------------------------TT----TT---------------------------------------------S------------------------T-----TT-----------SS--S---------------------###---SS
S-------------------------TT----TT---------------------------------------------S------------------------------TT----TT-----SS--S--------------------####---SF
S--M---------g------------TT----TT-----kk----------------k--------------ggg-----------------------------------TT----TT-----SS--S-------------------#r###---S#
XXXXXXXXXXXXXXXXXXXXXXXXXXXXXXXXXXXXXXXXXXXXXXXXXXXXXXXXXXXXXXXXXXXXXXXXXXXXXXXX--XXXXXXXXXXXXXXXXXXXXXXXXXXXXXXXXXXXXXXX--XX--XXXXXXXXXXX---XXXXXXXXXXXX--XX
XXXXXXXXXXXXXXXXXXXXXXXXXXXXXXXXXXXXXXXXXXXXXXXXXXXXXXXXXXXXXXXXXXXXXXXXXXXXXXXX--XXXXXXXXXXXXXXXXXXXXXXXXXXXXXXXXXXXXXXX--XX--XXXXXXXXXXX---XXXXXXXXXXXX--XX
