-------------------------------------------------------------------------------------------------------------------------------------------------------------
-------------------------------------------------------------------------------------------------------------------------------------------------------------
-------------------------------------------------------------------------------------------------------------------------------------------------------------
SSSSSSSSSSSSSSSSSSSSSSSSSSSSSSSSSSSSSSSSSSSSSSSSSSSSSSSSSSSSSSSSSSSSSSSSSSSSSSSS--SSSSSSSSSSSSSSSSSSSSSSSSSSSSSSSSSSSSSSSSSSSSSSSSSSSSSSSSSSSSSSSSSSSSSSS----
SSSS--SSSSSS--SSSS--------------SSSSSS--SSSSSSS--SSSSSSS-SSSSSS--SSSS-----SSSSSS---SSSSSS--SSS-SSSS------SSSS--------------S---S------SSSS-------------------
SSSS--SSSSSS--SSSS--------------SSSSSS--SSSSSSS--SSSSSSS-SSSSSS--SSSS-----SSSSSS---SSSSSS--SSS-SSSS------SSSS--------------S---S------SSSS-------------------
--SS------SS---S--------------------SS---S---SS---S---SS-----SS---S----SS-----SS-------SS---S---S----SS---------------------------SS----------o------------SS
--SS------SS---S--------------------SS---S---SS---S---SS-----SS---S----SS-----SS-------SS---S---S----SS---------------------------SS-------------------------
--SS------SS---S--------------------SS---S---SS---S---SS-----SS---S----SS-----SS-------SS---S---S----SS---------------------------SS----------S--------------
ooSS--ooooSS---SoU--------------ooooSS---SoooSS---SoooSS-ooooSS---SoU--SC-ooooSS---ooooSS---So--SoU--SC------------------------U--SC----------S--------------
SSSS--SSSSSS---SSS--------TT----SSSSSS---SSSSSS---SSSSSS-SSSSSS---SSS--SS-SSSSSS---SSSSSS---SS--SSS--SS--SSSS-TT-----------S---S--SS--SSSS-------------##----
--------------------TT----TT----------------------------------------------------------------------------T-----TT---------------------------------SS---###----
--------------------TT----TT----------------------------------------------------------------------------------TT----TT---------------------------SS--####--SF
---M---------g------TT----TT-----------kk----------------k--------------ggg-----------------------------------TT----TT---------------------------SS-r####---#
XXXXXXXXXXXXXXXXXXXXXXXXXXXXXXXXXXXXXXXXXXXXXXXXXXXXXXXXXXXXXXXXXXXXXXXXXXXXXXXX--XXXXXXXXXXXXXXXXXXXXXXXXXXXXXXXXXXXXXXX--X---XXXXXXXXXXX---XX--XXXXXXXX----
XXXXXXXXXXXXXXXXXXXXXXXXXXXXXXXXXXXXXXXXXXXXXXXXXXXXXXXXXXXXXXXXXXXXXXXXXXXXXXXX--XXXXXXXXXXXXXXXXXXXXXXXXXXXXXXXXXXXXXXX--X---XXXXXXXXXXX---XX--XXXXXXXX----
