-------------------------------------------------------------------------------------------------------------------------------------------------------------
-------------------------------------------------------------------------------------------------------------------------------------------------------------
-------------------------------------------------------------------------------------------------------------------------------------------------------------
SSSSSSSSSSSSSSSSSSSSSSSSSSSSSSSSSSSSSSSSSSSSSSSSSSSSSSSSSSSSSSSSSSSSSSSSSSSSSSSS--SSSSSSSSSSSSSSSSSSSSSSSSSSSSSSSSSSSSSSSSSSSSSSSSSSSSSSSSSSSSSSSSSSSSSSSSSSS
SSSS--SSSS-------------------------SSSSSS--SSS-SS--SSSSSS--SSS--SSSS--SSSS-----S---SSSSSS--SSSS--------------------SSSSSSSSS---------------------------------
SSSS--SSSS-------------------------SSSSSS--SSS-SS--SSSSSS--SSS--SSSS--SSSS-----S---SSSSSS--SSSS--------------------SSSSSSSSS---------------------------------
SSSS---S----SS-------------------------SS---S-S--------SS---SS---SSS---S----SS---------SS---S----SS--------------------SS-------oooo-------------------------
SSSS---S----SS-------------------------SS---S-S--------SS---SS---SSS---S----SS---------SS---S----SS--------------------SS------------------------------------
SSSS---S----SS-------------------------SS---S-S--------SS---SS---SSS---S----SS---------SS---S----SS--------------------SS-------SSSS-------------------------
SSSS---SoU--SC---------------------ooooSS---SoS----ooooSS---SS---SSS---SoU--SC-----ooooSS---SoU--SC----------------ooooSS-------SSSS-------------------------
SSSS---SSS--SS------------TT-----##SSSSSS---SSSSS--SSSSSS---SS---SSS---SSS--SS-S---SSSSSS---SSS--SS-----------TT---SSSSSSSSS------------##----------###T-----
--------------------TT----TT----###------------SS-------------------------------------------------------TT----TT-----------------------###---------####T---SS
--------------------TT----TT---####------------SS-------------------------------------------------------TT----TT----------------------####--------#####T---SF
---M---------g------TT----TT--#####----kk----------------k--------------ggg-----------------------------TT----TT----T----------------#####-------###r##T---S#
XXXXXXXXXXXXXXXXXXXXXXXXXXXXXXXXXXXXXXXXXXXXXXXXXXXXXXXXXXXXXXXXXXXXXXXXXXXXXXXX---XXXXXXXXXXXXXXXXXXXXXXXXXXXXXXXXXXXXXXXXX---XXXXXXXXXXXXXXXXXXXXXXXXXX--XX
XXXXXXXXXXXXXXXXXXXXXXXXXXXXXXXXXXXXXXXXXXXXXXXXXXXXXXXXXXXXXXXXXXXXXXXXXXXXXXXX---XXXXXXXXXXXXXXXXXXXXXXXXXXXXXXXXXXXXXXXXX---XXXXXXXXXXXXXXXXXXXXXXXXXX--XX
