-------------------------------------------------------------------------------------------------------------------------------------------------------------
-------------------------------------------------------------------------------------------------------------------------------------------------------------
-------------------------------------------------------------------------------------------------------------------------------------------------------------
SSSSSSSSSSSSSSSSSSSSSSSSSSSSSSSSSSSSSSSSSSSSSSSSSSSSSSSSSSSSSSSSSSSSSSSSSSSSSSSS--SSSSSSSSSSSSSSSSSSSSSSSSSSSSSSSSSSSSSSSSSSSSSSSSSSSSSSSSSSSSSSSSSSSSSSS-SSS
SSSSSSSSSSSSSS--SSS-----------------S--SS--SSSSSS--SSSSSS--SSSS--SSSS------SSSSS---SSSSSSSSSSSSSS--SS-------------------SSSS----------SSSS-------------------
SSSSSSSSSSSSSS--SSS-----------------S--SS--SSSSSS--SSSSSS--SSSS--SSSS------SSSSS---SSSSSSSSSSSSSS--SS-------------------SSSS----------SSSS-------------------
--SS---SS-SSSS---S------------o-----S---S------SS------SS---SSS---S----SS------S----S-----SS---SS---S-----------------S---------ooSS-------------------------
--SS---SS-SSSS---S------------------S---S------SS------SS---SSS---S----SS------S----S-----SS---SS---S-----------------S-----------SS-------------------------
--SS---SS-SSSS---S------------S-----S---S------SS------SS---SSS---S----SS------S----S-----SS---SS---S-----------------S---------SSSS-------------------------
ooSSoooSSoSSSS---So-----------------S---S--ooooSS--ooooSS---SSS---SoU--SC--ooooS----SoUoooSSoooSS---S-----------------S---------SSSC-------------------------
SSSSSSSSSSSSSS---SS-------TT----TT--S---S--SSSSSS--SSSSSS---SSS---SSS--SS--SSSSS----SSSSSSSSSSSSS---S---------TT------S-SSSS------SS--SSSS---------##--##----
--------------------TT----TT----TT----------------------------------------------------------------------TT----TT----------------------------------###-###--S-
--------------------TT----TT----TT----------------------------------------------------------------------TT----TT---------------------------------########--SF
---M---------g------TT----TT----TT-----kk----------------k--------------ggg-----------------------------TT----TT----T---------------------------####r####--S#
XXXXXXXXXXXXXXXXXXXXXXXXXXXXXXXXXXXXXXXXXXXXXXXXXXXXXXXXXXXXXXXXXXXXXXXXXXXXXXXX--XXXXXXXXXXXXXXXXXXXXXXXXXXXXXXXXXXXXXXXXXX---XXXXXXXXXXX--XXXXXXXXXXXXX--XX
XXXXXXXXXXXXXXXXXXXXXXXXXXXXXXXXXXXXXXXXXXXXXXXXXXXXXXXXXXXXXXXXXXXXXXXXXXXXXXXX--XXXXXXXXXXXXXXXXXXXXXXXXXXXXXXXXXXXXXXXXXX---XXXXXXXXXXX--XXXXXXXXXXXXX--XX
