-------------------------------------------------------------------------------------------------------------------------------------------------------------
-------------------------------------------------------------------------------------------------------------------------------------------------------------
-------------------------------------------------------------------------------------------------------------------------------------------------------------
SSSSSSSSSSSSSSSSSSSSSSSSSSSSSSSSSSSSSSSSSSSSSSSSSSSSSSSSSSSSSSSSSSSSSSSSSSSSSSSS--SSSSSSSSSSSSSSSSSSSSSSSSSSSSSSSSSSSSSSSSSSSSSSSSSSSSSSSSSSSSSSSSSSSSSSSSSSS
SSSS--SSSSSSS--SSSS---------------SSSSSSSSSSS--SS--SSSSSS--SSSSSSSSS--SSSSSSSS-----SSSSSS--SSSS-----S----------------------------SSSS--SS--------------------
SSSS--SSSSSSS--SSSS---------------SSSSSSSSSSS--SS--SSSSSS--SSSSSSSSS--SSSSSSSS-----SSSSSS--SSSS-----S----------------------------SSSS--SS--------------------
--SS---S---SS---S------------------SSS-SS--SSSS--------SS---SS----SS---S----SS---------SS---S----SS--------------------------------SS---S--------------------
--SS---S---SS---S------------------SSS-SS--SSSS--------SS---SS----SS---S----SS---------SS---S----SS--------------------------------SS---S--------------------
--SS---S---SS---S------------------SSS-SS--SSSS--------SS---SS----SS---S----SS---------SS---S----SS--------------------------------SS---S--------------------
ooSS---SoooSS---SoU---------------oSSSoSSooSSSS----ooooSS---SSooooSS---SooooSS-----ooooSS---SoU--SC------------------------------ooSS---S--------------------
SSSS---SSSSSS---SSS-------TT------SSSSSSSSSSSSSSS--SSSSSS---SSSSSSSS---SSSSSSS-----SSSSSS---SSS--SS-----------TT-----------------SSSS---S-------------##-----
--------------------TT----TT-------------------SS-------------------------------------------------------TT----TT-----------SS------------S-----------###---SS
--------------------TT----TT----TT-------------SS-------------------------------------------------------TT----TT----TT-----SS------------S----------####---SF
---M---------g------TT----TT----TT-----kk----------------k--------------ggg-----------------------------TT----TT----TT-----SS------------S---------#r###---S#
XXXXXXXXXXXXXXXXXXXXXXXXXXXXXXXXXXXXXXXXXXXXXXXXXXXXXXXXXXXXXXXXXXXXXXXXXXXXXXXX---XXXXXXXXXXXXXXXXXXXXXXXXXXXXXXXXXXXXXX--XX--XXXXXXXXXXX--XXXXXXXXXXXXX--XX
XXXXXXXXXXXXXXXXXXXXXXXXXXXXXXXXXXXXXXXXXXXXXXXXXXXXXXXXXXXXXXXXXXXXXXXXXXXXXXXX---XXXXXXXXXXXXXXXXXXXXXXXXXXXXXXXXXXXXXX--XX--XXXXXXXXXXX--XXXXXXXXXXXXX--XX
