-------------------------------------------------------------------------------------------------------------------------------------------------------------
-------------------------------------------------------------------------------------------------------------------------------------------------------------
-------------------------------------------------------------------------------------------------------------------------------------------------------------
SSSSSSSSSSSSSSSSSSSSSSSSSSSSSSSSSSSSSSSSSSSSSSSSSSSSSSSSSSSSSSSSSSSSSSSSSSSSSSSS--SSSSSSSSSSSSSSSSSSSSSSSSSSSSSSSSSSSSSSSSSSSSSSSSSSSSSSSSSSSSSSSSSSSSSS--SSS
SSSS--SSSSSS--SSSS---------------SSSSS-SS--SSSSSS--SSSSSSSSSSS--SSSSSSSSS--SSSSS---SSSSSS--SSSSSS-----------------------SSSS---------------------------------
SSSS--SSSSSS--SSSS---------------SSSSS-SS--SSSSSS--SSSSSSSSSSS--SSSSSSSSS--SSSSS---SSSSSS--SSSSSS-----------------------SSSS---------------------------------
--SS------SS---S--------------S------S---------SS---S---SS--SS---S-----SS----SS--------SS---S--SS---------------------SS--------ooo--------------------------
--SS------SS---S--------------S------S---------SS---S---SS--SS---S-----SS----SS--------SS---S--SS---------------------SS-------------------------------------
--SS------SS---S--------------S------S---------SS---S---SS--SS---S-----SS----SS--------SS---S--SS---------------U-----SS--------SSS--------------------------
ooSS--ooooSS---SoU------------C------S-----ooooSS---SoUoSSooSS---SoooooSS--ooSS----ooooSS---SoUSS--------------oS-----SS--------SSS--------------------------
SSSS--SSSSSS---SSS--------TT--S--SSSSS-SS--SSSSSS---SSSSSSSSSS---SSSSSSSS--SSSSS---SSSSSS---SSSSS-------------TSS-----SSSSSS------------##------------##-----
--------------------TT----TT-----------SS--------------------------------------S------------------------TT----T------------------------###-----------###---SS
--------------------TT----TT-----------SS--------------------------------------S------------------------TT----T-----------------------####----------####---SF
---M---------g------TT----TT-----------kk----------------k--------------ggg-----------------------------TT----T-----T----------------#####---------#r###---S#
XXXXXXXXXXXXXXXXXXXXXXXXXXXXXXXXXXXXXXXXXXXXXXXXXXXXXXXXXXXXXXXXXXXXXXXXXXXXXXXX--XXXXXXXXXXXXXXXXXXXXXXXXXXXXXXXXXXXXXXXXXX---XXXXXXXXXXX--XXXXXXXXXXXX---XX
XXXXXXXXXXXXXXXXXXXXXXXXXXXXXXXXXXXXXXXXXXXXXXXXXXXXXXXXXXXXXXXXXXXXXXXXXXXXXXXX--XXXXXXXXXXXXXXXXXXXXXXXXXXXXXXXXXXXXXXXXXX---XXXXXXXXXXX--XXXXXXXXXXXX---XX
