-------------------------------------------------------------------------------------------------------------------------------------------------------------
-------------------------------------------------------------------------------------------------------------------------------------------------------------
-------------------------------------------------------------------------------------------------------------------------------------------------------------
SSSSSSSSSSSSSSSSSSSSSSSSSSSSSSSSSSSSSSSSSSSSSSSSSSSSSSSSSSSSSSSSSSSSSSSSSSSSSSSS--SSSSSSSSSSSSSSSSSSSSSSSSSSSSSSSSSSSSSSSSSSSSSSSSSSSLSSSSSSSSSSSSSSSSSSS--SS
SSSSSSSSSSSS--SSSS--------------SSSSSS-SSSSSSSS--SSSS------SSSS--SSSS-----SSS--S---SSSSSSSSSSSS--SS-----SSS---------------SS-------------SS------------------
SSSSSSSSSSSS--SSSS--------------SSSSSS-SSSSSSSS--SSSS------SSSS--SSSS-----SSS--S---SSSSSSSSSSSS--SS-----SSS---------------SS-------------SS------------------
-SS-SS----SS---S--------------------SS-S-SS--SS---S----SS----SS---S----SS--SSSS--------SS-SS-SS---S-SS--------------------------oooooo-----------------------
-SS-SS----SS---S--------------------SS-S-SS--SS---S----SS----SS---S----SS--SSSS--------SS-SS-SS---S-SS-------------------------------------------------------
-SS-SS----SS---S--------------------SS-S-SS--SS---S----SS----SS---S----SS--SSSS--------SS-SS-SS---S-SS--------------------------SSSSSS-----------------------
oSSoSSooooSS---SoU--------------ooooSS-SoSSooSS---SoU--SC---oSS---SoU--SC-oSSSS----ooooSSoSSoSS---S-SC--------------------------SSSSSS-----------------------
SSSSSSSSSSSS---SSS--------TT----SSSSSS-SSSSSSSS---SSS--SS--SSSS---SSS--SS-SSSSSS---SSSSSSSSSSSS---S-SS--SSS---TT----------SS-------------SS------------##----
--------------------TT----TT---------------------------------------------------S------------------------T-----TT--------------------------------------###--SS
--------------------TT----TT---------------------------------------------------S------------------------------TT----TT-------------------------------####--SF
---M---------g------TT----TT-----------kk----------------k--------------ggg-----------------------------------TT----TT------------------------------r####--S#
XXXXXXXXXXXXXXXXXXXXXXXXXXXXXXXXXXXXXXXXXXXXXXXXXXXXXXXXXXXXXXXXXXXXXXXXXXXXXXXX--XXXXXXXXXXXXXXXXXXXXXXXXXXXXXXXXXXXXXXX-XX---XXXXXXXXXXXX---XXXXXXXXXXX--XX
XXXXXXXXXXXXXXXXXXXXXXXXXXXXXXXXXXXXXXXXXXXXXXXXXXXXXXXXXXXXXXXXXXXXXXXXXXXXXXXX--XXXXXXXXXXXXXXXXXXXXXXXXXXXXXXXXXXXXXXX-XX---XXXXXXXXXXXX---XXXXXXXXXXX--XX
