-------------------------------------------------------------------------------------------------------------------------------------------------------------
-------------------------------------------------------------------------------------------------------------------------------------------------------------
-------------------------------------------------------------------------------------------------------------------------------------------------------------
SSSSSSSSSSSSSSSSSSSSSSSSSSSSSSSSSSSSSSSSSSSSSSSSSSSSSSSSSSSSSSSSSSSSSSSSSSSSSSSS--SSSSSSSSSSSSSSSSSSSSSSSSSSSSSSSSSSSSSSSSSSSSSSSSSSSSSSSSSSSSSSSSSSSSSSSSSSS
SSSS--SSSS-----------------------------S--SSSSSS--SSSSSS--SSSS--SSSS----SSSSSS----SS-SSSS--SSSSSSS--SSSS----------S------SSSS------SS--SSSS------------------
SSSS--SSSS-----------------------------S--SSSSSS--SSSSSS--SSSS--SSSS----SSSSSS----SS-SSSS--SSSSSSS--SSSS----------S------SSSS------SS--SSSS------------------
--SS---S----SS--------------------------------SS---S--SS---SSS---S----SS----SS---------SS---S---SS---S---------------SS----------ooSS------------------------
--SS---S----SS--------------------------------SS---S--SS---SSS---S----SS----SS---------SS---S---SS---S---------------SS------------SS------------------------
--SS---S----SS--------------------------------SS---S--SS---SSS---S----SS----SS---------SS---S---SS---S---------------SS----------SSSS------------------------
ooSS---SoU--SC----------------------------ooooSS---SoUSS---SSS---SoU--SCooooSS----oU-ooSS---SoooSS---SoU----------U--SC----------SSSS------------------------
SSSS---SSS--SS---------##-------TT-----S--SSSSSS---SSSSS---SSS---SSS--SSSSSSSS----SS-SSSS---SSSSSS---SSS------TT--S--SS--SSSS------SS--SSSS------------##----
----------------------###-TT----TT-----S----------------------------------------------------------------T-----TT--------------------------------------###--SS
---------------------####-TT----TT----TS----------------------------------------------------------------------TT-------------------------------------####--SF
---M---------g------#####-TT----TT----Tkk----------------k--------------ggg-----------------------------------TT----T-------------------------------r####--S#
XXXXXXXXXXXXXXXXXXXXXXXXXXXXXXXXXXXXXXXXXXXXXXXXXXXXXXXXXXXXXXXXXXXXXXXXXXXXXXXX--XXXXXXXXXXXXXXXXXXXXXXXXXXXXXXXXXXXXXXXXXXX---XXXXXXXXXXX---XXXXXXXXXXX--XX
XXXXXXXXXXXXXXXXXXXXXXXXXXXXXXXXXXXXXXXXXXXXXXXXXXXXXXXXXXXXXXXXXXXXXXXXXXXXXXXX--XXXXXXXXXXXXXXXXXXXXXXXXXXXXXXXXXXXXXXXXXXX---XXXXXXXXXXX---XXXXXXXXXXX--XX
