-------------------------------------------------------------------------------------------------------------------------------------------------------------
-------------------------------------------------------------------------------------------------------------------------------------------------------------
-------------------------------------------------------------------------------------------------------------------------------------------------------------
SSSSSSSSSSSSSSSSSSSSSSSSSSSSSSSSSSSSSSSSSSSSSSSSSSSSSSSSSSSSSSSSSSSSSSSSSSSSSSSS--SSSSSSSSSSSSSSSSSSSSSSSSSSSSSSSSSSSSSSSSSSSSSSSSSSSSSSSS---------SSSSSSSSSS
SSSS--SSSS----SSSS--S-----------SS--SSSSSS--SSSSS--SSSSSS-SSSSS--SSSSSSSS--SSSS----SSSSSS--SSSSSS--SSS--------------SSS-SSSS---------------------------------
SSSS--SSSS----SSSS--S-----------SS--SSSSSS--SSSSS--SSSSSS-SSSSS--SSSSSSSS--SSSS----SSSSSS--SSSSSS--SSS--------------SSS-SSSS---------------------------------
--SS---S----SS--SS-------------S--------SS---S--S------SS----SS---S-SS-SS---S----------SS---S--SS---SS---------------S----------ooo---------SSS--------------
--SS---S----SS--SS-------------S--------SS---S--S------SS----SS---S-SS-SS---S----------SS---S--SS---SS---------------S---------------------------------------
--SS---S----SS--SS-------------S--------SS---S--S------SS----SS---S-SS-SS---S----------SS---S--SS---SS---------------S----------SSS--------------------------
ooSS---SoU--SCooSS-------------S----ooooSS---SoUS--ooooSS-oooSS---SoSSoSS---SoU----ooooSS---SooSS---SS---------------So---------SSS--------------SS----------
SSSS---SSS--SSSSSS-------##T---SSS--SSSSSS---SSSS--SSSSSS-SSSSS---SSSSSSS---SSS----SSSSSS---SSSSS---SS--------TT-----SS-SSSS------------##---------TTT##-----
------------------------###T----SS----------------------------------------------------------------------TT----TT-----------------------###---------TTT##---SS
-----------------------####T----SS----------------------------------------------------------------------TT----TT----------------------####--SSS----TTT##---SF
---M---------g--------#####T-----------kk----------------k--------------ggg-----------------------------TT----TT----T----------------#####---------TrT##---S#
XXXXXXXXXXXXXXXXXXXXXXXXXXXXXXXXXXXXXXXXXXXXXXXXXXXXXXXXXXXXXXXXXXXXXXXXXXXXXXXX--XXXXXXXXXXXXXXXXXXXXXXXXXXXXXXXXXXXXXXXXXX---XXXXXXXXXXX-------XXXXXXXX--XX
XXXXXXXXXXXXXXXXXXXXXXXXXXXXXXXXXXXXXXXXXXXXXXXXXXXXXXXXXXXXXXXXXXXXXXXXXXXXXXXX--XXXXXXXXXXXXXXXXXXXXXXXXXXXXXXXXXXXXXXXXXX---XXXXXXXXXXX-------XXXXXXXX--XX
