-------------------------------------------------------------------------------------------------------------------------------------------------------------
-------------------------------------------------------------------------------------------------------------------------------------------------------------
-------------------------------------------------------------------------------------------------------------------------------------------------------------
SSSSSSSSSSSSSSSSSSSSSSSSSSSSSSSSSSSSSSSSSSSSSSSSSSSSSSSSSSSSSSSSSSSSSSSSSSSSSSSS--SSSSSSSSSSSSSSSSSSSSSSSSSSSSSSSSSSSSSSSSSSSSSSSSSSSSSSSSSSSSS--------------
SSSS--SSSS-SSSS-----------------SS--SSSSSS--SSSSSSS--SSSSSSSSS--SSSSSSS----SSSS-------SSSSSSS--SSSS------SSSS-------SSSS--SSSS--------SSSS-------------------
SSSS--SSSS-SSSS-----------------SS--SSSSSS--SSSSSSS--SSSSSSSSS--SSSSSSS----SSSS-------SSSSSSS--SSSS------SSSS-------SSSS--SSSS--------SSSS-------------------
--SS---S---SSSS----------------S--------SS---S---SS---S-----SS---S---SSSS----------ooo---SSSS---S----SS--------------SSS---S------SS----------o--------------
--SS---S---SSSS----------------S--------SS---S---SS---S-----SS---S---SSSS----------------SSSS---S----SS--------------SSS---S------SS-------------------------
--SS---S---SSSS----------------S--------SS---S---SS---S-----SS---S---SSSS----------SSS---SSSS---S----SS--------------SSS---S------SS----------S--------------
ooSS---SoU-SSSS----------------S----ooooSS---SoooSS---SoUoooSS---SoooSSSC----------SSSoooSSSS---SoU--SC--------------SSS---SoU----SC----------S--SSSSSSU-----
SSSS---SSS-SSSS-----------TT---SSS--SSSSSS---SSSSSS---SSSSSSSS---SSSSSSSS--SSSS-------SSSSSSS---SSS--SS--SSSS-TT-----SSS---SSS----SS--SSSS-------------------
--------------------TT----TT----SS----------------------------------------------------------------------T-----TT---------------------------------------------
--------------------TT----TT----SS----------------------------------------------------------------------------TT--------------------------------------------F
---M---------g------TT----TT-----------kk----------------k--------------ggg-----------------------------------TT----T-------------------------------r-------#
XXXXXXXXXXXXXXXXXXXXXXXXXXXXXXXXXXXXXXXXXXXXXXXXXXXXXXXXXXXXXXXXXXXXXXXXXXXXXXX---XXXXXXXXXXXXXXXXXXXXXXXXXXXXXXXXXXXXXXXXXXXXXXXXXXXXXXXX---XX--XXXXXXXX--X-
XXXXXXXXXXXXXXXXXXXXXXXXXXXXXXXXXXXXXXXXXXXXXXXXXXXXXXXXXXXXXXXXXXXXXXXXXXXXXXX---XXXXXXXXXXXXXXXXXXXXXXXXXXXXXXXXXXXXXXXXXXXXXXXXXXXXXXXX---XX--XXXXXXXX--XX
