-------------------------------------------------------------------------------------------------------------------------------------------------------------
-------------------------------------------------------------------------------------------------------------------------------------------------------------
-------------------------------------------------------------------------------------------------------------------------------------------------------------
SSSSSSSSSSSSSSSSSSSSSSSSSSSSSSSSSSSSSSSSSSSSSSSSSSSSSSSSSSSSSSSSSSSSSSSSSSSSSSSS--SSSSSSSSSSSSSSSSSSSSSSSSSSSSSSSSSSSSSSSSSSSSSSSSSSSSSSSS--------SSSSSSS----
--SS--SSSSSS------------------------SSS-SSSSSS--SSSS----SS--SSSSSSS--SSSS------S---SSSSSS--SSSSSSS------SSSS-------------------------------------------------
--SS--SSSSSS------------------------SSS-SSSSSS--SSSS----SS--SSSSSSS--SSSS------S---SSSSSS--SSSSSSS------SSSS-------------------------------------------------
SS--------SS------------------------SS------SS---S----SSSS----SSSSS---S----SSSS--------SS---S---SS--SS--------------------------------------SSS------------SS
SS--------SS------------------------SS------SS---S----SSSS----SSSSS---S----SSSS--------SS---S---SS--SS-------------------------------------------------------
SS--------SS------------------------SS------SS---S----SSSS----SSSSS---S----SSSS--------SS---S---SS--SS-------------------------------------------------------
SS----ooooSS------------------------SS--ooooSS---SoU--SCSS--ooSSSSS---SoU--SCSS----ooooSS---SoooSS--SC-------------------------------------------S-----------
SSSS--SSSSSS------------##TT--------SS--SSSSSS---SSS--SSSS--SSSSSSS---SSS--SSSSS---SSSSSS---SSSSSS--SS--SSSS--TTT-----------------------##-------------##----
--SS-------------------###TT----TT---------------------------------------------S------------------------T------TT----------SS----------###------------###----
--SS------------------####TT----TT---------------------------------------------S-------------------------------TT---TT-----SS---------####--SSS------####--SF
---M---------g-------#####TT----TT-----kk----------------k--------------ggg------------------------------------TT---TT-----SS--------#####----------r####---#
XXXXXXXXXXXXX-XXXXXXXXXXXXXXXXXXXXXXXXXXXXXXXXXXXXXXXXXXXXXXXXXXXXXXXXXXXXXXXXXX--XXXXXXXXXXXXXXXXXXXXXXXXXXXXXXXXXXXXXXX--XX--XXXXXXXXXXX-------XXXXXXXX----
XXXXXXXXXXXXX-XXXXXXXXXXXXXXXXXXXXXXXXXXXXXXXXXXXXXXXXXXXXXXXXXXXXXXXXXXXXXXXXXX--XXXXXXXXXXXXXXXXXXXXXXXXXXXXXXXXXXXXXXX--XX--XXXXXXXXXXX-------XXXXXXXX----
