-------------------------------------------------------------------------------------------------------------------------------------------------------------
-------------------------------------------------------------------------------------------------------------------------------------------------------------
-------------------------------------------------------------------------------------------------------------------------------------------------------------
SSSSSSSSSSSSSSSSSSSSSSSSSSSSSSSSSSSSSSSSSSSSSSSSSSSSSSSSSSSSSSSSSSSSSSSSSSSSSSSS--SSSSSSSSSSSSSSSSSSSSSSSSSSSSSSSSSSSSSSSSSSSSSSSSSSSSSSSSSSS----------------
SSSS--SSSSSS--SS----------------SS--SSSSSS--SSSSS--SSSSSS--SSSS--SSSS-----SSSSSS---SSSSSS--SSSSSSSSSSSS--S---------------SSS---S------SSSS-------------------
SSSS--SSSSSS--SS----------------SS--SSSSSS--SSSSS--SSSSSS--SSSS--SSSS-----SSSSSS---SSSSSS--SSSSSSSSSSSS--S---------------SSS---S------SSSS-------------------
--SS------SS---S------------------------SS---S---------SS---SSS---S----SS-----SS-------SS---S---SS---SS---------------------------SS---------SS--------------
--SS------SS---S------------------------SS---S---------SS---SSS---S----SS-----SS-------SS---S---SS---SS---------------------------SS-------------------------
--SS------SS---S------------------------SS---S---------SS---SSS---S----SS-----SS-------SS---S---SS---SS---------------------------SS-------------------------
ooSS--ooooSS---S--------------------ooooSS---SoU---ooooSS---SSS---SoU--SC-ooooSS---ooooSS---SoUoSSoooSS------------------------U--SC-------------SSSSSSU-----
SSSS--SSSSSS---S----------TT----SS--SSSSSS---SSSS--SSSSSS---SSS---SSS--SS-SSSSSS---SSSSSS---SSSSSSSSSSS-------TT---------SSS---S--SS--SSSS-------------------
--------------------TT----TT----SS--------------S-------------------------------------------------------T-----TT---------------------------------------------
--------------------TT----TT---#SS--------------S-------------------------------------------------------------TT----TT-----------------------SS-------------F
---M---------g------TT----TT---#-------kk----------------k--------------ggg-----------------------------------TT----TT------------------------------r-------#
XXXXXXXXXXXXXXXXXXXXXXXXXXXXXXXXXXXXXXXXXXXXXXXXXXXXXXXXXXXXXXXXXXXXXXXXXXXXXXXX--XXXXXXXXXXXXXXXXXXXXXXXXXXXXXXXXXXXXXXXXXX---XXXXXXXXXXX-------XXXXXXXX--X-
XXXXXXXXXXXXXXXXXXXXXXXXXXXXXXXXXXXXXXXXXXXXXXXXXXXXXXXXXXXXXXXXXXXXXXXXXXXXXXXX--XXXXXXXXXXXXXXXXXXXXXXXXXXXXXXXXXXXXXXXXXX---XXXXXXXXXXX-------XXXXXXXX--XX
