-------------------------------------------------------------------------------------------------------------------------------------------------------------
-------------------------------------------------------------------------------------------------------------------------------------------------------------
-------------------------------------------------------------------------------------------------------------------------------------------------------------
SSSSSSSSSSSSSSSSSSSSSSSSSSSSSSSSSSSSSSSSSSSSSSSSSSSSSSSSSSSSSSSSSSSSSSSSSSSSSSSS--SSSSSSSSSSSSSSSSSSSSSSSSSSSSSSSSSSSSSSSSSSSSSSSSSSSSSSSS------------SSS---S
SSSS--SSSSSS--SSSS-------------------SSSS--SSSS-SS--SSSSSS--SSS--SSSSSSSS--SSSS----SSSSSS--SSSS-SSS------SSS-------------------SSSSS--SS---------------------
SSSS--SSSSSS--SSSS-------------------SSSS--SSSS-SS--SSSSSS--SSS--SSSSSSSS--SSSS----SSSSSS--SSSS-SSS------SSS-------------------SSSSS--SS---------------------
--SS------SS---S-----------------------SS---S--S--------SS---SS---S----SS---S-----S----SS---S---S----SS---------------------------SS--------SSS------------S-
--SS------SS---S-----------------------SS---S--S--------SS---SS---S----SS---S-----S----SS---S---S----SS---------------------------SS-------------------------
--SS------SS---S-----------------------SS---S--S--------SS---SS---S----SS---S-----S----SS---S---S----SS---------------------------SS-------------------------
ooSS--ooooSS---SoU-------------------ooSS---SoUS----ooooSS---SS---SooooSS---SoU---CooooSS---SoU-SoU--SC------------------------oooSS-------------SSSSS-------
SSSS--SSSSSS---SSS-------##-----TT---SSSS---SSSSSS--SSSSSS---SS---SSSSSSS---SSS---SSSSSSS---SSS-SSS--SS--SSS--TT---------------SSSSS----##-------------##----
------------------------###T----TT--------------SS------------------------------------------------------T-----TT-----------S------------##------------###----
-----------------------####T----TT--------------SS------------------------------------------------------------TT----TT-----S------------##--SSS-------###--SF
---M---------g--------#####T----TT-----kk----------------k--------------ggg-----------------------------------TT----TT-----S------------##----------r-###---#
XXXXXXXXXXXXXXXXXXXXXXXXXXXXXXXXXXXXXXXXXXXXXXXXXXXXXXXXXXXXXXXXXXXXXXXXXXXXXXXX--XXXXXXXXXXXXXXXXXXXXXXXXXXXXXXXXXXXXXXX--X---XXXXXXXXXXX-------XXXXXXXX---X
XXXXXXXXXXXXXXXXXXXXXXXXXXXXXXXXXXXXXXXXXXXXXXXXXXXXXXXXXXXXXXXXXXXXXXXXXXXXXXXX--XXXXXXXXXXXXXXXXXXXXXXXXXXXXXXXXXXXXXXX--X---XXXXXXXXXXX-------XXXXXXXX---X
