-------------------------------------------------------------------------------------------------------------------------------------------------------------
-------------------------------------------------------------------------------------------------------------------------------------------------------------
-------------------------------------------------------------------------------------------------------------------------------------------------------------
SSSSSSSSSSSSSSSSSSSSSSSSSSSSSSSSSSSSSSSSSSSSSSSSSSSSSSSSSSSSSSSSSSSSSSSSSSSSSSSS--SSSSSSSSSSSSSSSSSSSSSSSSSSSSSSSSSSSSSSSSSSSSSSSSSSSSSSSS--SSSSSSSSSSSSS----
SSSS--SSSS-SSS--SSSS------------------SSS--SSSS-SS--SSSSSS--SSSSSSSS--SSSS-SSSSS---SSSSSS--SS--SSSS------SSSS-------------SS---------------------------------
SSSS--SSSS-SSS--SSSS------------------SSS--SSSS-SS--SSSSSS--SSSSSSSS--SSSS-SSSSS---SSSSSS--SS--SSSS------SSSS-------------SS---------------------------------
--SS---S----SS---S---------------------SS---S--S--------SS---S--S-SS---S-------S----S--SS---S---S----SS----------------------------------------------------SS
--SS---S----SS---S---------------------SS---S--S--------SS---S--S-SS---S-------S----S--SS---S---S----SS------------------------------------------------------
--SS---S----SS---S---------------------SS---S--S--------SS---S--S-SS---S-------S----S--SS---S---S----SS------------------------------------------------------
ooSS---SoU-oSS---SoU---------C--------oSS---SoUS----ooooSS---SoUSoSS---SoU-ooooS----SooSS---S---SoU--SC------------------------------------------------------
SSSS---SSS-SSS---SSS---#-#------------SSS---SSSSSS--SSSSSS---SSSSSSS---SSS-SSSSS----SSSSS---S---SSS--SS--SSSS-TT----------SS------------##-------------##----
---------------------#-#-#-#---#----------------SS------------------------------------------------------T-----TT-----------------------###-------SS---###----
---------------------#-#-#-#---#-#--------------SS------------------------------------------------------------TT----TT----------------####-------SS--####--SF
---M---------g-------#-#-#-#-E-#-#-----kk----------------k--------------ggg-----------------------------------TT----TT---------------#####-------SS-r####---#
XXXXXXXXXXXXXXXXXXXXXXXXXXXXXXXXXXXXXXXXXXXXXXXXXXXXXXXXXXXXXXXXXXXXXXXXXXXXXXXX--XXXXXXXXXXXXXXXXXXXXXXXXXXXXXXXXXXXXXXX-XX--XXXXXXXXXXXX--XXX--XXXXXXXX----
XXXXXXXXXXXXXXXXXXXXXXXXXXXXXXXXXXXXXXXXXXXXXXXXXXXXXXXXXXXXXXXXXXXXXXXXXXXXXXXX--XXXXXXXXXXXXXXXXXXXXXXXXXXXXXXXXXXXXXXX-XX--XXXXXXXXXXXX--XXX--XXXXXXXX----
