-------------------------------------------------------------------------------------------------------------------------------------------------------------
-------------------------------------------------------------------------------------------------------------------------------------------------------------
-------------------------------------------------------------------------------------------------------------------------------------------------------------
SSSSSSSSSSSSSSSSSSSSSSSSSSSSSSSSSSSSSSSSSSSSSSSSSSSSSSSSSSSSSSSSSSSSSSSSSSSSSSSS--SSSSSSSSSSSSSSSSSSSSSSSSSSSSSSSSSSSSSSSSSSSSSSSSSSSSSSSS----------SSSSS----
SSSS--SSSSSS--SSSS------SS---------SSSSSS--SSSS---SSSSSSSS--SSSS------SSS--SSSS----SSSSSS--SSSS-SS-----------------SSSS---SS---------------------------------
SSSS--SSSSSS--SSSS------SS---------SSSSSS--SSSS---SSSSSSSS--SSSS------SSS--SSSS----SSSSSS--SSSS-SS-----------------SSSS---SS---------------------------------
--SS---S-SSS---S----SS-----------------SS---S----S---SS-SS---S----SS---SS---S----------SS---S---SS-------------SS---------------ooooo-------SSS------------SS
--SS---S-SSS---S----SS-----------------SS---S----S---SS-SS---S----SS---SS---S----------SS---S---SS-------------SS--------------------------------------------
--SS---S-SSS---S----SS-----------------SS---S----S---SS-SS---S----SS---SS---S----------SS---S---SS-------------SS---------------SSSSS------------------------
ooSS---SoSSS---SoU--SC-------------ooooSS---SoU--SoooSSoSS---SoU--SC--oSS---SoU----ooooSS---SoU-SS-------------SC---------------SSSSS------------SSS---------
SSSS---SSSSS---SSS--SS--SS##-----#-SSSSSS---SSS--SSSSSSSSS---SSS--SS--SSS---SSS----SSSSSS---SSS-SS------------TSS--SSSS---SS------------##-------------##----
--------------------------##----##----------------------------------------------------------------------TT----T------------------------###------------###----
--------------------------##---###----------------------------------------------------------------------TT----T-----------------------####--SSS------####--SF
---M---------g------------##--####-----kk----------------k--------------ggg-----------------------------TT----T-----T----------------#####----------r####---#
XXXXXXXXXXXXXXXXXXXXXXXXXXXXXXXXXXXXXXXXXXXXXXXXXXXXXXXXXXXXXXXXXXXXXXXXXXXXXXXX--XXXXXXXXXXXXXXXXXXXXXXXXXXXXXXXXXXXXX---XX---XXXXXXXXXXX-------XXXXXXXX----
XXXXXXXXXXXXXXXXXXXXXXXXXXXXXXXXXXXXXXXXXXXXXXXXXXXXXXXXXXXXXXXXXXXXXXXXXXXXXXXX--XXXXXXXXXXXXXXXXXXXXXXXXXXXXXXXXXXXXX---XX---XXXXXXXXXXX-------XXXXXXXX----
