-------------------------------------------------------------------------------------------------------------------------------------------------------------
-------------------------------------------------------------------------------------------------------------------------------------------------------------
-------------------------------------------------------------------------------------------------------------------------------------------------------------
SSSSSSSSSSSSSSSSSSSSSSSSSSSSSSSSSSSSSSSSSSSSSSSSSSSSSSSSSSSSSSSSSSSSSSSSSSSSSSSS--SSSSSSSSSSSSSSSSSSSSSSSSSSSSSSSSSSSSSSSSSSSSSSSSSSSSSSSS---------SSSSSS----
SSSS--SSSS----SSSS--------------SS--SSSSSS--SSSSSS--SSSS-SSSSSS--SSSS------SSS-------SSS--SSSS------SSS--------------SSS--SS--------S--S---------------------
SSSS--SSSS----SSSS--------------SS--SSSSSS--SSSSSS--SSSS-SSSSSS--SSSS------SSS-------SSS--SSSS------SSS--------------SSS--SS--------S--S---------------------
--SS---S----SS--SS------------SS--------SS--SS--SS---S---SS--SS---S----SS---SS--------SS---S----SS---SS---------------SS--------ooooS-------SSS------------SS
--SS---S----SS--SS------------SS--------SS--SS--SS---S---SS--SS---S----SS---SS--------SS---S----SS---SS---------------SS------------S------------------------
--SS---S----SS--SS------------SS--------SS--SS--SS---S---SS--SS---S----SS---SS--------SS---S----SS---SS---------------SS--------SSSSS------------------------
ooSS---SoU--SCooSS------------SS----ooooSS--SSooSS---SoU-SSooSS---SoU--SC--oSS-------oSS---SoU--SC---SS--------------oSS--------SSSSS------------SS----------
SSSS---SSS--SSSSSS--------TT--SSSS--SSSSSS--SSSSSS---SSS-SSSSSS---SSS--SS--SSS-------SSS---SSS--SS--SSS-------TT-----SSS---S--------S---##-------------##----
--------------------TT----TT----SS----------------------------------------------------------------------TT----TT------------------------##------------###----
--------------------TT----TT----SS----------------------------------------------------------------------TT----TT----T-------------------##--SSS------####--SF
---M---------g------TT----TT-----------kk----------------k--------------ggg-----------------------------TT----TT----T-------------------##----------r####---#
XXXXXXXXXXXXXXXXXXXXXXXXXXXXXXXXXXXXXXXXXXXXXXXXXXXXXXXXXXXXXXXXXXXXXXXXXXXXXXXX----XXXXXXXXXXXXXXXXXXXXXXXXXXXXXXXXXXXXXXXX---XXXXXXXXXXX-------XXXXXXXX----
XXXXXXXXXXXXXXXXXXXXXXXXXXXXXXXXXXXXXXXXXXXXXXXXXXXXXXXXXXXXXXXXXXXXXXXXXXXXXXXX----XXXXXXXXXXXXXXXXXXXXXXXXXXXXXXXXXXXXXXXX---XXXXXXXXXXX-------XXXXXXXX----
