-------------------------------------------------------------------------------------------------------------------------------------------------------------
-------------------------------------------------------------------------------------------------------------------------------------------------------------
-------------------------------------------------------------------------------------------------------------------------------------------------------------
SSSSSSSSSSSSSSSSSSSSSSSSSSSSSSSSSSSSSSSSSSSSSSSSSSSSSSSSSSSSSSSSSSSSSSSSSSSSSSSS--SSSSSSSSSSSSSSSSSSSSSSSSSSSSSSSSSSSSSSSSSSSSSSSSSSSLSSSS----------SSSSS----
SSSS--SSSSSS--SSSS-----------------SSSSSS--SSSSSSS--SSSS----SSSSSSS--SSSS---SS-----SSSSSS--SSSSSSSS------SSSS-------------SS---------------------------------
SSSS--SSSSSS--SSSS-----------------SSSSSS--SSSSSSS--SSSS----SSSSSSS--SSSS---SS-----SSSSSS--SSSSSSSS------SSSS-------------SS---------------------------------
SS--------SS---S-----------------------SS---S---SS---S----SSSS---SS---S----SSS---------SS---SSS-S----SS-------------------------oooooo------SSS------------S-
SS--------SS---S-----------------------SS---S---SS---S----SSSS---SS---S----SSS---------SS---SSS-S----SS------------------------------------------------------
SS--------SS---S-----------------------SS---S---SS---S----SSSS---SS---S----SSS---------SS---SSS-S----SS-------------------------SSSSSS-----------------------
SS----ooooSS---SoU-----------------ooooSS---SoooSS---SoU--SCSSoooSS---SoU--SSS-----ooooSS---SSS-SoU--SC-------------------------SSSSSS-----------SSS---------
SSSS--SSSSSS---SSS--------TT-------SSSSSS---SSSSSS---SSS--SSSSSSSSS---SSS--SSS-----SSSSSS---SSS-SSS--SS--SSSS-TT----------SS---------------------------##----
--SS----------------TT----TT----------------------------------------------------------------------------T-----TT--------------------------------------###----
--SS----------------TT----TT----TT----------------------------------------------------------------------------TT----TT----------------------SSS------####--SF
---M---------g------TT----TT----TT-----kk----------------k--------------ggg-----------------------------------TT----TT------------------------------r####---#
XXXXXXXXXXXXXXXXXXXXXXXXXXXXXXXXXXXXXXXXXXXXXXXXXXXXXXXXXXXXXXXXXXXXXXXXXXXXXXXX--XXXXXXXXXXXXXXXXXXXXXXXXXXXXXXXXXXXXX---XX---XXXXXXXXXXX-------XXXXXXXX----
XXXXXXXXXXXXXXXXXXXXXXXXXXXXXXXXXXXXXXXXXXXXXXXXXXXXXXXXXXXXXXXXXXXXXXXXXXXXXXXX--XXXXXXXXXXXXXXXXXXXXXXXXXXXXXXXXXXXXX---XX---XXXXXXXXXXX-------XXXXXXXX---X
