-------------------------------------------------------------------------------------------------------------------------------------------------------------
-------------------------------------------------------------------------------------------------------------------------------------------------------------
-------------------------------------------------------------------------------------------------------------------------------------------------------------
SSSSSSSSSSSSSSSSSSSSSSSSSSSSSSSSSSSSSSSSSSSSSSSSSSSSSSSSSSSSSSSSSSSSSSSSSSSSSSSS--SSSSSSSSSSSSSSSSSSSSSSSSSSSSSSSSSSSSSSSSSSSSSSSSSSSSSSSSSS-----------------
SSSSSSSSSSSSS--SSSS-------------SS--SSSSSS--SSSS--SSSSSSS--SSSS----SSSSSSSSSSS----SS----SSSSS--SSSS------SSS---------SS-SSSS----------SSSS-------------------
SSSSSSSSSSSSS--SSSS-------------SS--SSSSSS--SSSS--SSSSSSS--SSSS----SSSSSSSSSSS----SS----SSSSS--SSSS------SSS---------SS-SSSS----------SSSS-------------------
--SS-SS----SS---S----S------------------SS---SSS----SS-SS---S----SS---SS-SS-SS--------SS--SSS---S----SS---------------S---------ooSS--------SSS--------------
--SS-SS----SS---S----S------------------SS---SSS----SS-SS---S----SS---SS-SS-SS--------SS--SSS---S----SS---------------S-----------SS-------------------------
--SS-SS----SS---S----S------------------SS---SSS----SS-SS---S----SS---SS-SS-SS--------SS--SSS---S----SS---------------S---------SSSS-------------------------
ooSSoSSooooSS---SoU--S--------------ooooSS---SSS--ooSSoSS---SoU--SCoooSSoSSoSS----oU--SCooSSS---SoU--SC---------------S---------SSSC-------------SSSSSSU-----
SSSSSSSSSSSSS---SSS--S---TT-----SS--SSSSSS---SSS--SSSSSSS---SSS--SSSSSSSSSSSSS----SS--SSSSSSS---SSS--SS--SSS--TT------S-SSSS------SS--SSSS-------------------
-------------------------TT-----SS----------------------------------------------------------------------T-----TT---------------------------------------------
-------------------------TT----TSS----------------------------------------------------------------------------TT----#-----------------------SSS-------------F
---M---------g-----------TT----T-------kk----------------k--------------ggg-----------------------------------TT----T-------------------------------r-------#
XXXXXXXXXXXXXXXXXXXXXXXXXXXXXXXXXXXXXXXXXXXXXXXXXXXXXXXXXXXXXXXXXXXXXXXXXXXXXXXX--XXXXXXXXXXXXXXXXXXXXXXXXXXXXXXXXXXXXXXXXXX---XXXXXXXXXXX-------XXXXXXXX--X-
XXXXXXXXXXXXXXXXXXXXXXXXXXXXXXXXXXXXXXXXXXXXXXXXXXXXXXXXXXXXXXXXXXXXXXXXXXXXXXXX--XXXXXXXXXXXXXXXXXXXXXXXXXXXXXXXXXXXXXXXXXX---XXXXXXXXXXX-------XXXXXXXX--XX
