-------------------------------------------------------------------------------------------------------------------------------------------------------------
-------------------------------------------------------------------------------------------------------------------------------------------------------------
-------------------------------------------------------------------------------------------------------------------------------------------------------------
SSSSSSSSSSSSSSSSSSSSSSSSSSSSSSSSSSSSSSSSSSSSSSSSSSSSSSSSSSSSSSSSSSSSSSSSSSSSSSSS--SSSSSSSLSSSSSSSSSSSSSSSSSSSSSSSSSSSSSSSSSSSSSSSSSSSSSSSS---SSSSSSSSSSSS---S
SSSS--SSSSSS--SSSS--------------SS--SSSSSS--SSSSSS-SSSSSS--SSSS--SSSS-----S-SSSS----------SSS--SSSS------SS------------SS------------------------------------
SSSS--SSSSSS--SSSS--------------SS--SSSSSS--SSSSSS-SSSSSS--SSSS--SSSS-----S-SSSS----------SSS--SSSS------SS------------SS------------------------------------
--SS------SS---S----SS------------------SS---S--SS---SSSS---SSS---S----SS-S---------oooooo-SS---S----SS----------------SS-------------------S--------------S-
--SS------SS---S----SS------------------SS---S--SS---SSSS---SSS---S----SS-S----------------SS---S----SS----------------SS------------------------------------
--SS------SS---S----SS------------------SS---S--SS---SSSS---SSS---S----SS-S---------SSSSSS-SS---S----SS----------------SS------------------------------------
ooSS---oooSS---SoU--SC--------------ooooSS---SooSS-ooSSSS---SSS---SoU--SC-S---------SSSSSSoSS---SoU--SC----------------SS------------------------------------
SSSS---SSSSS---SSS--SS----##----SS--SSSSSS---SSSSS-SSSSSS---SSS---SSS--SS-S-SSSS----------SSS---SSS--SS--SS---TT-------SS---------------##-------------##----
-------------------------###----SS----------------------------------------------------------------------T-----TT-----------S-----------###------------###----
------------------------####---TSS----------------------------------------------------------------------------TT----TT-----S----------####--S--------####--SF
---M---------g----------####---T-------kk----------------k--------------ggg-----------------------------------TT----TT-----S---------#####----------r####---#
XXXXXXXXXXXXXXXXXXXXXXXXXXXXXXXXXXXXXXXXXXXXXXXXXXXXXXXXXXXXXXXXXXXXXXXXXXXXXXXX---XXXXXXXXXXXXXXXXXXXXXXXXXXXXXXXXXXXXXX--X--XXXXXXXXXXXX---XXXXXXXXXXXX---X
XXXXXXXXXXXXXXXXXXXXXXXXXXXXXXXXXXXXXXXXXXXXXXXXXXXXXXXXXXXXXXXXXXXXXXXXXXXXXXXX---XXXXXXXXXXXXXXXXXXXXXXXXXXXXXXXXXXXXXX--X--XXXXXXXXXXXX---XXXXXXXXXXXX---X
