-------------------------------------------------------------------------------------------------------------------------------------------------------------
-------------------------------------------------------------------------------------------------------------------------------------------------------------
-------------------------------------------------------------------------------------------------------------------------------------------------------------
SSSSSSSSSSSSSSSSSSSSSSSSSSSSSSSSSSSSSSSSSSSSSSSSSSSSSSSSSSSSSSSSSSSSSSSSSSSSSSSS--SSSSSSSSSSSSSSSSSSSSSSSSSSSSSSSSSSSSSSSSSSSSSSSSSSSSSSSS----------SSSSSSSSS
SSSSSSSS--SSSS------SSS---------SSSSS--SS--SSSSSS--SSSSSS-SSSSS--SSSS-SSS--SSSS------SSSSSS-SSSSSS--SSSS------------------------SSS--------------------------
SSSSSSSS--SSSS------SSS---------SSSSS--SS--SSSSSS--SSSSSS-SSSSS--SSSS-SSS--SSSS------SSSSSS-SSSSSS--SSSS------------------------SSS--------------------------
----SSSS---S----SS-----------------SS----------SS---S--SS-SS-SS---S----SS---S------------SS-----SS---S---------------------------S----------SSS--------------
----SSSS---S----SS-----------------SS----------SS---S--SS-SS-SS---S----SS---S------------SS-----SS---S---------------------------S---------------------------
----SSSS---S----SS-----------------SS----------SS---S--SS-SS-SS---S----SS---S------------SS-----SS---S---------------------------S---------------------------
ooooSSSS---SoU--SC--------------oooSS------ooooSS---SoUSS-SSoSS---SoU-oSS---SoU------ooooSS-ooooSS---SoU-------------------------So--------------SSS---------
SSSSSSSS---SSS--SS--SSS--##T----SSSSS---S--SSSSSS---SSSSS-SSSSS---SSS-SSS---SSS------SSSSSS-SSSSSS---SSS------TT-----------------SS-----##-----------##------
------------------------###T------------S---------------------------------------------------------------T-----TT-----------S-----------###----------###SS----
-----------------------####T------------S----------------------------------------------------------------T----TT----TT-----S----------####--SSS-----###SS---F
---M---------g---------####T-----------kk----------------k--------------ggg------------------------------T----TT----TT-----S---------#####----------r##SS---#
XXXXXXXXXXXXXXXXXXXXXXXXXXXXXXXXXXXXXXXXXXXXXXXXXXXXXXXXXXXXXXXXXXXXXXXXXXXXXXXX----XXXXXXXXXXXXXXXXXXXXXXXXXXXXXXXXXXXXX--X--XXXXXXXXXXXX-------XXXXXXXX--XX
XXXXXXXXXXXXXXXXXXXXXXXXXXXXXXXXXXXXXXXXXXXXXXXXXXXXXXXXXXXXXXXXXXXXXXXXXXXXXXXX----XXXXXXXXXXXXXXXXXXXXXXXXXXXXXXXXXXXXX--X--XXXXXXXXXXXX-------XXXXXXXX--XX
