-------------------------------------------------------------------------------------------------------------------------------------------------------------
-------------------------------------------------------------------------------------------------------------------------------------------------------------
-------------------------------------------------------------------------------------------------------------------------------------------------------------
SSSSSSSSSSSSSSSSSSSSSSSSSSSSSSSSSSSSSSSSSSSSSSSSSSSSSSSSSSSSSSSSSSSSSSSSSSSSSSSS--SSSSSSSLSSSSSSSSSSSSSSSSSSSSSSSSSSSSSSSSSSSSSSSSSSSSSSSSSSS----------------
SSSS--SSSS-SS------------------------SSSS--SSSS---SSSSSS--SSSSS--SSS--SSSS-SSSSS----------SSS--SSS--SSS--------------S---SSSS-----------SS-------------------
SSSS--SSSS-SS------------------------SSSS--SSSS---SSSSSS--SSSSS--SSS--SSSS-SSSSS----------SSS--SSS--SSS--------------S---SSSS-----------SS-------------------
--SS---S---SS--------------------------SS---S---------SS---S-SS---SS---SSS---SS-----oooooo-SS---SS---S----------------S----------oooo--------SS--------------
--SS---S---SS--------------------------SS---S---------SS---S-SS---SS---SSS---SS------------SS---SS---S----------------S--------------------------------------
--SS---S---SS--------------------------SS---S---------SS---S-SS---SS---SSS---SS-----SSSSSS-SS---SS---S----------------S----------SSSS------------------------
ooSS---SoU-SS------------------------ooSS---SoU---ooooSS---SoSS--oSS---SSS-ooSS-----SSSSSSoSS---SS---So---------------C----------SSSS------------SSSSSSU-----
SSSS---SSS-SS---------#-#-------TT---SSSS---SSS---SSSSSS---SSSS--SSS---SSS-SSSSS----------SSS---SS---SS-------TT------S--SSSS-----------SS-------------------
--------------------#-#-#-#T----TT----------------------------------------------------------------------TT----TT-----------------------#---------------------
------------------#-#-#-#-#T----TT----------------------------------------------------------------------#T----TT----T-----------------##-----SS-------------F
---M---------g--#-#-#-#-#-#T----TT-----kk----------------k--------------ggg-----------------------------#T----TT----T----------------###------------r-------#
XXXXXXXXXXXXXXXXXXXXXXXXXXXXXXXXXXXXXXXXXXXXXXXXXXXXXXXXXXXXXXXXXXXXXXXXXXXXXXXX---XXXXXXXXXXXXXXXXXXXXXXXXXXXXXXXXXXXXXXXXXX---XXXXXXXXXX-------XXXXXXXX--X-
XXXXXXXXXXXXXXXXXXXXXXXXXXXXXXXXXXXXXXXXXXXXXXXXXXXXXXXXXXXXXXXXXXXXXXXXXXXXXXXX---XXXXXXXXXXXXXXXXXXXXXXXXXXXXXXXXXXXXXXXXXX---XXXXXXXXXX-------XXXXXXXX--XX
