-------------------------------------------------------------------------------------------------------------------------------------------------------------
-------------------------------------------------------------------------------------------------------------------------------------------------------------
-------------------------------------------------------------------------------------------------------------------------------------------------------------
SSSSSSSSSSSSSSSSSSSSSSSSSSSSSSSSSSSSSSSSSSSSSSSSSSSSSSSSSSSSSSSSSSSSSSSSSSSSSSSS--SSSSSSSSSSSSSSSSSSSSSSSSSSSSSSSSSSSSSSSSSSSSSSSSSSSSSSSSSSSSSSSSSSSSSSS-SSS
SSSS--SSSS-----------------------SSSSS--SSSSSSSS--SSSSSSSS--SSSSSSSS--SSSSSSSS----SS----SSSSS--SSSS----SSSSS-------------SSSS---------SSSS-------------------
SSSS--SSSS-----------------------SSSSS--SSSSSSSS--SSSSSSSS--SSSSSSSS--SSSSSSSS----SS----SSSSS--SSSS----SSSSS-------------SSSS---------SSSS-------------------
SSSS---S----SS---------------SS------S---S----SS---S----SS---S----SS---S----SS--------SS---SS---S----S----------------S----------ooS-------------------------
SSSS---S----SS---------------SS------S---S----SS---S----SS---S----SS---S----SS--------SS---SS---S----S----------------S------------S-------------------------
SSSS---S----SS---------------SS------S---S----SS---S----SS---S----SS---S----SS--------SS---SS---S----S----------------S----------SSS-------------------------
SSSS---SoU--SC---------------SC------S---SoUooSS---SooooSS---SoUooSS---SoUooSS----oU--SCoooSS---SoU--S----------------C----------SSC-------------------------
SSSS---SSS--SS------------TT-SS--SSSSS---SSSSSSS---SSSSSSS---SSSSSSS---SSSSSSS----SS--SSSSSSS---SSS--S-SSSS---TTT-----S--SSSS------S--SSSS-------------##----
--------------------TT----TT----------------------------------------------------------------------------T-----TTT-------------------------------------###--SS
--------------------TT----TT----------------------------------------------------------------------------------TTT----T-------------------------------####--SF
---M---------g------TT----TT-----------kk----------------k--------------ggg-----------------------------------TTT---TT------------------------------r####--S#
XXXXXXXXXXXXXXXXXXXXXXXXXXXXXXXXXXXXXXXXXXXXXXXXXXXXXXXXXXXXXXXXXXXXXXXXXXXXXXXX--XXXXXXXXXXXXXXXXXXXXXXXXXXXXXXXXXXXXXXXXXXX---XXXXXXXXXX---XXXXXXXXXXXX--XX
XXXXXXXXXXXXXXXXXXXXXXXXXXXXXXXXXXXXXXXXXXXXXXXXXXXXXXXXXXXXXXXXXXXXXXXXXXXXXXXX--XXXXXXXXXXXXXXXXXXXXXXXXXXXXXXXXXXXXXXXXXXX---XXXXXXXXXX---XXXXXXXXXXXX--XX
