-------------------------------------------------------------------------------------------------------------------------------------------------------------
-------------------------------------------------------------------------------------------------------------------------------------------------------------
-------------------------------------------------------------------------------------------------------------------------------------------------------------
SSSSSSSSSSSSSSSSSSSSSSSSSSSSSSSSSSSSSSSSSSSSSSSSSSSSSSSSSSSSSSSSSSSSSSSSSSSSSSSS--SSSSSSSSLSSSSSSSSSSSSSSSSSSSSSSSSSSSSSSSSSSSSSSSSSSLSSSSSSSSSSSSSSSSSSSSSSS
SSSS--SSSSSS--SSSS--------------------SS--SSSSSS--SSSSSSSSSSSSS--SSSS-SSS--SSSS-------------SSSSS--SSSS---------------S-SSSS------------SSSS-----------------
SSSS--SSSSSS--SSSS--------------------SS--SSSSSS--SSSSSSSSSSSSS--SSSS-SSS--SSSS-------------SSSSS--SSSS---------------S-SSSS------------SSSS-----------------
-SS-------SS---S------------------------------SS---S--SSSSSSSSS---S----SS---S--------oooooo----SS---SS----------------S---------oooooo-----------------------
-SS-------SS---S------------------------------SS---S--SSSSSSSSS---S----SS---S------------------SS---SS----------------S--------------------------------------
-SS-------SS---S------------------------------SS---S--SSSSSSSSS---S----SS---S--------SSSSSS----SS---SS----------------S---------SSSSSS-----------------------
oSS---ooooSS---SoU------------------------ooooSS---SoUSSSSSSSSS---SoU-oSS---SoU------SSSSSS-oooSS---SS----------------S---------SSSSSS-------------------C---
SSSS--SSSSSS---SSS-------#-#----TT----SS--SSSSSS---SSSSSSSSSSSS---SSS-SSS---SSS-------------SSSSS---SS--------TT------S-SSSS------------SSSS-------#-#-------
---S-------------------#-#-#----TT----SS----------------------------------------------------------------TT----TT---------------------------------#-#-#-#---#-
---S-----------------#-#-#-#----TT----SS----------------------------------------------------------------TT----TT----TT---------------------------#-#-#-#---#F
---M---------g-----#-#-#-#-#----TT-----kk----------------k--------------ggg-----------------------------TT----TT----TT---------------------------#-#r#-#-E-##
XXXXXXXXXXXXXXXXXXXXXXXXXXXXXXXXXXXXXXXXXXXXXXXXXXXXXXXXXXXXXXXXXXXXXXXXXXXXXXXX----XXXXXXXXXXXXXXXXXXXXXXXXXXXXXXXXXXXXXXXX---XXXXXXXXXXXXX---XXXXXXXXXXXXXX
XXXXXXXXXXXXXXXXXXXXXXXXXXXXXXXXXXXXXXXXXXXXXXXXXXXXXXXXXXXXXXXXXXXXXXXXXXXXXXXX----XXXXXXXXXXXXXXXXXXXXXXXXXXXXXXXXXXXXXXXX---XXXXXXXXXXXXX---XXXXXXXXXXXXXX
