-------------------------------------------------------------------------------------------------------------------------------------------------------------
-------------------------------------------------------------------------------------------------------------------------------------------------------------
-------------------------------------------------------------------------------------------------------------------------------------------------------------
SSSSSSSSSSSSSSSSSSSSSSSSSSSSSSSSSSSSSSSSSSSSSSSSSSSSSSSSSSSSSSSSSSSSSSSSSSSSSSSS--SSSSSSSSSSSSSSSSSSSSSSSSSSSSSSSSSSSSSSSSSSSSSSSSSSSSSSSSSSSSS--------------
SSSS--SSSSSS--SSSS--------------S--SSSSSS--SSSSS--SSSSSSSS--SSSSSSSS--SSSSSSSS----SS-SSSS--SSSS--S--SSSS-----------------------SSSSSS--SSSSS-----------------
SSSS--SSSSSS--SSSS--------------S--SSSSSS--SSSSS--SSSSSSSS--SSSSSSSS--SSSSSSSS----SS-SSSS--SSSS--S--SSSS-----------------------SSSSSS--SSSSS-----------------
--SS------SS---S-----------------------SS---S-SS---S----SS---S-SSSSS---S----SS---------SS---S----S---S-----------------------------SS---S--------------------
--SS------SS---S-----------------------SS---S-SS---S----SS---S-SSSSS---S----SS---------SS---S----S---S-----------------------------SS---S--------------------
--SS------SS---S-----------------------SS---S-SS---S----SS---S-SSSSS---S----SS---------SS---S----S---S-----------------------------SS---S--------------------
ooSS--ooooSS---SoU-----------------ooooSS---SoSS---SooooSS---SoSSSSS---SoUooSS----oU-ooSS---SoU--S---SoU-----------------------ooooSS---So-------SSSSSSU-----
SSSS--SSSSSS---SSS-------##T----S--SSSSSS---SSSS---SSSSSSS---SSSSSSS---SSSSSSS----SS-SSSS---SSS--S---SSS------TT---------------SSSSSS---SSSS-----------------
------------------------###T----S-----------------------------------------------------------------------TT----TT----------SS---------------------------------
-----------------------####T----S-----------------------------------------------------------------------TT----TT----TT----SS--------------------------------F
---M---------g--------#####T-----------kk----------------k--------------ggg-----------------------------TT----TT----TT----SS------------------------r-------#
XXXXXXXXXXXXXXXXXXXXXXXXXXXXXXXXXXXXXXXXXXXXXXXXXXXXXXXXXXXXXXXXXXXXXXXXXXXXXXXX--XXXXXXXXXXXXXXXXXXXXXXXXXXXXXXXXXXXXXX--XX-XXXXXXXXXXXXXXX-----XXXXXXXX--X-
XXXXXXXXXXXXXXXXXXXXXXXXXXXXXXXXXXXXXXXXXXXXXXXXXXXXXXXXXXXXXXXXXXXXXXXXXXXXXXXX--XXXXXXXXXXXXXXXXXXXXXXXXXXXXXXXXXXXXXX--XX-XXXXXXXXXXXXXXX-----XXXXXXXX--XX
