-------------------------------------------------------------------------------------------------------------------------------------------------------------
-------------------------------------------------------------------------------------------------------------------------------------------------------------
-------------------------------------------------------------------------------------------------------------------------------------------------------------
SSSSSSSSSSSSSSSSSSSSSSSSSSSSSSSSSSSSSSSSSSSSSSSSSSSSSSSSSSSSSSSSSSSSSSSSSSSSSSSS--SSSSSSSLSSSSSSSSSSSSSSSSSSSSSSSSSSSSSSSSSSSSSSSSSSSLSSSS-SSSSSSSSSSSSSS----
SSSS--SSSS--SSSSSS--SSSS--------SS--SSSSSSSSSSSSSSSSSSSS-SSSSSS--SSSS----SSSSSSS----------SSS--SSSS------SS-------------SSSS---------------------------------
SSSS--SSSS--SSSSSS--SSSS--------SS--SSSSSSSSSSSSSSSSSSSS-SSSSSS--SSSS----SSSSSSS----------SSS--SSSS------SS-------------SSSS---------------------------------
S-SS---S--------SS---S--------SS--------SS---SSSSSS---SS-----SS---S----SS-SS--------oooooo-SS---S----SS--------------S----------oooooo---------------------SS
S-SS---S--------SS---S--------SS--------SS---SSSSSS---SS-----SS---S----SS-SS---------------SS---S----SS--------------S---------------------------------------
S-SS---S--------SS---S--------SS--------SS---SSSSSS---SS-----SS---S----SS-SS--------SSSSSS-SS---S----SS--------------S----------SSSSSS-----------------------
SoSS---SoU--ooooSS---SoU------SS----ooooSSoooSSSSSSoooSS-ooooSS---SoU--SCoSS--------SSSSSSoSS---SoU--SC--------------C----------SSSSSS-----------------------
SSSS---SSS--SSSSSS---SSS-##---SSSS--SSSSSSSSSSSSSSSSSSSS-SSSSSS---SSS--SSSSSSSSS----------SSS---SSS--SS--SS---TT-----S--SSSS------------##----------##-##----
S-----------------------###-----SS----------------------------------------------------------------------T-----TT-----------------------###---------######----
S-----------------------###-----SS----------------------------------------------------------------------------TT----T-----------------####--------#######--SF
S--M---------g----------###------------kk----------------k--------------ggg-----------------------------------TT----T-----------------####-------###r####---#
XXXXXXXXXXXXXXXXXXXXXXXXXXXXXXXXXXXXXXXXXXXXXXXXXXXXXXXXXXXXXXXXXXXXXXXXXXXXXXXX---XXXXXXXXXXXXXXXXXXXXXXXXXXXXXXXXXXXXXXXXX---XXXXXXXXXXX-XXXXXXXXXXXXXX----
XXXXXXXXXXXXXXXXXXXXXXXXXXXXXXXXXXXXXXXXXXXXXXXXXXXXXXXXXXXXXXXXXXXXXXXXXXXXXXXX---XXXXXXXXXXXXXXXXXXXXXXXXXXXXXXXXXXXXXXXXX---XXXXXXXXXXX-XXXXXXXXXXXXXX----
