-------------------------------------------------------------------------------------------------------------------------------------------------------------
-------------------------------------------------------------------------------------------------------------------------------------------------------------
-------------------------------------------------------------------------------------------------------------------------------------------------------------
SSSSSSSSSSSSSSSSSSSSSSSSSSSSSSSSSSSSSSSSSSSSSSSSSSSSSSSSSSSSSSSSSSSSSSSSSSSSSSSS--SSSSSSSSSSSSSSSSSSSSSSSSSSSSSSSSSSSSSSSSSSSSSSSSSSSSSSSSSSSSSSSSSSSSSSS----
-SS--SSSSSS--SS-----------------SS--SSSSSS--SSSS--SSSSSSS--SSSS----SSSSSS-SSSSS----------SSSSSS--SS------SSSS-------------SS----------SSSS--SS---------------
-SS--SSSSSS--SS-----------------SS--SSSSSS--SSSS--SSSSSSS--SSSS----SSSSSS-SSSSS----------SSSSSS--SS------SSSS-------------SS----------SSSS--SS---------------
S--------SS---S---------------SS--------SS---S-S---SSS-SS---S----SS----SS----SS-----ooooo----SS---S--SS---------------------------SS-----------------------SS
S--------SS---S---------------SS--------SS---S-S---SSS-SS---S----SS----SS----SS--------------SS---S--SS---------------------------SS-------------------------
S--------SS---S---------------SS--------SS---S-S---SSS-SS---S----SS----SS----SS-----SSSSS----SS---S--SS---------------------------SS-------------------------
S----ooooSS---S---------------SS----ooooSS---SoS---SSSoSS---SoU--SCooooSS-oooSS-----SSSSSooooSS---S--SC---------------------------SC-------------------------
SSS--SSSSSS---S--------##-TT--SSSS--SSSSSS---SSS---SSSSSS---SSS--SSSSSSSS-SSSSS----------SSSSSS---S--SS--SSSS-TT----------SS------SS--SSSS--SS---------##----
-SS-------------------###-TT----SS----------------------------------------------------------------------T-----TT--------------------------------------###----
-SS------------------####-TT----SS----------------------------------------------------------------------------TT----TT-------------------------------####--SF
---M---------g------#####-TT-----------kk----------------k--------------ggg-----------------------------------TT----TT------------------------------r####---#
XXXXXXXXXXXXXXXXXXXXXXXXXXXXXXXXXXXXXXXXXXXXXXXXXXXXXXXXXXXXXXXXXXXXXXXXXXXXXXXX---XXXXXXXXXXXXXXXXXXXXXXXXXXXXXXXXXXXXXX-XX---XXXXXXXXXXX--XX---XXXXXXXX----
XXXXXXXXXXXXXXXXXXXXXXXXXXXXXXXXXXXXXXXXXXXXXXXXXXXXXXXXXXXXXXXXXXXXXXXXXXXXXXXX---XXXXXXXXXXXXXXXXXXXXXXXXXXXXXXXXXXXXXX-XX---XXXXXXXXXXX--XX---XXXXXXXX----
