-------------------------------------------------------------------------------------------------------------------------------------------------------------
-------------------------------------------------------------------------------------------------------------------------------------------------------------
-------------------------------------------------------------------------------------------------------------------------------------------------------------
SSSSSSSSSSSSSSSSSSSSSSSSSSSSSSSSSSSSSSSSSSSSSSSSSSSSSSSSSSSSSSSSSSSSSSSSSSSSSSSS--SSSSSSSSSSSSSSSSSSSSSSSSSSSSSSSSSSSSSSSSSSSSSSSSSSSSSSSS--------SSSSSSS-SSS
SSSS--SSSS----SSSS----------------SSS--SSSSSSSS--SSSSSSSS--SSSS---SSSSS-SSSSSS----SS----SSSSS--SSSS---SS------------------SS--------SS-----------------------
SSSS--SSSS----SSSS----------------SSS--SSSSSSSS--SSSSSSSS--SSSS---SSSSS-SSSSSS----SS----SSSSS--SSSS---SS------------------SS--------SS-----------------------
--SS---S----SS--SS-----------------SS---S----SS---S----SS---S----S---SS-----SS--------SS---SS---S----S--------------------------ooooSS------SSS--------------
--SS---S----SS--SS-----------------SS---S----SS---S----SS---S----S---SS-----SS--------SS---SS---S----S------------------------------SS-----------------------
--SS---S----SS--SS-----------------SS---S----SS---S----SS---S----S---SS-----SS--------SS---SS---S----S--------------------------SSSSSS-----------------------
ooSS---SoU--SCooSS----------------oSS---SooooSS---SooooSS---SoU--SoooSS-ooooSS----oU--SCoooSS---SoU--S--------------------------SSSSSS-----------S-----------
SSSS---SSS--SSSSSS----#---------TTSSS---SSSSSSS---SSSSSSS---SSS--SSSSSS-SSSSSS----SS--SSSSSSS---SSS--SSS------TT----------SS--------SS--##-------------##----
---------------------##---TT----TT----------------------------------------------------------------------TT----TT-----------------------###------------###--SS
--------------------###---TT----TT----------------------------------------------------------------------TT----TT----TT-----------------###--SSS------####--SF
---M---------g-----####---TT----TT-----kk----------------k--------------ggg-----------------------------TT----TT----TT-----------------###----------r####--S#
XXXXXXXXXXXXXXXXXXXXXXXXXXXXXXXXXXXXXXXXXXXXXXXXXXXXXXXXXXXXXXXXXXXXXXXXXXXXXXXX--XXXXXXXXXXXXXXXXXXXXXXXXXXXXXXXXXXXXX---XX---XXXXXXXXXXX-------XXXXXXXX--XX
XXXXXXXXXXXXXXXXXXXXXXXXXXXXXXXXXXXXXXXXXXXXXXXXXXXXXXXXXXXXXXXXXXXXXXXXXXXXXXXX--XXXXXXXXXXXXXXXXXXXXXXXXXXXXXXXXXXXXX---XX---XXXXXXXXXXX-------XXXXXXXX--XX
