-------------------------------------------------------------------------------------------------------------------------------------------------------------
-------------------------------------------------------------------------------------------------------------------------------------------------------------
-------------------------------------------------------------------------------------------------------------------------------------------------------------
SSSSSSSSSSSSSSSSSSSSSSSSSSSSSSSSSSSSSSSSSSSSSSSSSSSSSSSSSSSSSSSSSSSSSSSSSSSSSSSS--SSSSSSSSSSSSSSSSSSSSSSSSSSSSSSSSSSSSSSSSSSSSSSSSSSSLSSSSSSSSSSSSSSSSSS-SSSS
SSSS--SSSSSS--SSSS-------------------SS--SSSSSS--SSSSSSS--SSSSS--SSSS-----SSSSSS---SSSSSS--SSSSSSS------SSSS--------SSSS---------------SS--------------------
SSSS--SSSSSS--SSSS-------------------SS--SSSSSS--SSSSSSS--SSSSS--SSSS-----SSSSSS---SSSSSS--SSSSSSS------SSSS--------SSSS---------------SS--------------------
SS--------SS---S-------------------SS--------SS---SS--SS-----SS---S----SS---SSS--------SS---S--S----SS--------------------------oooooo-----------------------
SS--------SS---S-------------------SS--------SS---SS--SS-----SS---S----SS---SSS--------SS---S--S----SS-------------------------------------------------------
SS--------SS---S-------------------SS--------SS---SS--SS-----SS---S----SS---SSS--------SS---S--S----SS--------------------------SSSSSS-----------------------
SS----ooooSS---SoU-----------------SS----ooooSS---SSooSS---ooSS---SoU--SC-ooSSS----ooooSS---So-SoU--SC--------------------------SSSSSS-----------------------
SSSS--SSSSSS---SSS--------TT-------SSSS--SSSSSS---SSSSSS---SSSS---SSS--SS-SSSSSS---SSSSSS---SS-SSS--SS--SSSS--TTT---SSSS---------------SS-------------##-----
--SS----------------TT----TT---------SS----------------------------------------S------------------------T------TT----------------------SSS-----------###---SS
--SS----------------TT----TT----TT---SS----------------------------------------S-------------------------------TT----------------------SSS----------####---SF
---M---------g------TT----TT----TT-----kk----------------k--------------ggg------------------------------------TT---T--------------------S---------#r###---S#
XXXXXXXXXXXXXXXXXXXXXXXXXXXXXXXXXXXXXXXXXXXXXXXXXXXXXXXXXXXXXXXXXXXXXXXXXXXXXXXX--XXXXXXXXXXXXXXXXXXXXXXXXXXXXXXXXXXXXXX---X---XXXXXXXXXXX--XXXXXXXXXXXX---XX
XXXXXXXXXXXXXXXXXXXXXXXXXXXXXXXXXXXXXXXXXXXXXXXXXXXXXXXXXXXXXXXXXXXXXXXXXXXXXXXX--XXXXXXXXXXXXXXXXXXXXXXXXXXXXXXXXXXXXXX---X---XXXXXXXXXXX--XXXXXXXXXXXX---XX
