-------------------------------------------------------------------------------------------------------------------------------------------------------------
-------------------------------------------------------------------------------------------------------------------------------------------------------------
-------------------------------------------------------------------------------------------------------------------------------------------------------------
SSSSSSSSSSSSSSSSSSSSSSSSSSSSSSSSSSSSSSSSSSSSSSSSSSSSSSSSSSSSSSSSSSSSSSSSSSSSSSSS--SSSSSSSSSSSSSSSSSSSSSSSSSSSSSSSSSSSSSSSSSSSSSSSSSSSSSSSS-----SSSSSSSSSSSSSS
SSSS--SSSSSSSS------------------------SSSSSSSSSS--SSSSSSSS--SSSS----SSSSS--SSSS---S--SSSSSSSS--SSSS------SS-----------SS-SSS---------S-----------------------
SSSS--SSSSSSSS------------------------SSSSSSSSSS--SSSSSSSS--SSSS----SSSSS--SSSS---S--SSSSSSSS--SSSS------SS-----------SS-SSS---------S-----------------------
--SS---S----SS-------------------------S--SS--SS---S----SS---S----SS---SS---S------------SSSS---S----SS---------------SS--------ooooo-------SSS--------------
--SS---S----SS-------------------------S--SS--SS---S----SS---S----SS---SS---S------------SSSS---S----SS---------------SS-------------------------------------
--SS---S----SS-------------------------S--SS--SS---S----SS---S----SS---SS---S------------SSSS---S----SS---------------SS--------SSSSS------------------------
ooSS---SooooSS-------------------------SooSSooSS---SooooSS---SoU--SCoooSS---SoU------ooooSSSS---SoU--SC---------------SS--------SSSSS------------------------
SSSS---SSSSSSS----------##TT-----------SSSSSSSSS---SSSSSSS---SSS--SSSSSSS---SSS---S--SSSSSSSS---SSS--SS--SS---TT------SS-SSS------------##------------##-----
-----------------------###TT------------------------------------------------------S---------------------T-----TT-----------------------###-----------###---SS
----------------------####TT----TT------------------------------------------------S---------------------------TT----TT----------------####--SSS-----####---SF
---M---------g-------#####TT----TT-----kk----------------k--------------ggg-----------------------------------TT----TT----------------####---------#r###---S#
XXXXXXXXXXXXXXXXXXXXXXXXXXXXXXXXXXXXXXXXXXXXXXXXXXXXXXXXXXXXXXXXXXXXXXXXXXXXXXXX--XXXXXXXXXXXXXXXXXXXXXXXXXXXXXXXXXXXXXXXXXX---XXXXXXXXXXX-----XXXXXXXXXX--XX
XXXXXXXXXXXXXXXXXXXXXXXXXXXXXXXXXXXXXXXXXXXXXXXXXXXXXXXXXXXXXXXXXXXXXXXXXXXXXXXX--XXXXXXXXXXXXXXXXXXXXXXXXXXXXXXXXXXXXXXXXXX---XXXXXXXXXXX-----XXXXXXXXXX--XX
