-------------------------------------------------------------------------------------------------------------------------------------------------------------
-------------------------------------------------------------------------------------------------------------------------------------------------------------
-------------------------------------------------------------------------------------------------------------------------------------------------------------
SSSSSSSSSSSSSSSSSSSSSSSSSSSSSSSSSSSSSSSSSSSSSSSSSSSSSSSSSSSSSSSSSSSSSSSSSSSSSSSS--SSSSSSSSSSSSSSSSSSSSSSSSSSSSSSSSSSSSSSSSSSSSSSSSSSSLSSSSSSSSSSSSSSSSSSS-SSS
--SS--SSSSSS-SSSSS--SS-------------SSSSSS--SSSSS--SSSSSSS--SSSS--SSS--SSSS-SSS----SS----SSSSS--SSSS------SSSS----------S--SS-----------SSSS------------------
--SS--SSSSSS-SSSSS--SS-------------SSSSSS--SSSSS--SSSSSSS--SSSS--SSS--SSSS-SSS----SS----SSSSS--SSSS------SSSS----------S--SS-----------SSSS------------------
SS--------SS--SSSS---S-----------------SS---S-SS---S---SS---S-----SS---S----SS--------SS---SS---S----SS----------------S--------oooooo-----------------------
SS--------SS--SSSS---S-----------------SS---S-SS---S---SS---S-----SS---S----SS--------SS---SS---S----SS----------------S-------------------------------------
SS--------SS--SSSS---S-----------------SS---S-SS---S---SS---S-----SS---S----SS--------SS---SS---S----SS----------------S--------SSSSSS-----------------------
SS----ooooSS-oSSSS---S--------C----ooooSS---SoSS---SoooSS---SoU--oSS---SoU-oSS----oU--SCoooSS---SoU--SC----------------S--------SSSSSS-----------------------
SSSS--SSSSSS-SSSSS---S--#-#--------SSSSSS---SSSS---SSSSSS---SSS--SSS---SSS-SSS----SS--SSSSSSS---SSS--SS--SSSS-TT-------S---S-----------SSSS-----------###----
--SS------------------#-#-#-#---#-----------------------------------------------------------------------T-----TT-------------------------------------####--SS
--SS------------------#-#-#-#---#-#---------------------------------------------------------------------------TT----TT------------------------------#####--SF
---M---------g--------#-#-#-#-E-#-#----kk----------------k--------------ggg-----------------------------------TT----TT-----------------------------#r####--S#
XXXXXXXXXXXXXXXXXXXXXXXXXXXXXXXXXXXXXXXXXXXXXXXXXXXXXXXXXXXXXXXXXXXXXXXXXXXXXXXX--XXXXXXXXXXXXXXXXXXXXXXXXXXXXXXXXXXXXXXXXXX---XXXXXXXXXXXX---XXXXXXXXXXX--XX
XXXXXXXXXXXXXXXXXXXXXXXXXXXXXXXXXXXXXXXXXXXXXXXXXXXXXXXXXXXXXXXXXXXXXXXXXXXXXXXX--XXXXXXXXXXXXXXXXXXXXXXXXXXXXXXXXXXXXXXXXXX---XXXXXXXXXXXX---XXXXXXXXXXX--XX
