-------------------------------------------------------------------------------------------------------------------------------------------------------------
-------------------------------------------------------------------------------------------------------------------------------------------------------------
-------------------------------------------------------------------------------------------------------------------------------------------------------------
SSSSSSSSSSSSSSSSSSSSSSSSSSSSSSSSSSSSSSSSSSSSSSSSSSSSSSSSSSSSSSSSSSSSSSSSSSSSSSSS--SSSSSSSSSSSSSSSSSSSSSSSSSSSSSSSSSSSSSSSSSSSSSSSSSSSSSSSS------------SSS----
SSSS--SSSSS----------------------SSSSS--SSSSSSS--SSSSSSSSS--SSSS------SSS--SSSS------SSSSSS--SSSSSS--SSSS--SS--------------------SSSS------------------------
SSSS--SSSSS----------------------SSSSS--SSSSSSS--SSSSSSSSS--SSSS------SSS--SSSS------SSSSSS--SSSSSS--SSSS--SS--------------------SSSS------------------------
--SS-----SS-------------------------SS---S---SS---S---SSSS---S----SS---SS---S------------SS---S--SS---S--------------------------SSSS-------SSS------------SS
--SS-----SS-------------------------SS---S---SS---S---SSSS---S----SS---SS---S------------SS---S--SS---S--------------------------SSSS------------------------
--SS-----SS-------------------------SS---S---SS---S---SSSS---S----SS---SS---S------------SS---S--SS---S--------------------------SSSS------------------------
ooSS---ooSS----------------------oooSS---SoUoSS---SoooSSSS---SoU--SC--oSS---SoU------ooooSS---SoUSS---SoU------------------------SSSS------------SSSSS-------
SSSS---SSSS---------------TT-----SSSSS---SSSSSS---SSSSSSSS---SSS--SS--SSS---SSS------SSSSSS---SSSSS---SSS-----T##----------------SSSS---##-------------##----
--------------------TT----TT----------------------------------------------------------------------------T-----###----------SS----------###------------###----
--------------------TT----TT---TT----------------------------------------------------------------------------####---TT-----SS---------####--SSS-------###--SF
---M---------g------TT----TT#--TT------kk----------------k--------------ggg----------------------------------####---TT-----SS--------#####----------r-###---#
XXXXXXXXXXXXXXXXXXXXXXXXXXXXXXXXXXXXXXXXXXXXXXXXXXXXXXXXXXXXXXXXXXXXXXXXXXXXXXXX---XXXXXXXXXXXXXXXXXXXXXXXXXXXXXXXXXXXXXX--XX--XXXXXXXXXXX-------XXXXXXXX----
XXXXXXXXXXXXXXXXXXXXXXXXXXXXXXXXXXXXXXXXXXXXXXXXXXXXXXXXXXXXXXXXXXXXXXXXXXXXXXXX---XXXXXXXXXXXXXXXXXXXXXXXXXXXXXXXXXXXXXX--XX--XXXXXXXXXXX-------XXXXXXXX----
