-------------------------------------------------------------------------------------------------------------------------------------------------------------
-------------------------------------------------------------------------------------------------------------------------------------------------------------
-------------------------------------------------------------------------------------------------------------------------------------------------------------
SSSSSSSSSSSSSSSSSSSSSSSSSSSSSSSSSSSSSSSSSSSSSSSSSSSSSSSSSSSSSSSSSSSSSSSSSSSSSSSS--SSSSSSSLSSSSSSSSSSSSSSSSSSSSSSSSSSSSSSSSSSSSSSSSSSSSSSSS---------SSSSSS----
SSSS--SSSS-SSS--SSSS-------------SSSS--SSSSSSSSS--SSSSSSSSSSSS--SSSS----SSSSSSSS----------SSS--SSSS------SS-----------SS--SSSS---SSSS--SS--------------------
SSSS--SSSS-SSS--SSSS-------------SSSS--SSSSSSSSS--SSSSSSSSSSSS--SSSS----SSSSSSSS----------SSS--SSSS------SS-----------SS--SSSS---SSSS--SS--------------------
--SS---S----SS---S------------o----SS---S-----SS---S--SS----SS---S----SS--SS--------oooooo-SS---S----SS---------------SS---S----S--SS---S---SSS------------SS
--SS---S----SS---S-----------------SS---S-----SS---S--SS----SS---S----SS--SS---------------SS---S----SS---------------SS---S----S--SS---S--------------------
--SS---S----SS---S------------S----SS---S-----SS---S--SS----SS---S----SS--SS--------SSSSSS-SS---S----SS---------------SS---S----S--SS---S--------------------
ooSS---SoU-oSS---SoU---------------SS---SoUoooSS---SooSSooooSS---SoU--SCooSS--------SSSSSSoSS---SoU--SC---------------SS---SoU--SooSS---S--------SS----------
SSSS---SSS-SSS---SSS----#-#------SSSS---SSSSSSSS---SSSSSSSSSSS---SSS--SSSSSSSSSS----------SSS---SSS--SS--SS---TT------SS---SSS--SSSSS---S#-------------##----
----------------------#-#-#-#---#SS---------------------------------------------------------------------T-----TT-------------------------#------------###----
----------------------#-#-#-#--##SS---------------------------------------------------------------------------TT----TT-------------------#--SSS------####--SF
---M---------g--------#-#-#-#--##------kk----------------k--------------ggg-----------------------------------TT----TT-------------------#----------r####---#
XXXXXXXXXXXXXXXXXXXXXXXXXXXXXXXXXXXXXXXXXXXXXXXXXXXXXXXXXXXXXXXXXXXXXXXXXXXXXXXX---XXXXXXXXXXXXXXXXXXXXXXXXXXXXXXXXXXXXXXXXXXXXXXXXXXXXXXX-------XXXXXXXX----
XXXXXXXXXXXXXXXXXXXXXXXXXXXXXXXXXXXXXXXXXXXXXXXXXXXXXXXXXXXXXXXXXXXXXXXXXXXXXXXX---XXXXXXXXXXXXXXXXXXXXXXXXXXXXXXXXXXXXXXXXXXXXXXXXXXXXXXX-------XXXXXXXX----
