-------------------------------------------------------------------------------------------------------------------------------------------------------------
-------------------------------------------------------------------------------------------------------------------------------------------------------------
-------------------------------------------------------------------------------------------------------------------------------------------------------------
SSSSSSSSSSSSSSSSSSSSSSSSSSSSSSSSSSSSSSSSSSSSSSSSSSSSSSSSSSSSSSSSSSSSSSSSSSSSSSSS--SSSSSSSSSSSSSSSSSSSSSSSSSSSSSSSSSSSSSSSSSSSSSSSSSSSSSSSS-SSSSSSSSSSSSSS-SSS
SSSS--SSSSSSSSSSSS--SSSS--------SS--SSSSSS-SSSSS--SSSSSSSSSSSS--SSSS---SS--SSSS----SSSSSSSSSSS--SS------------------SSSSSSSS-----SSSS------------------------
SSSS--SSSSSSSSSSSS--SSSS--------SS--SSSSSS-SSSSS--SSSSSSSSSSSS--SSSS---SS--SSSS----SSSSSSSSSSS--SS------------------SSSSSSSS-----SSSS------------------------
--SS---S--SS----SS---S--------SS--------SS----SS---S---SS---SS---S----SSS---S----------SS---SS---S-------------------S----------oS-SS------------------------
--SS---S--SS----SS---S--------SS--------SS----SS---S---SS---SS---S----SSS---S----------SS---SS---S-------------------S-----------S-SS------------------------
--SS---S--SS----SS---S--------SS--------SS----SS---S---SS---SS---S----SSS---S----------SS---SS---S-------------------S----------SS-SS------------------------
ooSS---SooSSooooSS---SoU------SS----ooooSS-oooSS---SoooSSoooSS---SoU--SSS---SoU----ooooSSoooSS---S-------------------SoU--------SSoSS------------------------
SSSS---SSSSSSSSSSS---SSS--##--SSSS--SSSSSS-SSSSS---SSSSSSSSSSS---SSS--SSS---SSS----SSSSSSSSSSS---S------------TTT----SSSSSSS-----SSSS---##-------------##----
-------------------------###----SS----------------------------------------------------------------------TT----TTT----------------------###------------###--SS
------------------------####----SS----------------------------------------------------------------------TT----TTT---------------------####-----------####--SF
---M---------g----------####-----------kk----------------k--------------ggg-----------------------------TT----TTT---T----------------#####----------r####--S#
XXXXXXXXXXXXXXXXXXXXXXXXXXXXXXXXXXXXXXXXXXXXXXXXXXXXXXXXXXXXXXXXXXXXXXXXXXXXXXXX---XXXXXXXXXXXXXXXXXXXXXXXXXXXXXXXXXXXXXXXXX---XXXXXXXXXXX---XXXXXXXXXXXX--XX
XXXXXXXXXXXXXXXXXXXXXXXXXXXXXXXXXXXXXXXXXXXXXXXXXXXXXXXXXXXXXXXXXXXXXXXXXXXXXXXX---XXXXXXXXXXXXXXXXXXXXXXXXXXXXXXXXXXXXXXXXX---XXXXXXXXXXX---XXXXXXXXXXXX--XX
