-------------------------------------------------------------------------------------------------------------------------------------------------------------
-------------------------------------------------------------------------------------------------------------------------------------------------------------
-------------------------------------------------------------------------------------------------------------------------------------------------------------
SSSSSSSSSSSSSSSSSSSSSSSSSSSSSSSSSSSSSSSSSSSSSSSSSSSSSSSSSSSSSSSSSSSSSSSSSSSSSSSS--SSSSSSSSSSSSSSSSSSSSSSSSSSSSSSSSSSSSSSSSSSSSSSSSSSSSSSSSSSSSSSSSSSSSSSSSSSS
S-SS--SSSSSS--SSSS----------------SSS--SSSSSSSSS--SSSSSSS--SSSS--SSSS---SSSSSS----SSSSSSS--SSSSSS--SS---------------------------------SSSS---S---------------
S-SS--SSSSSS--SSSS----------------SSS--SSSSSSSSS--SSSSSSS--SSSS--SSSS---SSSSSS----SSSSSSS--SSSSSS--SS---------------------------------SSSS---S---------------
SS--------SS---S-------------------SS---S-----SS---S---SS---SSS---S----S----SS---------SS---S--SS---S-----------------------------SS-------------------------
SS--------SS---S-------------------SS---S-----SS---S---SS---SSS---S----S----SS---------SS---S--SS---S-----------------------------SS-------------------------
SS--------SS---S-------------------SS---S-----SS---S---SS---SSS---S----S----SS---------SS---S--SS---S-----------------------------SS-------------------------
SS----ooooSS---SoU----------------oSS---SoUoooSS---SoooSS---SSS---SoU--SooooSS----oooooSS---SooSS---S-----------------------------SC---------------------C---
SSSS--SSSSSS---SSS------#-#------#SSS---SSSSSSSS---SSSSSS---SSS---SSS--SSSSSSS----SSSSSSS---SSSSS---S---------TT------------------SS--SSSS---S-----#-#-------
S-SS------------------#-#-#-----##----------------------------------------------------------------------TT----TT-----------SS--------------------#-#-#-#---#-
S-SS----------------#-#-#-#----###----------------------------------------------------------------------TT----TT----TT-----SS--------------------#-#-#-#---#F
S--M---------g----#-#-#-#-#---####-----kk----------------k--------------ggg-----------------------------TT----TT----TT-----SS--------------------#-#r#-#-E-##
XXXXXXXXXXXXXXXXXXXXXXXXXXXXXXXXXXXXXXXXXXXXXXXXXXXXXXXXXXXXXXXXXXXXXXXXXXXXXXXX--XXXXXXXXXXXXXXXXXXXXXXXXXXXXXXXXXXXXXXX--XX--XXXXXXXXXXX---X---XXXXXXXXXXXX
XXXXXXXXXXXXXXXXXXXXXXXXXXXXXXXXXXXXXXXXXXXXXXXXXXXXXXXXXXXXXXXXXXXXXXXXXXXXXXXX--XXXXXXXXXXXXXXXXXXXXXXXXXXXXXXXXXXXXXXX--XX--XXXXXXXXXXX---X---XXXXXXXXXXXX
