-------------------------------------------------------------------------------------------------------------------------------------------------------------
-------------------------------------------------------------------------------------------------------------------------------------------------------------
-------------------------------------------------------------------------------------------------------------------------------------------------------------
SSSSSSSSSSSSSSSSSSSSSSSSSSSSSSSSSSSSSSSSSSSSSSSSSSSSSSSSSSSSSSSSSSSSSSSSSSSSSSSS--SSSSSSSSSSSSSSSSSSSSSSSSSSSSSSSSSSSSSSSSSSSSSSSSSSSLSSSS-----------SSSS----
--SS--SSSSSS--SS---------------SS--SSSSSS--SSSSS--SSSSSSS--SSSS---SS--SSSSSSSSSS---SSSSSS--SSSS-SS--SSS-------------SSSS-SSS---------------------------------
--SS--SSSSSS--SS---------------SS--SSSSSS--SSSSS--SSSSSSS--SSSS---SS--SSSSSSSSSS---SSSSSS--SSSS-SS--SSS-------------SSSS-SSS---------------------------------
SS--------SS---S-------------SS--------SS---S-SS---S---SS---S----SSS---S---SS--S----S--SS---S---SS---SS---------------SS--------oooooo------SSS------------SS
SS--------SS---S-------------SS--------SS---S-SS---S---SS---S----SSS---S---SS--S----S--SS---S---SS---SS---------------SS-------------------------------------
SS--------SS---S-------------SS--------SS---S-SS---S---SS---S----SSS---S---SS--S----S--SS---S---SS---SS---------------SS--------SSSSSS-----------------------
SS----ooooSS---S-------------SS----ooooSS---SoSS---SoooSS---SoU--SSS---SoooSSooS----SoUSS---SoU-SS---SS-------------ooSS--------SSSSSS-----------SSSS--------
SSSS--SSSSSS---S----------TT-SSSS--SSSSSS---SSSS---SSSSSS---SSS--SSS---SSSSSSSSS----SSSSS---SSS-SS---SS-------TT----SSSS-SSS------------##-------------##----
--SS----------------TT----TT---SS-----------------------------------------------------------------------TT----TT-----------------------###------------###----
--SS----------------TT----TT---SS-----------------------------------------------------------------------TT----TT-----------------------###--SSS------####--SF
---M---------g------TT----TT-----------kk----------------k--------------ggg-----------------------------TT----TT----T------------------###----------r####---#
XXXXXXXXXXXXXXXXXXXXXXXXXXXXXXXXXXXXXXXXXXXXXXXXXXXXXXXXXXXXXXXXXXXXXXXXXXXXXXXX--XXXXXXXXXXXXXXXXXXXXXXXXXXXXXXXXXXXXXXXXXX---XXXXXXXXXXX-------XXXXXXXX----
XXXXXXXXXXXXXXXXXXXXXXXXXXXXXXXXXXXXXXXXXXXXXXXXXXXXXXXXXXXXXXXXXXXXXXXXXXXXXXXX--XXXXXXXXXXXXXXXXXXXXXXXXXXXXXXXXXXXXXXXXXX---XXXXXXXXXXX-------XXXXXXXX----
