-------------------------------------------------------------------------------------------------------------------------------------------------------------
-------------------------------------------------------------------------------------------------------------------------------------------------------------
-------------------------------------------------------------------------------------------------------------------------------------------------------------
SSSSSSSSSSSSSSSSSSSSSSSSSSSSSSSSSSSSSSSSSSSSSSSSSSSSSSSSSSSSSSSSSSSSSSSSSSSSSSSS--SSSSSSSSSSSSSSSSSSSSSSSSSSSSSSSSSSSSSSSSSSSSSSSSSSSSSSSSSSSSSSSSSSSSSSSSSSS
SSSS--SSSSSS--SSSS--S-----------------SS--SSSSSS--SSSSSSS--SSSSSSSSS--SSSSSSSS-----SSSSSS--SSSSSSSS------SSSS------------------SSSSS--SSSS-------------------
SSSS--SSSSSS--SSSS--S-----------------SS--SSSSSS--SSSSSSS--SSSSSSSSS--SSSSSSSS-----SSSSSS--SSSSSSSS------SSSS------------------SSSSS--SSSS-------------------
SSS-------SS---S---------------------S--------SS---S---SS---S-----SS---S----SS---------SS---S---S----SS---------------------------SS---S---------------------
SSS-------SS---S---------------------S--------SS---S---SS---S-----SS---S----SS---------SS---S---S----SS---------------------------SS---S---------------------
SSS-------SS---S---------------------S--------SS---S---SS---S-----SS---S----SS---------SS---S---S----SS---------------------------SS---S---------------------
SSS---ooooSS---SoU-------------------S----ooooSS---SoUoSS---SoooooSS---SoUooSS-----ooooSS---SoU-SoU--SC-------------------------ooSS---SoU-------------------
SSSS--SSSSSS---SSS--S-----TT---------SSS--SSSSSS---SSSSSS---SSSSSSSS---SSSSSSS-----SSSSSS---SSS-SSS--SS--SSSS-TT----------------SSSS---SSS------------##-----
--SS----------------ST----TT----------SS----------------------------------------------------------------T-----TT-----------SS------------------------###---SS
--SS----------------ST----TT----TT----SS----------------------------------------------------------------------TT----TT-----SS-----------------------####---SF
--SM---------g-------T----TT----TT-----kk----------------k--------------ggg-----------------------------------TT----TT-----SS----------------------#r###---S#
XXXXXXXXXXXXXXXXXXXXXXXXXXXXXXXXXXXXXXXXXXXXXXXXXXXXXXXXXXXXXXXXXXXXXXXXXXXXXXXX--XXXXXXXXXXXXXXXXXXXXXXXXXXXXXXXXXXXXXXX--XX--XXXXXXXXXXX--XXXXXXXXXXXXX--XX
XXXXXXXXXXXXXXXXXXXXXXXXXXXXXXXXXXXXXXXXXXXXXXXXXXXXXXXXXXXXXXXXXXXXXXXXXXXXXXXX--XXXXXXXXXXXXXXXXXXXXXXXXXXXXXXXXXXXXXXX--XX--XXXXXXXXXXX--XXXXXXXXXXXXX--XX
