-------------------------------------------------------------------------------------------------------------------------------------------------------------
-------------------------------------------------------------------------------------------------------------------------------------------------------------
-------------------------------------------------------------------------------------------------------------------------------------------------------------
SSSSSSSSSSSSSSSSSSSSSSSSSSSSSSSSSSSSSSSSSSSSSSSSSSSSSSSSSSSSSSSSSSSSSSSSSSSSSSSS--SSSSSSSSSSSSSSSSSSSSSSSSSSSSSSSSSSSSSSSSSSSSSSSSSSSLSSSS--------SSSSSSS-SSS
SSSS-SSSSSS--SS------------------------SSSSSSSS--SSSS----SSSSSS--SSSS-----SSSSS----SSSSSS--SSSSSSS--SSSS-----------------------------------------------------
SSSS-SSSSSS--SS------------------------SSSSSSSS--SSSS----SSSSSS--SSSS-----SSSSS----SSSSSS--SSSSSSS--SSSS-----------------------------------------------------
--SS-----SS---S------------------------SS----SS---S----SS----SS---S----SS---SS---------SS---S---SS---S--------------------------oooooo------SSS--------------
--SS-----SS---S------------------------SS----SS---S----SS----SS---S----SS---SS---------SS---S---SS---S-------------------------------------------------------
--SS-----SS---S------------------------SS----SS---S----SS----SS---S----SS---SS---------SS---S---SS---S--------------------------SSSSSS-----------------------
ooSS-ooooSS---S------------------------SSooooSS---SoU--SCooooSS---SoU--SC-ooSS-----ooooSS---SoooSS---SoU------------------------SSSSSS-----------S-----------
SSSS-SSSSSS---S---------##------TT-----SSSSSSSS---SSS--SSSSSSSS---SSS--SS-SSSSS----SSSSSS---SSSSSS---SSS------T##-----------------------##-------------##----
-----------------------###TT----TT----------------------------------------------------------------------T-----###----------S------------##------------###--SS
----------------------####TT----TT----T----------------------------------------------------------------------####---TT-----S------------##--SSS------####--SF
---M---------g-------#####TT----TT----Tkk----------------k--------------ggg---------------------------------#####---TT-----S------------##----------r####--S#
XXXXXXXXXXXXXXXXXXXXXXXXXXXXXXXXXXXXXXXXXXXXXXXXXXXXXXXXXXXXXXXXXXXXXXXXXXXXXXX---XXXXXXXXXXXXXXXXXXXXXXXXXXXXXXXXXXXXXXX--X---XXXXXXXXXXX-------XXXXXXXX--XX
XXXXXXXXXXXXXXXXXXXXXXXXXXXXXXXXXXXXXXXXXXXXXXXXXXXXXXXXXXXXXXXXXXXXXXXXXXXXXXX---XXXXXXXXXXXXXXXXXXXXXXXXXXXXXXXXXXXXXXX--X---XXXXXXXXXXX-------XXXXXXXX--XX
