-------------------------------------------------------------------------------------------------------------------------------------------------------------
-------------------------------------------------------------------------------------------------------------------------------------------------------------
-------------------------------------------------------------------------------------------------------------------------------------------------------------
SSSSSSSSSSSSSSSSSSSSSSSSSSSSSSSSSSSSSSSSSSSSSSSSSSSSSSSSSSSSSSSSSSSSSSSSSSSSSSSS--SSSSSSSSLSSSSSSSSSSSSSSSSSSSSSSSSSSSSSSSSSSSSSSSSSSLSSSSSSSSS--------------
--SS--SSSSSS--SSSS-----------------SS--SSSSSSSSS--SSSSSSSSSSSSS--SSSS----SSSSS--------------SS--SS-----------------SSSS--SSS-----------SSSS------------------
--SS--SSSSSS--SSSS-----------------SS--SSSSSSSSS--SSSSSSSSSSSSS--SSSS----SSSSS--------------SS--SS-----------------SSSS--SSS-----------SSSS------------------
SS--------SS---SSS-----------------SS---S-----SS---S---SS----SS---S----SS---SS-------oooooo-SS---S--------------S---------------oooooo-----------------------
SS--------SS---SSS-----------------SS---S-----SS---S---SS----SS---S----SS---SS--------------SS---S--------------S--------------------------------------------
SS--------SS---SSS-----------------SS---S-----SS---S---SS----SS---S----SS---SS-------SSSSSS-SS---S--------------S---------------SSSSSS-----------------------
SS----ooooSS---SSS------------C----SS---SoUoooSS---SoooSSooooSS---SoU--SCoooSS-------SSSSSS-SS---S--------------C---------------SSSSSS-----------SSSSSSU-----
SSSS--SSSSSS---SSS------#-#--------SS---SSSSSSSS---SSSSSSSSSSSS---SSS--SSSSSSS--------------SS---S------------TTS--SSSS--SSS-----------SSSS------------------
--SS----------------TT#-#-#-#---#-----------------------------------------------------------------------TT----TT---------------------------------------------
--SS----------------TT#-#-#-#---#-#---------------------------------------------------------------------TT----TT--------------------------------------------F
---M---------g------TT#-#-#-#-E-#-#----kk----------------k--------------ggg-----------------------------TT----TT----T-------------------------------r-------#
XXXXXXXXXXXXXXXXXXXXXXXXXXXXXXXXXXXXXXXXXXXXXXXXXXXXXXXXXXXXXXXXXXXXXXXXXXXXXXXX----XXXXXXXXXXXXXXXXXXXXXXXXXXXXXXXXXXX--XXX---XXXXXXXXXXXX---X--XXXXXXXX--X-
XXXXXXXXXXXXXXXXXXXXXXXXXXXXXXXXXXXXXXXXXXXXXXXXXXXXXXXXXXXXXXXXXXXXXXXXXXXXXXXX----XXXXXXXXXXXXXXXXXXXXXXXXXXXXXXXXXXX--XXX---XXXXXXXXXXXX---X--XXXXXXXX--XX
