-------------------------------------------------------------------------------------------------------------------------------------------------------------
-------------------------------------------------------------------------------------------------------------------------------------------------------------
-------------------------------------------------------------------------------------------------------------------------------------------------------------
SSSSSSSSSSSSSSSSSSSSSSSSSSSSSSSSSSSSSSSSSSSSSSSSSSSSSSSSSSSSSSSSSSSSSSSSSSSSSSSS--SSSSSSSSSSSSSSSSSSSSSSSSSSSSSSSSSSSSSSSSSSSSSSSSSSSSSSSSSSSSSSSSSSSSSSSSSSS
--SS--SSSSSS--SSS---------------SS--SSSSSS--SSSS--SSSSSSSS--SSSS----SSSSS--SSSSS--SSSSSSSSSSS--SSSS-----SS-----------SSSSSSS-----S----SSSS-------------------
--SS--SSSSSS--SSS---------------SS--SSSSSS--SSSS--SSSSSSSS--SSSS----SSSSS--SSSSS--SSSSSSSSSSS--SSSS-----SS-----------SSSSSSS-----S----SSSS-------------------
SS--------SS---S--------------SS--------SS---SSS---SS---SS---S----SSS--SS---S-SS---S--SS---SS---S----SS---------------S---------oSSS-------------------------
SS--------SS---S--------------SS--------SS---SSS---SS---SS---S----SSS--SS---S-SS---S--SS---SS---S----SS---------------S----------SSS-------------------------
SS--------SS---S--------------SS--------SS---SSS---SS---SS---S----SSS--SS---S-SS---S--SS---SS---S----SS---------------S---------SSSS-------------------------
SS----ooooSS---So-------------SS----ooooSS---SSS---SSoooSS---SoU--SCSooSS---SoSS---SooSSoooSS---SoU--SC---------------So--------SSSC-------------------------
SSSS--SSSSSS---SS--------#-#--SSSS--SSSSSS---SSS---SSSSSSS---SSS--SSSSSSS---SSSS---SSSSSSSSSS---SSS--SS-SS----TTT-----SSSSSS-----SSS--SSSS------------##-----
--SS-------------------#-#-#----SS----------------------------------------------------------------------TS-----TT------------------------------------###---SS
--SS-----------------#-#-#-#----SS----------------------------------------------------------------------SS-----TT-----------------------------------####---SF
---M---------g-----#-#-#-#-#-----------kk----------------k--------------ggg------------------------------------TT---T------------------------------#r###---S#
XXXXXXXXXXXXXXXXXXXXXXXXXXXXXXXXXXXXXXXXXXXXXXXXXXXXXXXXXXXXXXXXXXXXXXXXXXXXXXXX--XXXXXXXXXXXXXXXXXXXXXXXXXXXXXXXXXXXXXXXXXX---XXXXXXXXXXX--XXXXXXXXXXXXX--XX
XXXXXXXXXXXXXXXXXXXXXXXXXXXXXXXXXXXXXXXXXXXXXXXXXXXXXXXXXXXXXXXXXXXXXXXXXXXXXXXX--XXXXXXXXXXXXXXXXXXXXXXXXXXXXXXXXXXXXXXXXXX---XXXXXXXXXXX--XXXXXXXXXXXXX--XX
