-------------------------------------------------------------------------------------------------------------------------------------------------------------
-------------------------------------------------------------------------------------------------------------------------------------------------------------
-------------------------------------------------------------------------------------------------------------------------------------------------------------
SSSSSSSSSSSSSSSSSSSSSSSSSSSSSSSSSSSSSSSSSSSSSSSSSSSSSSSSSSSSSSSSSSSSSSSSSSSSSSSS--SSSSSSSSSSSSSSSSSSSSSSSSSSSSSSSSSSSSSSSSSSSSSSSSSSSSSSSS-------------SSSSSS
SSSS--SSSS----------------------SSSSSS--SSSSSSSSS--SSSSSS--SSSS-SSSS--SSSSSSSS----SSSSSSS--SSSSSSS--SSSS--------------SS--SSSS--SSSSS--S---------------------
SSSS--SSSS----------------------SSSSSS--SSSSSSSSS--SSSSSS--SSSS-SSSS--SSSSSSSS----SSSSSSS--SSSSSSS--SSSS--------------SS--SSSS--SSSSS--S---------------------
--SS---S----SS----------------------SS---S----SS-------SS---S-----SS---S----SS---------SS---S---SS---S----------------SS---S-------SS-------SSS--------------
--SS---S----SS----------------------SS---S----SS-------SS---S-----SS---S----SS---------SS---S---SS---S----------------SS---S-------SS------------------------
--SS---S----SS----------------------SS---S----SS-------SS---S-----SS---S----SS---------SS---S---SS---S----------------SS---S-------SS------------------------
ooSS---SoU--SC------------------ooooSS---SooooSS---ooooSS---SoU-ooSS---SoUooSS----oUoooSS---SoooSS---SoU--------------SS---SoU--oooSS------------SSSSSS------
SSSS---SSS--SS------------TT----SSSSSS---SSSSSSSS--SSSSSS---SSS-SSSS---SSSSSSS----SSSSSSS---SSSSSS---SSS------TT------SS---SSS--SSSSS---##-------------------
--------------------TT----TT--------------------S-------------------------------------------------------TT----TT------------------------##-------------SS----
--------------------TT----TT--------------------S-------------------------------------------------------TT----TT----TT------------------##--SSS--------SS---F
---M---------g------TT----TT-----------kk----------------k--------------ggg-----------------------------TT----TT----TT------------------##----------r--SS---#
XXXXXXXXXXXXXXXXXXXXXXXXXXXXXXXXXXXXXXXXXXXXXXXXXXXXXXXXXXXXXXXXXXXXXXXXXXXXXXXX--XXXXXXXXXXXXXXXXXXXXXXXXXXXXXXXXXXXXXXXXXXXXXXXXXXXXXXXX-------XXXXXXXX--XX
XXXXXXXXXXXXXXXXXXXXXXXXXXXXXXXXXXXXXXXXXXXXXXXXXXXXXXXXXXXXXXXXXXXXXXXXXXXXXXXX--XXXXXXXXXXXXXXXXXXXXXXXXXXXXXXXXXXXXXXXXXXXXXXXXXXXXXXXX-------XXXXXXXX--XX
