-------------------------------------------------------------------------------------------------------------------------------------------------------------
-------------------------------------------------------------------------------------------------------------------------------------------------------------
-------------------------------------------------------------------------------------------------------------------------------------------------------------
SSSSSSSSSSSSSSSSSSSSSSSSSSSSSSSSSSSSSSSSSSSSSSSSSSSSSSSSSSSSSSSSSSSSSSSSSSSSSSSS--SSSSSSSSSSSSSSSSSSSSSSSSSSSSSSSSSSSSSSSSSSSSSSSSSSSSSSSS---------SSSSSSSSSS
--SS--SSSSSS--SSSS--SSS---------------S--SSSSSS--SSSSSSSS--SSSS----SSSSSSSSSSS----SSSSSSSSSSS--SSSS------SSSS------------SSSS------SS------------------------
--SS--SSSSSS--SSSS--SSS---------------S--SSSSSS--SSSSSSSS--SSSS----SSSSSSSSSSS----SSSSSSSSSSS--SSSS------SSSS------------SSSS------SS------------------------
SS--------SS---SSS---S-----------------------SS---S----SS---S----SS---SS--SSSS--------SS---SS---S----SS--------------SS----------ooSS-------SSS--------------
SS--------SS---SSS---S-----------------------SS---S----SS---S----SS---SS--SSSS--------SS---SS---S----SS--------------SS------------SS------------------------
SS--------SS---SSS---S-----------------------SS---S----SS---S----SS---SS--SSSS--------SS---SS---S----SS--------------SS----------SSSS------------------------
SS----ooooSS---SSS---So------------------ooooSS---SoUooSS---SoU--SCoooSSooSSSS----ooooSSoooSS---SoU--SC--------------SC----------SSSS------------SS----------
SSSS--SSSSSS---SSS---SS---------TT----S--SSSSSS---SSSSSSS---SSS--SSSSSSSSSSSSS----SSSSSSSSSSS---SSS--SS--SSSS-TTT----SS--SSSS------SS---##-----------##------
--SS----------------------TT----TT----S-----------------------------------------------------------------T-----TTT----------------------###----------###SS----
--SS----------------------TT----TT----S-----------------------------------------------------------------------TTT---------------------####--SSS----####SS---F
---M---------g------------TT----TT-----kk----------------k--------------ggg-----------------------------------TTT---T----------------#####---------#r##SS---#
XXXXXXXXXXXXXXXXXXXXXXXXXXXXXXXXXXXXXXXXXXXXXXXXXXXXXXXXXXXXXXXXXXXXXXXXXXXXXXXX--XXXXXXXXXXXXXXXXXXXXXXXXXXXXXXXXXXXXXXXXXXX---XXXXXXXXXX-------XXXXXXXX--XX
XXXXXXXXXXXXXXXXXXXXXXXXXXXXXXXXXXXXXXXXXXXXXXXXXXXXXXXXXXXXXXXXXXXXXXXXXXXXXXXX--XXXXXXXXXXXXXXXXXXXXXXXXXXXXXXXXXXXXXXXXXXX---XXXXXXXXXX-------XXXXXXXX--XX
