-------------------------------------------------------------------------------------------------------------------------------------------------------------
-------------------------------------------------------------------------------------------------------------------------------------------------------------
-------------------------------------------------------------------------------------------------------------------------------------------------------------
SSSSSSSSSSSSSSSSSSSSSSSSSSSSSSSSSSSSSSSSSSSSSSSSSSSSSSSSSSSSSSSSSSSSSSSSSSSSSSSS--SSSSSSSSSSSSSSSSSSSSSSSSSSSSSSSSSSSSSSSSSSSSSSSSSSSSSSSS-------SSSSSSSSSSSS
SSSS--SSSS---SS--SSS-------------------SSS--SSSS---SSSSSS--SSSSSSSSS--SSSS-SSSSS--SSSSSSS--SSSSSSS--SSSS-----------------------SSSSSS------------------------
SSSS--SSSS---SS--SSS-------------------SSS--SSSS---SSSSSS--SSSSSSSSS--SSSS-SSSSS--SSSSSSS--SSSSSSS--SSSS-----------------------SSSSSS------------------------
SSSS---S----SSS---S---------------------SS---S---------SS---S-----SS---S------SS---S---SS---S---SS---S-----------------------------SS-------SSS--------------
SSSS---S----SSS---S---------------------SS---S---------SS---S-----SS---S------SS---S---SS---S---SS---S-----------------------------SS------------------------
SSSS---S----SSS---S---------------------SS---S---------SS---S-----SS---S------SS---S---SS---S---SS---S-----------------------------SS------------------------
SSSS---SoU--SSS---So-------------------oSS---SoU---ooooSS---SoUoooSS---SoU-oooSS---SoooSS---SoooSS---SoU-----------------------ooooSS--------------------C---
SSSS---SSS--SSS---SS-----###-----------SSS---SSS---SSSSSS---SSSSSSSS---SSS-SSSSS---SSSSSS---SSSSSS---SSS------TT---------------SSSSSS---##---------#-#-------
SS----------------------####-----TT---------------------------------------------------------------------TT----TT-----------S-----------###-------#-#-#-#---#-
SS---------------------#####-----TT----------------------------------------------------------------------T----TT----TT-----S-----------###--SSS--#-#-#-#---#F
SS-M---------g--------######-----TT----kk----------------k--------------ggg------------------------------T----TT----TT-----S-----------###-------#-#r#-#-E-##
XXXXXXXXXXXXXXXXXXXXXXXXXXXXXXXXXXXXXXXXXXXXXXXXXXXXXXXXXXXXXXXXXXXXXXXXXXXXXXXX--XXXXXXXXXXXXXXXXXXXXXXXXXXXXXXXXXXXXXXX--X--XXXXXXXXXXXX-------XXXXXXXXXXXX
XXXXXXXXXXXXXXXXXXXXXXXXXXXXXXXXXXXXXXXXXXXXXXXXXXXXXXXXXXXXXXXXXXXXXXXXXXXXXXXX--XXXXXXXXXXXXXXXXXXXXXXXXXXXXXXXXXXXXXXX--X--XXXXXXXXXXXX-------XXXXXXXXXXXX
