-------------------------------------------------------------------------------------------------------------------------------------------------------------
-------------------------------------------------------------------------------------------------------------------------------------------------------------
-------------------------------------------------------------------------------------------------------------------------------------------------------------
SSSSSSSSSSSSSSSSSSSSSSSSSSSSSSSSSSSSSSSSSSSSSSSSSSSSSSSSSSSSSSSSSSSSSSSSSSSSSSSS--SSSSSSSSSSSSSSSSSSSSSSSSSSSSSSSSSSSSSSSSSSSSSSSSSSSSSSSS-----------SSSS----
SSSS--SSSSSS--SSSS------------------SS--SSSSSS--SSSS---SS--SSSS--SSS--SSSSSSSSS---S--SSSSSS--SSSS--SS---------------SSSS-SSS------SSS------------------------
SSSS--SSSSSS--SSSS------------------SS--SSSSSS--SSSS---SS--SSSS--SSS--SSSSSSSSS---S--SSSSSS--SSSS--SS---------------SSSS-SSS------SSS------------------------
--SS---S--SS---S--------------------SS------SS---S----SSS---S-----SS---S-----SS---S------SS---S-----S-----------------SS--------oo-SS-------SSS------------SS
--SS---S--SS---S--------------------SS------SS---S----SSS---S-----SS---S-----SS---S------SS---S-----S-----------------SS-----------SS------------------------
--SS---S--SS---S--------------------SS------SS---S----SSS---S-----SS---S-----SS---S------SS---S-----S-----------------SS--------SS-SS------------------------
ooSS---SooSS---SoU------------------SS--ooooSS---SoU--SSS---SoU--oSS---SoUoooSS---S--ooooSS---SoU---S---------------ooSS--------SSoSS------------SSSS--------
SSSS---SSSSS---SSS--------TT----TT--SS--SSSSSS---SSS--SSS---SSS--SSS---SSSSSSSS---S--SSSSSS---SSS---S---------TT----SSSS-SSS------SSS---##-------------##----
--------------------TT----TT----TT----------------------------------------------------------------------TT----TT-----------------------###------------###----
--------------------TT----TT----TT----------------------------------------------------------------------TT----TT----------------------####--SSS------####--SF
---M---------g------TT----TT----TT-----kk----------------k--------------ggg-----------------------------TT----TT----T-----------------####----------r####---#
XXXXXXXXXXXXXXXXXXXXXXXXXXXXXXXXXXXXXXXXXXXXXXXXXXXXXXXXXXXXXXXXXXXXXXXXXXXXXXXX--XXXXXXXXXXXXXXXXXXXXXXXXXXXXXXXXXXXXXXXXXX---XXXXXXXXXXX-------XXXXXXXX----
XXXXXXXXXXXXXXXXXXXXXXXXXXXXXXXXXXXXXXXXXXXXXXXXXXXXXXXXXXXXXXXXXXXXXXXXXXXXXXXX--XXXXXXXXXXXXXXXXXXXXXXXXXXXXXXXXXXXXXXXXXX---XXXXXXXXXXX-------XXXXXXXX----
