-------------------------------------------------------------------------------------------------------------------------------------------------------------
-------------------------------------------------------------------------------------------------------------------------------------------------------------
-------------------------------------------------------------------------------------------------------------------------------------------------------------
SSSSSSSSSSSSSSSSSSSSSSSSSSSSSSSSSSSSSSSSSSSSSSSSSSSSSSSSSSSSSSSSSSSSSSSSSSSSSSSS--SSSSSSSSSSSSSSSSSSSSSSSSSSSSSSSSSSSSSSSSSSSSSSSSSSSSSSSSSSS----------------
SSSS--SSSSSS--SS----------------SSSSSS--SSSSSSSSS--SSSSSS--SSSSSSSSS--SSSS-----S---SSSSSS--SSSSSSSS------SSS-------------SSSS--SSSS--SSSSS-------------------
SSSS--SSSSSS--SS----------------SSSSSS--SSSSSSSSS--SSSSSS--SSSSSSSSS--SSSS-----S---SSSSSS--SSSSSSSS------SSS-------------SSSS--SSSS--SSSSS-------------------
-SS-------SS---S--------------------SS------SSSS-------SS---S-----SS---S----SS-S----S--SS---S---S----SS---------------S----------SS---S------SS--------------
-SS-------SS---S--------------------SS------SSSS-------SS---S-----SS---S----SS-S----S--SS---S---S----SS---------------S----------SS---S----------------------
-SS-------SS---S--------------------SS------SSSS-------SS---S-----SS---S----SS-S----S--SS---S---S----SS---------------S----------SS---S----------------------
oSS---ooooSS---S----------------ooooSS---oooSSSS---ooooSS---SoUoooSS---SoU--SC-S----SooSS---SoU-SoU--SC---------------C--------ooSS---SoU--------SSSSSSU-----
SSSS--SSSSSS---S----------TT----SSSSSS---SSSSSSSS--SSSSSS---SSSSSSSS---SSS--SS-S----SSSSS---SSS-SSS--SS--SSS--TT------S--SSSS--SSSS---SSSS-------------------
---S----------------TT----TT--------------------S-------------------------------------------------------T-----TT---------------------------------------------
---S----------------TT----TT--------------------S-------------------------------------------------------------TT----TT-----------------------SS-------------F
---M---------g------TT----TT-----------kk----------------k--------------ggg-----------------------------------TT----TT------------------------------r-------#
XXXXXXXXXXXXXXXXXXXXXXXXXXXXXXXXXXXXXXXXXXXXXXXXXXXXXXXXXXXXXXXXXXXXXXXXXXXXXXXX--XXXXXXXXXXXXXXXXXXXXXXXXXXXXXXXXXXXXXXXXXXX--XXXXXXXXXXX-------XXXXXXXX--X-
XXXXXXXXXXXXXXXXXXXXXXXXXXXXXXXXXXXXXXXXXXXXXXXXXXXXXXXXXXXXXXXXXXXXXXXXXXXXXXXX--XXXXXXXXXXXXXXXXXXXXXXXXXXXXXXXXXXXXXXXXXXX--XXXXXXXXXXX-------XXXXXXXX--XX
