-------------------------------------------------------------------------------------------------------------------------------------------------------------
-------------------------------------------------------------------------------------------------------------------------------------------------------------
-------------------------------------------------------------------------------------------------------------------------------------------------------------
SSSSSSSSSSSSSSSSSSSSSSSSSSSSSSSSSSSSSSSSSSSSSSSSSSSSSSSSSSSSSSSSSSSSSSSSSSSSSSSS--SSSSSSSSSSSSSSSSSSSSSSSSSSSSSSS-SSSSSSSSSSSSSSSSSSSSSSSS--SSSSSSSSSSSSS-SSS
SSSSS--SSSSSS--SSSS-------------SSSSSS--SSSSSSSS---SSSSSSSSSSS--SSSSSSSSS--SSSSS---SSSSSS--SSSS---SSSS--SSSS-------------------SSSSS-------------------------
SSSSS--SSSSSS--SSSS-------------SSSSSS--SSSSSSSS---SSSSSSSSSSS--SSSSSSSSS--SSSSS---SSSSSS--SSSS---SSSS--SSSS-------------------SSSSS-------------------------
-SSSS------SS---S-------------------SS---S----SS-------SS---SS---S-----SS---S----------SS---S----S--SS---S------------------------SS-------------------------
-SSSS------SS---S-------------------SS---S----SS-------SS---SS---S-----SS---S----------SS---S----S--SS---S------------------------SS-------------------------
-SSSS------SS---S-------------------SS---S----SS-------SS---SS---S-----SS---S----------SS---S----S--SS---S------------------------SS-------------------------
oSSSS--ooooSS---SoU-------------ooooSS---SoUooSS---ooooSSoooSS---SoUoooSS---SoU----ooooSS---SoU--SooSS---SoU-------------------oooSS-------------------------
SSSSS--SSSSSS---SSS-------TT----SSSSSS---SSSSSSS---SSSSSSSSSSS---SSSSSSSS---SSSS---SSSSSS---SSS--SSSSS---SSS--T##--------------SSSSS----##-------------##----
---------------------T----TT----------------------------------------------------------------------------T-----###----------SS----------###------------###--SS
---------------------T----TT----------------------------------------------------------------------------------###---TT-----SS---------####-----------####--SF
---M---------g-------T----TT-----------kk----------------k--------------ggg-----------------------------------###---TT-----SS--------#####----------r####--S#
XXXXXXXXXXXXXXXXXXXXXXXXXXXXXXXXXXXXXXXXXXXXXXXXXXXXXXXXXXXXXXXXXXXXXXXXXXXXXXXX---XXXXXXXXXXXXXXXXXXXXXXXXXXXXXX-XXXXXXX--XX--XXXXXXXXXXX---XXXXXXXXXXXX--XX
XXXXXXXXXXXXXXXXXXXXXXXXXXXXXXXXXXXXXXXXXXXXXXXXXXXXXXXXXXXXXXXXXXXXXXXXXXXXXXXX---XXXXXXXXXXXXXXXXXXXXXXXXXXXXXX-XXXXXXX--XX--XXXXXXXXXXX---XXXXXXXXXXXX--XX
