-------------------------------------------------------------------------------------------------------------------------------------------------------------
-------------------------------------------------------------------------------------------------------------------------------------------------------------
-------------------------------------------------------------------------------------------------------------------------------------------------------------
SSSSSSSSSSSSSSSSSSSSSSSSSSSSSSSSSSSSSSSSSSSSSSSSSSSSSSSSSSSSSSSSSSSSSSSSSSSSSSSS--SSSSSSSSSSSSSSSSSSSSSSSSSSSSSSSSSSSSSSSSSSSSSSSSSSSLSSSS-----SSSSSSSSSS-SSS
SSSS--SSSSSS--SSSS--------------SSSSSS--SSSSSSSS---SSSSSSSSSSSS--SSSSSSSS-SSSS----SS----SSSSS--SSSS------------------SSS--SS---------------------------------
SSSS--SSSSSS--SSSS--------------SSSSSS--SSSSSSSS---SSSSSSSSSSSS--SSSSSSSS-SSSS----SS----SSSSS--SSSS------------------SSS--SS---------------------------------
--SS------SS---S--------------------SS---S--SSSS-------SS----SS---S----SS---SS--------SS---SS---S---------------------SS---S----oooooo------SSS--------------
--SS------SS---S--------------------SS---S--SSSS-------SS----SS---S----SS---SS--------SS---SS---S---------------------SS---S---------------------------------
--SS------SS---S--------------------SS---S--SSSS-------SS----SS---S----SS---SS--------SS---SS---S---------------------SS---S----SSSSSS-----------------------
ooSS--ooooSS---SoU--------------ooooSS---SooSSSS---ooooSSooooSS---SoUooSS-ooSS----oU--SCoooSS---SoU------------------oSS---S----SSSSSS-----------------------
SSSS--SSSSSS---SSS--------TT----SSSSSS---SSSSSSS---SSSSSSSSSSSS---SSSSSSS-SSSS----SS--SSSSSSS---SSS-----------TT-----SSS---S------------##-------------TT----
--------------------TT----TT----------------------------------------------------------------------------TT----TT-----------------------###-------TT----TT----
--------------------TT----TT----------------------------------------------------------------------------TT----TT----T------------------###--SSS--TT----TT--TF
---M---------g------TT----TT-----------kk----------------k--------------ggg-----------------------------TT----TT----T------------------###-------TT-r--TT--T#
XXXXXXXXXXXXXXXXXXXXXXXXXXXXXXXXXXXXXXXXXXXXXXXXXXXXXXXXXXXXXXXXXXXXXXXXXXXXXXXX--XXXXXXXXXXXXXXXXXXXXXXXXXXXXXXXXXXXXXXXXXX---XXXXXXXXXXX-----XXXXXXXXXX--XX
XXXXXXXXXXXXXXXXXXXXXXXXXXXXXXXXXXXXXXXXXXXXXXXXXXXXXXXXXXXXXXXXXXXXXXXXXXXXXXXX--XXXXXXXXXXXXXXXXXXXXXXXXXXXXXXXXXXXXXXXXXX---XXXXXXXXXXX-----XXXXXXXXXX--XX
