-------------------------------------------------------------------------------------------------------------------------------------------------------------
-------------------------------------------------------------------------------------------------------------------------------------------------------------
-------------------------------------------------------------------------------------------------------------------------------------------------------------
SSSSSSSSSSSSSSSSSSSSSSSSSSSSSSSSSSSSSSSSSSSSSSSSSSSSSSSSSSSSSSSSSSSSSSSSSSSSSSSS--SSSSSSSSSSSSSSSSSSSSSSSSSSSSSSSSSSSSSSSSSSSSSSSSSSSSSSSS------SSSSSSSSSSSSS
SSSS--SSSSSS--SSSS-S-----------------S--SSSSSSSS--SSSSSSS--SSSS--SSS--SSSS--------SSSSSS--SSSS------SSS--SS--------------------------------------------------
SSSS--SSSSSS--SSSS-S-----------------S--SSSSSSSS--SSSSSSS--SSSS--SSS--SSSS--------SSSSSS--SSSS------SSS--SS--------------------------------------------------
--SS------SS---S---------------------S---S----SS---S---SS---SSS---SS---S----SS--------SS---S----SS---SS---S---------------------------------SSS--------------
--SS------SS---S---------------------S---S----SS---S---SS---SSS---SS---S----SS--------SS---S----SS---SS---S--------------------------------------------------
--SS------SS---S---------------------S---S----SS---S---SS---SSS---SS---S----SS--------SS---S----SS---SS---S--------------------------------------------------
ooSS--ooooSS---SoU-------------------S---SooooSS---SoooSS---SSS---SS---SoU--SC-----oooSS---SoU--SC--oSS---S----------------------------------------------C---
SSSS--SSSSSS---SSS--------TT---------S---SSSSSSS---SSSSSS---SSS---SS---SSS--SS----SSSSSS---SSS--SS--SSS---S---TT------------------------##---------#-#-------
--------------------TT----TT----------------------------------------------------------------------------T-----TT-----------SS----------###-------#-#-#-#---#-
--------------------TT----TT----TT----------------------------------------------------------------------------TT----TT-----SS---------####--SSS--#-#-#-#---#F
---M---------g------TT----TT----TT-----kk----------------k--------------ggg-----------------------------------TT----TT-----SS--------#####-------#-#r#-#-E-##
XXXXXXXXXXXXXXXXXXXXXXXXXXXXXXXXXXXXXXXXXXXXXXXXXXXXXXXXXXXXXXXXXXXXXXXXXXXXXXXX--XXXXXXXXXXXXXXXXXXXXXXXXXXXXXXXXXXXXXXX--XX--XXXXXXXXXXX------XXXXXXXXXXXXX
XXXXXXXXXXXXXXXXXXXXXXXXXXXXXXXXXXXXXXXXXXXXXXXXXXXXXXXXXXXXXXXXXXXXXXXXXXXXXXXX--XXXXXXXXXXXXXXXXXXXXXXXXXXXXXXXXXXXXXXX--XX--XXXXXXXXXXX------XXXXXXXXXXXXX
