-------------------------------------------------------------------------------------------------------------------------------------------------------------
-------------------------------------------------------------------------------------------------------------------------------------------------------------
-------------------------------------------------------------------------------------------------------------------------------------------------------------
SSSSSSSSSSSSSSSSSSSSSSSSSSSSSSSSSSSSSSSSSSSSSSSSSSSSSSSSSSSSSSSSSSSSSSSSSSSSSSSS--SSSSSSSSSSSSSSSSSSSSSSSSSSSSSSSSSSSSSSSSSSSSSSSSSSSSSSSS--SSSSSSSSSSSSS-SSS
SSSS--SSSSSS--SSSS-S------------SS--SSSSSSSSSSS----SSSSSS--SSSS--SSSS------SSSSS---SSSSSSSSSSS--SS------------------SSSS--SSSS-SSSSSS--S---------------------
SSSS--SSSSSS--SSSS-S------------SS--SSSSSSSSSSS----SSSSSS--SSSS--SSSS------SSSSS---SSSSSSSSSSS--SS------------------SSSS--SSSS-SSSSSS--S---------------------
-SS-------SS---S--------------SS--------S----SS--------SS---SSS---S----SS-----SS-------SSSS-SS---S--------------------SS---S-------SS------------------------
-SS-------SS---S--------------SS--------S----SS--------SS---SSS---S----SS-----SS-------SSSS-SS---S--------------------SS---S-------SS------------------------
-SS-------SS---S--------------SS--------S----SS--------SS---SSS---S----SS-----SS-------SSSS-SS---S--------------------SS---S-------SS------------------------
oSS---ooooSS---SoU------------SS----ooooSooooSS----ooooSS---SSS---SoU--SC-----SS---ooooSSSSoSS---S------------------ooSS---SoU-ooooSS------------------------
SSSS--SSSSSS---SSS-------##---SSSS--SSSSSSSSSSS----SSSSSS---SSS---SSS--SS--SSSSS---SSSSSSSSSSS---S------------TT----SSSS---SSS-SSSSSS---##-------------##----
---S--------------------###-----SS----------------------------------------------------------------------TT----TT------------------------##------------###--SS
---S-------------------####-----SS----------------------------------------------------------------------TT----TT------------------------##-----------####--SF
---M---------g--------#####------------kk----------------k--------------ggg-----------------------------TT----TT----T-------------------##----------r####--S#
XXXXXXXXXXXXXXXXXXXXXXXXXXXXXXXXXXXXXXXXXXXXXXXXXXXXXXXXXXXXXXXXXXXXXXXXXXXXXXXX--XXXXXXXXXXXXXXXXXXXXXXXXXXXXXXXXXXXXXXXXXXXXXXXXXXXXXXXX---XXXXXXXXXXXX--XX
XXXXXXXXXXXXXXXXXXXXXXXXXXXXXXXXXXXXXXXXXXXXXXXXXXXXXXXXXXXXXXXXXXXXXXXXXXXXXXXX--XXXXXXXXXXXXXXXXXXXXXXXXXXXXXXXXXXXXXXXXXXXXXXXXXXXXXXXX---XXXXXXXXXXXX--XX
