-------------------------------------------------------------------------------------------------------------------------------------------------------------
-------------------------------------------------------------------------------------------------------------------------------------------------------------
-------------------------------------------------------------------------------------------------------------------------------------------------------------
SSSSSSSSSSSSSSSSSSSSSSSSSSSS-SSSSSSSSSSSSSSSSSSSSSSSSSSSSSSSSSSSSSSSSSSSSSSSSSSS--SSSSSSSSSSSSSSSSSSSSSSSSSSSSSSSSSSSSSSSSSSSSSSSSSSSSSSSSSSSSSSSSSSSSSSSSSSS
-SS--SSSSSS--SSSSS--SSS------------SS---SSSSSS--SSSS---SS--SSSS--SSSS------SSSS---SSS----SSSS--SSSS-----SS--S------SSSS-------SS------SSSS-------------------
-SS--SSSSSS--SSSSS--SSS------------SS---SSSSSS--SSSS---SS--SSSS--SSSS------SSSS---SSS----SSSS--SSSS-----SS--S------SSSS-------SS------SSSS-------------------
S--------SS---S-SS---S-------------SS-------SS---S----SSS---SSS---S----SS----SS---S----SS--SS---S----SS---------S-----------------SS-------------------------
S--------SS---S-SS---S-------------SS-------SS---S----SSS---SSS---S----SS----SS---S----SS--SS---S----SS---------S-----------------SS-------------------------
S--------SS---S-SS---S-------------SS-------SS---S----SSS---SSS---S----SS----SS---S----SS--SS---S----SS---------S-----------------SS-------------------------
S----ooooSS---SoSS---So------------SS---ooooSS---SoU--SSS---SSS---SoU--SC---oSS---SoU--SCooSS---SoU--SC---------C-------------oU--SC---------------------C---
SSS--SSSSSS---SSSS---SS---##-----##SS---SSSSSS---SSS--SSS---SSS---SSS--SS--SSSS---SSS--SSSSSS---SSS--SS-SS----TTS--SSSS-------SS--SS--SSSS---------#-#-------
-SS----------------------###----###---------------------------------------------------------------------TS----TT-----------S---------------------#-#-#-#---#-
-SS---------------------####---####---------------------------------------------------------------------SS----TT-----------S---------------------#-#-#-#---#F
---M---------g---------#####--#####----kk----------------k--------------ggg-----------------------------------TT----T------S---------------------#-#r#-#-E-##
XXXXXXXXXXXXXXXXXXXXXXXXXXXX-XXXXXXXXXXXXXXXXXXXXXXXXXXXXXXXXXXXXXXXXXXXXXXXXXXX--XXXXXXXXXXXXXXXXXXXXXXXXXXXXXXXXXXXXX---XX--XXXXXXXXXXXX------XXXXXXXXXXXXX
XXXXXXXXXXXXXXXXXXXXXXXXXXXX-XXXXXXXXXXXXXXXXXXXXXXXXXXXXXXXXXXXXXXXXXXXXXXXXXXX--XXXXXXXXXXXXXXXXXXXXXXXXXXXXXXXXXXXXX---XX--XXXXXXXXXXXX------XXXXXXXXXXXXX
