-------------------------------------------------------------------------------------------------------------------------------------------------------------
-------------------------------------------------------------------------------------------------------------------------------------------------------------
-------------------------------------------------------------------------------------------------------------------------------------------------------------
SSSSSSSSSSSSSSSSSSSSSSSSSSSS---SSSSSSSSSSSSSSSSSSSSSSSSSSSSSSSSSSSSSSSSSSSSSSSSS--SSSSSSSSLSSSSSSSSSSSSSSSSSSSSSS-SSSSSSSSSSSSSSSSSSSLSSSS-------------------
SSSSS-SSSSSS--SSSS---------------S--SSSSSS--SSSS--SSSSSSSS-SSSSSSSS--SSSS--SSSS-------------SS--SS--------------S---SSSS--SS---------------------------------
SSSSS-SSSSSS--SSSS---------------S--SSSSSS--SSSS--SSSSSSSS-SSSSSSSS--SSSS--SSSS-------------SS--SS--------------S---SSSS--SS---------------------------------
---SS-----SS---S--------------S---------SS---S----SS--SSSS--SS---SS---SSS---S--------oooooo-SS---S--------------S----S----------oooooo------SSS--------------
---SS-----SS---S------------------------SS---S----SS--SSSS--SS---SS---SSS---S---------------SS---S--------------S----S---------------------------------------
---SS-----SS---S------------------------SS---S----SS--SSSS--SS---SS---SSS---S--------SSSSSS-SS---S--------------S----S----------SSSSSS-----------------------
oooSS-ooooSS---SoU------------------ooooSS---SoU--SSooSSSS-oSSoooSS---SSS---SoU------SSSSSS-SS---S--------------S----SoU--------SSSSSS-----------SSSSSSU-----
SSSSS-SSSSSS---SSS--------##-----S--SSSSSS---SSS--SSSSSSSS-SSSSSSSS---SSS---SSS-------------SS---S------------TTS----SSS--SS------------##-------------------
--------------------TT---###----#S----------------------------------------------------------------------TT----TTS----------------------###-------------------
--------------------TT--####--S##S----------------------------------------------------------------------TT----TTS---------------------####--SSS-------------F
---M---------g------TT-#####---##------kk----------------k--------------ggg-----------------------------TT----TTS---T-----------------####----------r-------#
XXXXXXXXXXXXXXXXXXXXXXXXXXXX---XXXXXXXXXXXXXXXXXXXXXXXXXXXXXXXXXXXXXXXXXXXXXXXXX----XXXXXXXXXXXXXXXXXXXXXXXXXXXXXXXXXXXX--XX---XXXXXXXXXXX-------XXXXXXXX--X-
XXXXXXXXXXXXXXXXXXXXXXXXXXXX---XXXXXXXXXXXXXXXXXXXXXXXXXXXXXXXXXXXXXXXXXXXXXXXXX----XXXXXXXXXXXXXXXXXXXXXXXXXXXXXXXXXXXX--XX---XXXXXXXXXXX-------XXXXXXXX--XX
