-------------------------------------------------------------------------------------------------------------------------------------------------------------
-------------------------------------------------------------------------------------------------------------------------------------------------------------
-------------------------------------------------------------------------------------------------------------------------------------------------------------
SSSSSSSSSSSSSSSSSSSSSSSSSSSSSSSSSSSSSSSSSSSSSSSSSSSSSSSSSSSSSSSSSSSSSSSSSSSSSSSS--SSSSSSSSSSSSSSSSSSSSSSSSSSSSSSSSSSSSSSSSSSSSSSSSSSSSSSSSSSSSSSSSSSSSSSS----
SSSS--SSSS-S--SSSS------SSS-------SSS--SSSS-----S--SSSSSS--SSSS--SSSS-SSSS-SSSSS-------SSSSSSSSSSS--SSS------------------SSS---SSSSSS--SSSS------------------
SSSS--SSSS-S--SSSS------SSS-------SSS--SSSS-----S--SSSSSS--SSSS--SSSS-SSSS-SSSSS-------SSSSSSSSSSS--SSS------------------SSS---SSSSSS--SSSS------------------
--SS---S---S---S----SS-------------SS---S----SS--------SS---S-S---S-----SS--SS------ooo----SS---SS---S-----------------------------SS----------------------SS
--SS---S---S---S----SS-------------SS---S----SS--------SS---S-S---S-----SS--SS-------------SS---SS---S-----------------------------SS------------------------
--SS---S---S---S----SS-------------SS---S----SS--------SS---S-S---S-----SS--SS------SSS----SS---SS---S-----------------------------SS------------------------
ooSS---SoU-S---SoU--SC------------oSS---SoU--SC----ooooSS---SoS---SoU-ooSS-oSS------SSSooooSSoooSS---So------------------------ooooSS------------------------
SSSS---SSS-S---SSS--SS--SSS-----TTSSS---SSS--SS-S--SSSSSS---SSS---SSS-SSSS-SSSSS-------SSSSSSSSSSS---SS-------TT---------SSS---SSSSSS---SSS---------##-##----
---------------------------T----TT--------------S-------------------------------------------------------TT----TT-----------------------------------######----
---------------------------T----TT--------------S-------------------------------------------------------TT----TT----TT----------------------------#######--SF
---M---------g-------------T----TT-----kk----------------k--------------ggg-----------------------------TT----TT----TT---------------------------###r####---#
XXXXXXXXXXXXXXXXXXXXXXXXXXXXXXXXXXXXXXXXXXXXXXXXXXXXXXXXXXXXXXXXXXXXXXXXXXXXXXXX---XXXXXXXXXXXXXXXXXXXXXXXXXXXXXXXXXXXXXXXXX-XXXXXXXXXXXXXX---XXXXXXXXXXX----
XXXXXXXXXXXXXXXXXXXXXXXXXXXXXXXXXXXXXXXXXXXXXXXXXXXXXXXXXXXXXXXXXXXXXXXXXXXXXXXX---XXXXXXXXXXXXXXXXXXXXXXXXXXXXXXXXXXXXXXXXX-XXXXXXXXXXXXXX---XXXXXXXXXXX----
