-------------------------------------------------------------------------------------------------------------------------------------------------------------
-------------------------------------------------------------------------------------------------------------------------------------------------------------
-------------------------------------------------------------------------------------------------------------------------------------------------------------
SSSSSSSSSSSSSSSSSSSSSSSSSSSSSSSSSSSSSSSSSSSSSSSSSSSSSSSSSSSSSSSSSSSSSSSSSSSSSSSS--SSSSSSSLSSSSSSSSSSSSSSSSSSSSSSSSSSSSSSSSSSSSSSSSSSSSSSSSSSSSSSSSSSSSSSS-SSS
--SS--SSSSSS--SS------------------SSS--SSSSSSS--SSSSSSSS-SSSSSS--SSSS----SSSSSSS-----------SSSSSS--SSSS-------------------SS----------SSSS-------------------
--SS--SSSSSS--SS------------------SSS--SSSSSSS--SSSSSSSS-SSSSSS--SSSS----SSSSSSS-----------SSSSSS--SSSS-------------------SS----------SSSS-------------------
SS--------SS---S-------------------SS---S---SS---S----SS-----SS---S----SS--SS-------oooooo-----SS---S---------------------------oooS-------------------------
SS--------SS---S-------------------SS---S---SS---S----SS-----SS---S----SS--SS------------------SS---S------------------------------S-------------------------
SS--------SS---S-------------------SS---S---SS---S----SS-----SS---S----SS--SS-------SSSSSS-----SS---S---------------------------SSSS-------------------------
SS----ooooSS---S------------------oSS---SoooSS---SooooSS-ooooSS---SoU--SCooSS-------SSSSSS-ooooSS---SoU-------------------------SSSC-------------------------
SSSS--SSSSSS---S--------##TT------SSS---SSSSSS---SSSSSSS-SSSSSS---SSS--SSSSSSSSS-----------SSSSSS---SSS-------TT----------SS-------S--SSSS-------------##----
--SS-------------------###TT----------------------------------------------------------------------------TT----TT--------------------------------------###--SS
--SS------------------####TT----TT----------------------------------------------------------------------TT----TT----TT-------------------------------####--SF
---M---------g-------#####TT----TT-----kk----------------k--------------ggg-----------------------------TT----TT----TT------------------------------r####--S#
XXXXXXXXXXXXXXXXXXXXXXXXXXXXXXXXXXXXXXXXXXXXXXXXXXXXXXXXXXXXXXXXXXXXXXXXXXXXXXXX---XXXXXXXXXXXXXXXXXXXXXXXXXXXXXXXXXXXX---XX---XXXXXXXXXXX---XXXXXXXXXXXX--XX
XXXXXXXXXXXXXXXXXXXXXXXXXXXXXXXXXXXXXXXXXXXXXXXXXXXXXXXXXXXXXXXXXXXXXXXXXXXXXXXX---XXXXXXXXXXXXXXXXXXXXXXXXXXXXXXXXXXXX---XX---XXXXXXXXXXX---XXXXXXXXXXXX--XX
