-------------------------------------------------------------------------------------------------------------------------------------------------------------
-------------------------------------------------------------------------------------------------------------------------------------------------------------
-------------------------------------------------------------------------------------------------------------------------------------------------------------
SSSSSSSSSSSSSSSSSSSSSSSSSSSSSSSSSSSSSSSSSSSSSSSSSSSSSSSSSSSSSSSSSSSSSSSSSSSSSSSS--SSSSSSSSSSSSSSSSSSSSSSSSSSSSSSSSSSSSSSSSSSSSSSSSSSSSSSSS---------SSSSSS----
SSSS--SSSSSS--SSSS------S------------SS--SSSSSS--SSSSSSSSS--SSSS-----SSSS--SS--S---SSSSSS--SSSSSS--S-----------------------------SS--------------------------
SSSS--SSSSSS--SSSS------S------------SS--SSSSSS--SSSSSSSSS--SSSS-----SSSS--SS--S---SSSSSS--SSSSSS--S-----------------------------SS--------------------------
--SS---S--SS---S----SS-------------SS--------SS---SSS---SS---S----SS---SS---SSS--------SS---S--SS--------------------------------SS---------SSS------------SS
--SS---S--SS---S----SS-------------SS--------SS---SSS---SS---S----SS---SS---SSS--------SS---S--SS--------------------------------SS--------------------------
--SS---S--SS---S----SS-------------SS--------SS---SSS---SS---S----SS---SS---SSS--------SS---S--SS--------------------------------SS--------------------------
ooSS---SooSS---SoU--SC-------------SS----ooooSS---SSSoooSS---SoU--SC-ooSS---SSS----ooooSS---SooSS--------------------------------SS--------------SS----------
SSSS---SSSSS---SSS--SS--S#TT-----##SSSS--SSSSSS---SSSSSSSS---SSS--SS-SSSS---SSSS---SSSSSS---SSSSS-------------TT-----------------SS-----##-------------##----
-------------------------#TT----###--SS----------------------------------------S------------------------TT----TT-----------SS----------###------------###----
-------------------------#TT---####--SS----------------------------------------S------------------------TT----TT----TT-----SS---------####--SSS------####--SF
---M---------g-----------#TT--#####----kk----------------k--------------ggg-----------------------------TT----TT----TT-----SS--------#####----------r####---#
XXXXXXXXXXXXXXXXXXXXXXXXXXXXXXXXXXXXXXXXXXXXXXXXXXXXXXXXXXXXXXXXXXXXXXXXXXXXXXXX--XXXXXXXXXXXXXXXXXXXXXXXXXXXXXXXXXXXXXXX--XX--XXXXXXXXXXX-------XXXXXXXX----
XXXXXXXXXXXXXXXXXXXXXXXXXXXXXXXXXXXXXXXXXXXXXXXXXXXXXXXXXXXXXXXXXXXXXXXXXXXXXXXX--XXXXXXXXXXXXXXXXXXXXXXXXXXXXXXXXXXXXXXX--XX--XXXXXXXXXXX-------XXXXXXXX----
