-------------------------------------------------------------------------------------------------------------------------------------------------------------
-------------------------------------------------------------------------------------------------------------------------------------------------------------
-------------------------------------------------------------------------------------------------------------------------------------------------------------
SSSSSSSSSSSSSSSSSSSSSSSSSSSSSSSSSSSSSSSSSSSSSSSSSSSSSSSSSSSSSSSSSSSSSSSSSSSSSSSS--SSSSSSSSSSSSSSSSSSSSSSSSSSSSSSSSSSSSSSSSSSSSSSSSSSSSSSSS------------SSS----
SSSS--SSSS---SSSSS--SS----------SS--SSSSSS--SS-SS--SSSSSS--SSSSSSSS--SSSS----SSS------SSSSSSS--SSSS-----------------SSSS--SSSS----SS--S----------------------
SSSS--SSSS---SSSSS--SS----------SS--SSSSSS--SS-SS--SSSSSS--SSSSSSSS--SSSS----SSS------SSSSSSS--SSSS-----------------SSSS--SSSS----SS--S----------------------
SSSS---S----S---SS---S------------------SS---SS--------SS---S----SS---S----SS--------o-SS--SS---S----SS---------------SS---S----SSSS--------SSS------------SS
SSSS---S----S---SS---S------------------SS---SS--------SS---S----SS---S----SS----------SS--SS---S----SS---------------SS---S----SSSS-------------------------
SSSS---S----S---SS---S------------------SS---SS--------SS---S----SS---S----SS--------S-SS--SS---S----SS---------------SS---S----SSSS-------------------------
SSSS---SoU--SoooSS---S--------------ooooSS---SS----ooooSS---SooooSS---SoU--SC--------SoSSooSS---SoU--SC-------------ooSS---SoU--SCSS-------------SSSSS-------
SSSS---SSS--SSSSSS---S---#-#----SS--SSSSSS---SSSS--SSSSSS---SSSSSSS---SSS--SSSSS------SSSSSSS---SSS--SS-------TT----SSSS---SSS--SSSS----##-------------##----
-----------------------#-#-#----SS-------------SS-------------------------------------------------------TT----TT-----------------------###------------###----
-----------------------#-#-#---TSS-------------SS-------------------------------------------------------TT----TT-----------------------###--SSS-------###--SF
---M---------g---------#-#-#---T-------kk----------------k--------------ggg-----------------------------TT----TT----T------------------###----------r-###---#
XXXXXXXXXXXXXXXXXXXXXXXXXXXXXXXXXXXXXXXXXXXXXXXXXXXXXXXXXXXXXXXXXXXXXXXXXXXXXXXX----XXXXXXXXXXXXXXXXXXXXXXXXXXXXXXXXXXXXXXXXXXXXXXXXXXXXXX-------XXXXXXXX----
XXXXXXXXXXXXXXXXXXXXXXXXXXXXXXXXXXXXXXXXXXXXXXXXXXXXXXXXXXXXXXXXXXXXXXXXXXXXXXXX----XXXXXXXXXXXXXXXXXXXXXXXXXXXXXXXXXXXXXXXXXXXXXXXXXXXXXX-------XXXXXXXX----
