-------------------------------------------------------------------------------------------------------------------------------------------------------------
-------------------------------------------------------------------------------------------------------------------------------------------------------------
-------------------------------------------------------------------------------------------------------------------------------------------------------------
SSSSSSSSSSSSSSSSSSSSSSSSSSSSSSSSSSSSSSSSSSSSSSSSSSSSSSSSSSSSSSSSSSSSSSSSSSSSSSSS--SSSSSSSSSSSSSSSSSSSSSSSSSSSSSSSSSSSSSSSSSSSSSSSSSSSLSSSSSSS----------------
SSSSSSSSSSSSS--SSSS-------------SS--SSSSSS--SSSS--SSSSSSS--SSSS---SSSSSSS--SSSSS---SSSSSS--SSSS--SS--SSSS---------------SSSS-----------SSS-------------------
SSSSSSSSSSSSS--SSSS-------------SS--SSSSSS--SSSS--SSSSSSS--SSSS---SSSSSSS--SSSSS---SSSSSS--SSSS--SS--SSSS---------------SSSS-----------SSS-------------------
--SS-SS----SS---S----S------------------SS---SSS---S---SS---S----S-SS--SS---S-SS-------SS---S----SS---S---------------SS--------oooooo-------SS--------------
--SS-SS----SS---S----S------------------SS---SSS---S---SS---S----S-SS--SS---S-SS-------SS---S----SS---S---------------SS-------------------------------------
--SS-SS----SS---S----S------------------SS---SSS---S---SS---S----S-SS--SS---S-SS-------SS---S----SS---S---------U-----SS--------SSSSSS-----------------------
ooSSoSSooooSS---SoU--S--------------ooooSS---SSS---SoooSS---SoU--SoSSooSS---SoSS---ooooSS---SoU--SS---SoU------oS-----SS--------SSSSSS-----------SSSSSSU-----
SSSSSSSSSSSSS---SSS--S----##----SS--SSSSSS---SSS---SSSSSS---SSS--SSSSSSSS---SSSS---SSSSSS---SSS--SS---SSS-----TSS-----SSSSSS-----------SSS-------------------
-------------------------###----SS----------------------------------------------------------------------T-----T---------S------------------------------------
------------------------####---TSS----------------------------------------------------------------------------T---------S--------------------SS-------------F
---M---------g---------#####---T-------kk----------------k--------------ggg-----------------------------------T-----T-------------------------------r-------#
XXXXXXXXXXXXXXXXXXXXXXXXXXXXXXXXXXXXXXXXXXXXXXXXXXXXXXXXXXXXXXXXXXXXXXXXXXXXXXXX--XXXXXXXXXXXXXXXXXXXXXXXXXXXXXXXXXXXXXXXXXX---XXXXXXXXXXX-------XXXXXXXX--X-
XXXXXXXXXXXXXXXXXXXXXXXXXXXXXXXXXXXXXXXXXXXXXXXXXXXXXXXXXXXXXXXXXXXXXXXXXXXXXXXX--XXXXXXXXXXXXXXXXXXXXXXXXXXXXXXXXXXXXXXXXXX---XXXXXXXXXXX-------XXXXXXXX--XX
