-------------------------------------------------------------------------------------------------------------------------------------------------------------
-------------------------------------------------------------------------------------------------------------------------------------------------------------
-------------------------------------------------------------------------------------------------------------------------------------------------------------
SSSSSSSSSSSSSSSSSSSSSSSSSSSSSSSSSSSSSSSSSSSSSSSSSSSSSSSSSSSSSSSSSSSSSSSSSSSSSSSS--SSSSSSSSSSSSSSSSSSSSSSSSSSSSSSSSSSSSSSSSSSSSSSSSSSSSSSSSSSSSSSSSSSSSSSS----
SSSS--SSSS---SSSSS--SSS------------------SSSSSSSSS--SSSS---SSSS--SSSSSSSS--SSSSS---SSSSSS--SSSS-SS------------------SSSSSS--S--SSSSSS--SSS-------------------
SSSS--SSSS---SSSSS--SSS------------------SSSSSSSSS--SSSS---SSSS--SSSSSSSS--SSSSS---SSSSSS--SSSS-SS------------------SSSSSS--S--SSSSSS--SSS-------------------
--SS---S----S---SS---S-----------------------SS-SS---S----S--SS---S----SS---S----------SS---S---SS----------------------SS---------SS---S------------------SS
--SS---S----S---SS---S-----------------------SS-SS---S----S--SS---S----SS---S----------SS---S---SS----------------------SS---------SS---S--------------------
--SS---S----S---SS---S-----------------------SS-SS---S----S--SS---S----SS---S----------SS---S---SS----------------------SS---------SS---S--------------------
ooSS---SoU--SoooSS---So-------C----------ooooSSoSS---SoU--SooSS---SooooSS---SoU----ooooSS---SoU-SS------------------ooooSS-----ooooSS---So-------------------
SSSS---SSS--SSSSSS---SS-#-#--------------SSSSSSSSS---SSS--SSSSS---SSSSSSS---SSSS---SSSSSS---SSS-SS------------TT----SSSSSS-----SSSSSS---SS---------##--##----
------------------------#-#-#---#----------------------------------------------S------------------------TT----TT----------------------------------###-###----
------------------------#-#-#---#-#--------------------------------------------S------------------------TT----TT---------------------------------########--SF
---M---------g----------#-#-#-E-#-#----kk----------------k--------------ggg-----------------------------TT----TT----T---------------------------####r####---#
XXXXXXXXXXXXXXXXXXXXXXXXXXXXXXXXXXXXXXXXXXXXXXXXXXXXXXXXXXXXXXXXXXXXXXXXXXXXXXXX--XXXXXXXXXXXXXXXXXXXXXXXXXXXXXXXXXXXXXXXXXXXXXXXXXXXXXXXXXXXXXXXXXXXXXXX----
XXXXXXXXXXXXXXXXXXXXXXXXXXXXXXXXXXXXXXXXXXXXXXXXXXXXXXXXXXXXXXXXXXXXXXXXXXXXXXXX--XXXXXXXXXXXXXXXXXXXXXXXXXXXXXXXXXXXXXXXXXXXXXXXXXXXXXXXXXXXXXXXXXXXXXXX----
