-------------------------------------------------------------------------------------------------------------------------------------------------------------
-------------------------------------------------------------------------------------------------------------------------------------------------------------
-------------------------------------------------------------------------------------------------------------------------------------------------------------
SSSSSSSSSSSSSSSSSSSSSSSSSSSSSSSSSSSSSSSSSSSSSSSSSSSSSSSSSSSSSSSSSSSSSSSSSSSSSSSS--SSSSSSSSSSSSSSSSSSSSSSSSSSSSSSSSSSSSSSSSSSSSSSSSSSSSSSSSSSSSS--------------
SSSS--SSSS-----------------------SSSSSS--SSSSSSSSS--SSSS-SSSSS--SSSS----S--SSSS----SSSSSSSSSS--SSSS------SS-------------SSSS-----------SSSS------------------
SSSS--SSSS-----------------------SSSSSS--SSSSSSSSS--SSSS-SSSSS--SSSS----S--SSSS----SSSSSSSSSS--SSSS------SS-------------SSSS-----------SSSS------------------
--SS---S----S-----------------o------SS---S-----SS---S------SS---S----SSS---SSS--------SSSSSS---S----SS-------------------------oooSS------------------------
--SS---S----S------------------------SS---S-----SS---S------SS---S----SSS---SSS--------SSSSSS---S----SS----------------------------SS------------------------
--SS---S----S-----------------S------SS---S-----SS---S------SS---S----SSS---SSS--------SSSSSS---S----SS-------------------------SSSSS------------------------
ooSS---SoU--S--------------------ooooSS---SoUoooSS---SoU-oooSS---SoU--SCS---SSS----ooooSSSSSS---SoU--SC-------------------------SSSSC------------SSSSSSU-----
SSSS---SSS--S-------------TT-----SSSSSS---SSSSSSSS---SSS-SSSSS---SSS--SSS---SSS----SSSSSSSSSS---SSS--SS--SS---TT--------SSSS-------SS--SSSS------------------
--------------------TT----TT----------------------------------------------------------------------------T-----TT---------------------------------------------
--------------------TT----TT----------------------------------------------------------------------------------TT----TT--------------------------------------F
---M---------g------TT----TT-----------kk----------------k--------------ggg-----------------------------------TT----TT------------------------------r-------#
XXXXXXXXXXXXXXXXXXXXXXXXXXXXXXXXXXXXXXXXXXXXXXXXXXXXXXXXXXXXXXXXXXXXXXXXXXXXXXXX--XXXXXXXXXXXXXXXXXXXXXXXXXXXXXXXXXXXXXXXXXX---XXXXXXXXXXXX---X--XXXXXXXX--X-
XXXXXXXXXXXXXXXXXXXXXXXXXXXXXXXXXXXXXXXXXXXXXXXXXXXXXXXXXXXXXXXXXXXXXXXXXXXXXXXX--XXXXXXXXXXXXXXXXXXXXXXXXXXXXXXXXXXXXXXXXXX---XXXXXXXXXXXX---X--XXXXXXXX--XX
