-------------------------------------------------------------------------------------------------------------------------------------------------------------
-------------------------------------------------------------------------------------------------------------------------------------------------------------
-------------------------------------------------------------------------------------------------------------------------------------------------------------
SSSSSSSSSSSSSSSSSSSSSSSSSSSSSSSSSSSSSSSSSSSSSSSSSSSSSSSSSSSSSSSSSSSSSSSSSSSSSSSS--SSSSSSSSSSSSSSSSSSSSSSSSSSSSSSSSSSSSSSSSSSSSSSSSSSSSSSSSSSSSSSSSSSSSSSS---S
SSSS--SSSSSSSS--SSSS-------------------SS--SSSS-S--SSSSSS--SSSS--SSSSSSSS--SSSS----SSSSSS--SSSSSSS--SSSS-------------------S---------------------------------
SSSS--SSSSSSSS--SSSS-------------------SS--SSSS-S--SSSSSS--SSSS--SSSSSSSS--SSSS----SSSSSS--SSSSSSS--SSSS-------------------S---------------------------------
--SS---S----SS---S---------------------SS---S----------SS---S-------SS-SS---S----------SS---S---SS---S--------------------------oooo-----------------------S-
--SS---S----SS---S---------------------SS---S----------SS---S-------SS-SS---S----------SS---S---SS---S-------------------------------------------------------
--SS---S----SS---S---------------------SS---S----------SS---S-------SS-SS---S----------SS---S---SS---S--------------------------SSSS-------------------------
ooSS---SooooSS---SoU----------C--------SS---SoU----ooooSS---SoU--oooSSoSS---SoU----ooooSS---SoooSS---SoU------------------------SSSS-------------------------
SSSS---SSSSSSS---SSS----#-#------------SS---SSS-S--SSSSSS---SSS--SSSSSSSS---SSS----SSSSSS---SSSSSS---SSS------TT-----------S------------##---------##--##----
----------------------#-#-#-#---#---------------S-------------------------------------------------------TT----TT-----------------------###--------###-###----
----------------------#-#-#-#---#-#-------------S--------------------------------------------------------T----TT----TT----------------####-------########--SF
---M---------g--------#-#-#-#-E-#-#----kk----------------k--------------ggg------------------------------T----TT----TT---------------#####------####r####---#
XXXXXXXXXXXXXXXXXXXXXXXXXXXXXXXXXXXXXXXXXXXXXXXXXXXXXXXXXXXXXXXXXXXXXXXXXXXXXXXX--XXXXXXXXXXXXXXXXXXXXXXXXXXXXXXXXXXXXXXX--X---XXXXXXXXXXXXXXXXXXXXXXXXXX---X
XXXXXXXXXXXXXXXXXXXXXXXXXXXXXXXXXXXXXXXXXXXXXXXXXXXXXXXXXXXXXXXXXXXXXXXXXXXXXXXX--XXXXXXXXXXXXXXXXXXXXXXXXXXXXXXXXXXXXXXX--X---XXXXXXXXXXXXXXXXXXXXXXXXXX---X
