-------------------------------------------------------------------------------------------------------------------------------------------------------------
-------------------------------------------------------------------------------------------------------------------------------------------------------------
-------------------------------------------------------------------------------------------------------------------------------------------------------------
SSSSSSSSSSSSSSSSSSSSSSSSSSSSSSSSSSSSSSSSSSSSSSSSSSSSSSSSSSSSSSSSSSSSSSSSSSSSSSSS--SSSSSSSSSSSSSSSSSSSSSSSSSSSSSSS-SSSSSSSSSSSSSSSSSSSSSSSSSSSSSSSSSSSSSSSSSS-
SSSSSSSSSSSS--SSSS------SS------SS--SSSSSS--SSSSS-SSSSSSSS--SSSS------SSSS-SSS-----SSSSSS--SSSS--------------------------SSSS------SS--SSSSSS----------------
SSSSSSSSSSSS--SSSS------SS------SS--SSSSSS--SSSSS-SSSSSSSS--SSSS------SSSS-SSS-----SSSSSS--SSSS--------------------------SSSS------SS--SSSSSS----------------
---SS---SSSS---S----SS--------SS--------SS---S-SS-----SSSS---S----SS----SS--SS---------SS---S------------------------SS----------ooSS---S--------------------
---SS---SSSS---S----SS--------SS--------SS---S-SS-----SSSS---S----SS----SS--SS---------SS---S------------------------SS------------SS---S--------------------
---SS---SSSS---S----SS--------SS--------SS---S-SS-----SSSS---S----SS----SS--SS---------SS---S------------------------SS----------SSSS---S--------------------
oooSSoooSSSS---SoU--SC--------SS----ooooSS---SoSS-ooooSSSS---SoU--SC--ooSS-oSS-----ooooSS---SoU----------------------SC----------SSSS---S----------------C---
SSSSSSSSSSSS---SSS--SS--SSTT--SSSS--SSSSSS---SSSS-SSSSSSSS---SSS--SS--SSSS-SSS-----SSSSSS---SSS---------------TT-----SS--SSSS------SS---SSSSS------#-#-------
--------------------------TT----SS----------------------------------------------------------------------TT----TT---------------------------------#-#-#-#---#-
--------------------------TT----SS----------------------------------------------------------------------TT----TT---------------------------------#-#-#-#---#F
---M---------g------------TT-----------kk----------------k--------------ggg-----------------------------TT----TT----T----------------------------#-#r#-#-E-##
XXXXXXXXXXXXXXXXXXXXXXXXXXXXXXXXXXXXXXXXXXXXXXXXXXXXXXXXXXXXXXXXXXXXXXXXXXXXXXXX--XXXXXXXXXXXXXXXXXXXXXXXXXXXXXXXXXXXXXXXXXXX---XXXXXXXXXXXXX---XXXXXXXXXXXX-
XXXXXXXXXXXXXXXXXXXXXXXXXXXXXXXXXXXXXXXXXXXXXXXXXXXXXXXXXXXXXXXXXXXXXXXXXXXXXXXX--XXXXXXXXXXXXXXXXXXXXXXXXXXXXXXXXXXXXXXXXXXX---XXXXXXXXXXXXX---XXXXXXXXXXXXX
