-------------------------------------------------------------------------------------------------------------------------------------------------------------
-------------------------------------------------------------------------------------------------------------------------------------------------------------
-------------------------------------------------------------------------------------------------------------------------------------------------------------
SSSSSSSSSSSSSSSSSSSSSSSSSSSSSSSSSSSSSSSSSSSSSSSSSSSSSSSSSSSSSSSSSSSSSSSSSSSSSSSS--SSSSSSSSSSSSSSSSSSSSSSSSSSSSSSSSSSSSSSSSSSSSSSSSSSSSSSSSSSSSSSSSSSSSSSS----
--SS--SSSSSS--SS----------------------SS--SSSSSS--SSSSSSS--SSSSSSSSS--SSSSSSS--S---SSSSSS--SSS-SSSS------SSSS------------SSSS--S------SSSS-------------------
--SS--SSSSSS--SS----------------------SS--SSSSSS--SSSSSSS--SSSSSSSSS--SSSSSSS--S---SSSSSS--SSS-SSSS------SSSS------------SSSS--S------SSSS-------------------
SS--------SS---S-----------------------S------SS---S---SS---S-----SS---S--SSSSS--------SS---S---S----SS--------------SS-----------SS-----------------------SS
SS--------SS---S-----------------------S------SS---S---SS---S-----SS---S--SSSSS--------SS---S---S----SS--------------SS-----------SS-------------------------
SS--------SS---S-----------------------S------SS---S---SS---S-----SS---S--SSSSS--------SS---S---S----SS--------------SS-----------SS-------------------------
SS----ooooSS---S-----------------------S--ooooSS---SoUoSS---SoooooSS---SooSSSSS----ooooSS---So--SoU--SC--------------SC--------U--SC-------------------------
SSSS--SSSSSS---S------##--------TT-----S--SSSSSS---SSSSSS---SSSSSSSS---SSSSSSSSS---SSSSSS---SS--SSS--SS--SSSS-TT-----SS--SSSS--S--SS--SSSS-------------##----
--SS-----------------###--TT----TT---------------------------------------------S------------------------T-----TT---------------------------------SS---###----
--SS----------------####--TT----TT---------------------------------------------S------------------------------TT---------------------------------SS--####--SF
---M---------g-----#####--TT----TT-----kk----------------k--------------ggg-----------------------------------TT----T----------------------------SS-r####---#
XXXXXXXXXXXXXXXXXXXXXXXXXXXXXXXXXXXXXXXXXXXXXXXXXXXXXXXXXXXXXXXXXXXXXXXXXXXXXXXX--XXXXXXXXXXXXXXXXXXXXXXXXXXX-XXXXXXXXXXXXXXX--XXXXXXXXXXX--XXX--XXXXXXXX----
XXXXXXXXXXXXXXXXXXXXXXXXXXXXXXXXXXXXXXXXXXXXXXXXXXXXXXXXXXXXXXXXXXXXXXXXXXXXXXXX--XXXXXXXXXXXXXXXXXXXXXXXXXXX-XXXXXXXXXXXXXXX--XXXXXXXXXXX--XXX--XXXXXXXX----
