-------------------------------------------------------------------------------------------------------------------------------------------------------------
-------------------------------------------------------------------------------------------------------------------------------------------------------------
-------------------------------------------------------------------------------------------------------------------------------------------------------------
SSSSSSSSSSSSSSSSSSSSSSSSSSSSSSSSSSSSSSSSSSSSSSSSSSSSSSSSSSSSSSSSSSSSSSSSSSSSSSSS--SSSSSSSSLSSSSSSSSSSSSSSSSSSSSSSSSSSSSSSSSSSSSSSSSSSSSSSS-------SSSSSSSSSSSS
SSSS--SSSSSS--SSSS--SSS-----------SSS--SSSS-----SS--SSSS--SSSSS-SSSS--SSSS------------------S--SSSS------SSSSS----SSSSSS--SSS--------------------------------
SSSS--SSSSSS--SSSS--SSS-----------SSS--SSSS-----SS--SSSS--SSSSS-SSSS--SSSS------------------S--SSSS------SSSSS----SSSSSS--SSS--------------------------------
--SS------SS----SS---S-------------SS---S----SS-SS---S----S--SS---SS---S----SS-------oooooo-S---S----SS---------------SS---S----------------SSS--------------
--SS------SS----SS---S-------------SS---S----SS-SS---S----S--SS---SS---S----SS--------------S---S----SS---------------SS---S---------------------------------
--SS------SS----SS---S-------------SS---S----SS-SS---S----S--SS---SS---S----SS-------SSSSSS-S---S----SS---------------SS---S---------------------------------
ooSS--ooooSS--ooSS---So-----------oSS---SoU--SC-SS---SoU--SooSS-ooSS---SoU--SC-------SSSSSS-S---SoU--SC-----------ooooSS---So----------------------------C---
SSSS--SSSSSS--SSSS---SS---TT------SSS---SSS--SS-SS---SSS--SSSSS-SSSS---SSS--SS--------------S---SSS--SS--SSSSST#--SSSSSS---SS-----------##---------#-#-------
--------------------------TT----------------------------------------------------------------------------T-----##---------------S-------###-------#-#-#-#---#-
--------------------------TT----TT----------------------------------------------------------------------------##---------------S------####--SSS--#-#-#-#---#F
---M---------g------------TT----TT-----kk----------------k--------------ggg-----------------------------------##----T----------S-----#####-------#-#r#-#-E-##
XXXXXXXXXXXXXXXXXXXXXXXXXXXXXXXXXXXXXXXXXXXXXXXXXXXXXXXXXXXXXXXXXXXXXXXXXXXXXXXX----XXXXXXXXXXXXXXXXXXXXXXXXXXXXXXXXXXXXXXXXX--XXXXXXXXXXX-------XXXXXXXXXXXX
XXXXXXXXXXXXXXXXXXXXXXXXXXXXXXXXXXXXXXXXXXXXXXXXXXXXXXXXXXXXXXXXXXXXXXXXXXXXXXXX----XXXXXXXXXXXXXXXXXXXXXXXXXXXXXXXXXXXXXXXXX--XXXXXXXXXXX-------XXXXXXXXXXXX
