-------------------------------------------------------------------------------------------------------------------------------------------------------------
-------------------------------------------------------------------------------------------------------------------------------------------------------------
-------------------------------------------------------------------------------------------------------------------------------------------------------------
SSSSSSSSSSSSSSSSSSSSSSSSSSSSSSSSSSSSSSSSSSSSSSSSSSSSSSSSSSSSSSSSSSSSSSSSSSSSSSSS--SSSSSSSSSSSSSSSSSSSSSSSSSSSSSSSSSSSSSSSSSSSSSSSSSSSLSSSS------SSSSSSSSSSSSS
SSSSS-SSSSSS--SSSS--SSS------------SS--SSSS------S-SSSSSS--SSSSSSSSS--SSSS----------SSSSSSSSS--SSSS------SS-------------SSSS---------------------------------
SSSSS-SSSSSS--SSSS--SSS------------SS--SSSS------S-SSSSSS--SSSSSSSSS--SSSS----------SSSSSSSSS--SSSS------SS-------------SSSS---------------------------------
---SS-----SS---S-S---S-------------SS---S----SS--------SS---S-SS--SS---S----SS----------SS-SS---S----SS-------------------------oooooo------SSS--------------
---SS-----SS---S-S---S-------------SS---S----SS--------SS---S-SS--SS---S----SS----------SS-SS---S----SS------------------------------------------------------
---SS-----SS---S-S---S-------------SS---S----SS--------SS---S-SS--SS---S----SS----------SS-SS---S----SS-------------------------SSSSSS-----------------------
oooSS-ooooSS---SoS---So------------SS---SoU--SC----ooooSS---SoSSooSS---SoU--SC------ooooSSoSS---SoU--SC-------------------------SSSSSS-------------------C---
SSSSS-SSSSSS---SSS---SS-#-TT-------SS---SSS--SS--S-SSSSSS---SSSSSSSS---SSS--SS------SSSSSSSSS---SSS--SS--SS---TT--------SSSS------------##---------#-#-------
-----------------------##-TT----------------------------------------------------------------------------T-----TT------------------------##-------#-#-#-#---#-
-----------------------##-TT----TT----------------------------------------------------------------------------TT----TT------------------##--SSS--#-#-#-#---#F
---M---------g---------##-TT----TT-----kk----------------k--------------ggg-----------------------------------TT----TT------------------##-------#-#r#-#-E-##
XXXXXXXXXXXXXXXXXXXXXXXXXXXXXXXXXXXXXXXXXXXXXXXXXXXXXXXXXXXXXXXXXXXXXXXXXXXXXXXX--XXXXXXXXXXXXXXXXXXXXXXXXXXXXXXXXXXXXXXXXXX---XXXXXXXXXXX------XXXXXXXXXXXXX
XXXXXXXXXXXXXXXXXXXXXXXXXXXXXXXXXXXXXXXXXXXXXXXXXXXXXXXXXXXXXXXXXXXXXXXXXXXXXXXX--XXXXXXXXXXXXXXXXXXXXXXXXXXXXXXXXXXXXXXXXXX---XXXXXXXXXXX------XXXXXXXXXXXXX
