-------------------------------------------------------------------------------------------------------------------------------------------------------------
-------------------------------------------------------------------------------------------------------------------------------------------------------------
-------------------------------------------------------------------------------------------------------------------------------------------------------------
SSSSSSSSSSSSSSSSSSSSSSSSSSSSSSSSSSSSSSSSSSSSSSSSSSSSSSSSSSSSSSSSSSSSSSSSSSSSSSSS--SSSSSSSSSSSSSSSSSSSSSSSSSSSSSSSSSSSSSSSSSSSSSSSSSSSSSSSSSSSSS--------------
SSSS--SSSSSS--SSSS----------------------SS-SSSS--SSSS------SSSS--SSSS--SSSSSSS----SSSSSSS--SSSS-----S----------------SSS-------S------SSSS-------------------
SSSS--SSSSSS--SSSS----------------------SS-SSSS--SSSS------SSSS--SSSS--SSSSSSS----SSSSSSS--SSSS-----S----------------SSS-------S------SSSS-------------------
--SS---S--SS---S------------------------SS-S-SS---S----SS----SS---S-----SS--SS---------SS---S----SS-------------------SS----------SS----------o--------------
--SS---S--SS---S------------------------SS-S-SS---S----SS----SS---S-----SS--SS---------SS---S----SS-------------------SS----------SS-------------------------
--SS---S--SS---S------------------------SS-S-SS---S----SS----SS---S-----SS--SS---------SS---S----SS-------------------SS----------SS----------S--------------
ooSS---SooSS---SoU----------------------SS-SoSS---SoU--SC----SS---SoU--oSSooSS----oooooSS---SoU--SC------------------oSS-------U--SC----------S--SSSSSSU-----
SSSS---SSSSS---SSS-------##-----TT------SS-SSSS---SSS--SS--SSSS---SSS--SSSSSSS----SSSSSSS---SSS--SS-----------TT-----SSS-------S--SS--SSSS-------------------
------------------------###T----TT----------------------------------------------------------------------TT----TT-----------S---------------------------------
-----------------------####T----TT----TT----------------------------------------------------------------TT----TT----T------S--------------------------------F
---M---------g--------#####T----TT----Tkk----------------k--------------ggg-----------------------------TT----TT----T------S------------------------r-------#
XXXXXXXXXXXXXXXXXXXXXXXXXXXXXXXXXXXXXXXXXXXXXXXXXXXXXXXXXXXXXXXXXXXXXXXXXXXXXXXX--XXXXXXXXXXXXXXXXXXXXXXXXXXXXXXXXXXXXXXX--X---XXXXXXXXXXX---XX--XXXXXXXX--X-
XXXXXXXXXXXXXXXXXXXXXXXXXXXXXXXXXXXXXXXXXXXXXXXXXXXXXXXXXXXXXXXXXXXXXXXXXXXXXXXX--XXXXXXXXXXXXXXXXXXXXXXXXXXXXXXXXXXXXXXX--X---XXXXXXXXXXX---XX--XXXXXXXX--XX
