-------------------------------------------------------------------------------------------------------------------------------------------------------------
-------------------------------------------------------------------------------------------------------------------------------------------------------------
-------------------------------------------------------------------------------------------------------------------------------------------------------------
SSSSSSSSSSSSSSSSSSSSSSSSSSSSSSSSSSSSSSSSSSSSSSSSSSSSSSSSSSSSSSSSSSSSSSSSSSSSSSSS--SSSSSSSSSSSSSSSSSSSSSSSSSSSSSSSSSSSSSSSSSSSSSSSSSSSSSSSSSSSSSSSSSSSSSSSSSSS
SSSSS-SSSSSS--SSSS------SSS----------SS--SSSSSS--SSSSSSSSSS--SSSSSSS--SSS--SSSSS---SSSSSSSSSS--SSSSSSSSS-----------------------S------SSSS-------------------
SSSSS-SSSSSS--SSSS------SSS----------SS--SSSSSS--SSSSSSSSSS--SSSSSSS--SSS--SSSSS---SSSSSSSSSS--SSSSSSSSS-----------------------S------SSSS-------------------
---SS---SSSS---S----SS-------------SS--------SS---S----SSSS---S---SS---S-------S----S------SS---S----S----------------------------SS-------------------------
---SS---SSSS---S----SS-------------SS--------SS---S----SSSS---S---SS---S-------S----S------SS---S----S----------------------------SS-------------------------
---SS---SSSS---S----SS-------------SS--------SS---S----SSSS---S---SS---S-------S----S------SS---S----S----------------------------SS-------------------------
oooSS-ooSSSS---SoU--SC-------------SS----ooooSS---SooooSSSS---SoooSS---So--ooooS----SoUooooSS---So---SoU-----------------------U--SC-------------------------
SSSSS-SSSSSS---SSS--SS--SSST-----#-SSSS--SSSSSS---SSSSSSSSS---SSSSSS---SS--SSSSS----SSSSSSSSS---SSSS-SSS------TT---------------S--SS--SSSS-------------##----
---------------------------T----##---SS-----------------------------------------------------------------TT----TT----------SS--------------------------###--SS
---------------------------T---###---SS-----------------------------------------------------------------TT----TT----TT----SS-------------------------####--SF
---M---------g-------------T--####-----kk----------------k--------------ggg-----------------------------TT----TT----TT----SS------------------------r####--S#
XXXXXXXXXXXXXXXXXXXXXXXXXXXXXXXXXXXXXXXXXXXXXXXXXXXXXXXXXXXXXXXXXXXXXXXXXXXXXXXX--XXXXXXXXXXXXXXXXXXXXXXXXXXXXXXXXXXXXXX--XX---XXXXXXXXXXX---XXXXXXXXXXXX--XX
XXXXXXXXXXXXXXXXXXXXXXXXXXXXXXXXXXXXXXXXXXXXXXXXXXXXXXXXXXXXXXXXXXXXXXXXXXXXXXXX--XXXXXXXXXXXXXXXXXXXXXXXXXXXXXXXXXXXXXX--XX---XXXXXXXXXXX---XXXXXXXXXXXX--XX
