-------------------------------------------------------------------------------------------------------------------------------------------------------------
-------------------------------------------------------------------------------------------------------------------------------------------------------------
-------------------------------------------------------------------------------------------------------------------------------------------------------------
SSSSSSSSSSSSSSSSSSSSSSSSSSSSSSSSSSSSSSSSSSSSSSSSSSSSSSSSSSSSSSSSSSSSSSSSSSSSSSSS--SSSSSSSSSSSSSSSSSSSSSSSSSSSSSSSSSSSSSSSSSSSSSSSSSSSSSSSSSSSSSSSSSSSSSSSSSSS
SSSS--SSSSS--SS-----------------SS--SSSS-SSSSSS--SSSSSSSSS--SSSS------SSSSSSSS----SS----SSSSSSSSS--SSS---------------SSS--SSSS----SSS--S---------------------
SSSS--SSSSS--SS-----------------SS--SSSS-SSSSSS--SSSSSSSSS--SSSS------SSSSSSSS----SS----SSSSSSSSS--SSS---------------SSS--SSSS----SSS--S---------------------
-SSS---S-SS---S------------------------S-----SS---S---SSSS---S----SS---SS---SS--------SS-SS----SS---S-----------------SS---S----SS-SS------------------------
-SSS---S-SS---S------------------------S-----SS---S---SSSS---S----SS---SS---SS--------SS-SS----SS---S-----------------SS---S----SS-SS------------------------
-SSS---S-SS---S------------------------S-----SS---S---SSSS---S----SS---SS---SS--------SS-SS----SS---S-----------------SS---S----SS-SS------------------------
oSSS---SoSS---S---------------------oooS-ooooSS---SoooSSSS---SoU--SC--oSSoooSS----oU--SCoSSooooSS---So---------------oSS---SoU--SCoSS------------------------
SSSS---SSSS---S-----------TT----SS--SSSS-SSSSSS---SSSSSSSS---SSS--SS--SSSSSSSS----SS--SSSSSSSSSSS---SS--------TT-----SSS---SSS--SSSSS-----------------#------
--------------------TT----TT----SS----------------------------------------------------------------------TT----TT------------------------SS-----------##SS----
--------------------TT----TT----SS----------------------------------------------------------------------TT----TT----T-------------------SS----------###SS---F
---M---------g------TT----TT-----------kk----------------k--------------ggg-----------------------------TT----TT----T-------------------SS---------#r##SS---#
XXXXXXXXXXXXXXXXXXXXXXXXXXXXXXXXXXXXXXXXXXXXXXXXXXXXXXXXXXXXXXXXXXXXXXXXXXXXXXXX--XXXXXXXXXXXXXXXXXXXXXXXXXXXXXXXXXXXXXXXXXXXXXXXXXXXXXXXX--XXXXXXXXXXXXX--XX
XXXXXXXXXXXXXXXXXXXXXXXXXXXXXXXXXXXXXXXXXXXXXXXXXXXXXXXXXXXXXXXXXXXXXXXXXXXXXXXX--XXXXXXXXXXXXXXXXXXXXXXXXXXXXXXXXXXXXXXXXXXXXXXXXXXXXXXXX--XXXXXXXXXXXXX--XX
