-------------------------------------------------------------------------------------------------------------------------------------------------------------
-------------------------------------------------------------------------------------------------------------------------------------------------------------
-------------------------------------------------------------------------------------------------------------------------------------------------------------
SSSSSSSSSSSSSSSSSSSSSSSSSSSSSSSSSSSSSSSSSSSSSSSSSSSSSSSSSSSSSSSSSSSSSSSSSSSSSSSS--SSSSSSSSSSSSSSSSSSSSSSSSSSSSSSSSSSSSSSSSSSSSSSSSSSSSSSSSSSSSSSSSSSSSSSSSSSS
SSSSSSSSSSSSS--SSSS------------------SSSSSSSSSSS---SSSSSS--SSSS-SSSSSSSSS--SSSS--------SSSSSS--SSSS------SSSS--------SSS--SS-----------SSSS------------------
SSSSSSSSSSSSS--SSSS------------------SSSSSSSSSSS---SSSSSS--SSSS-SSSSSSSSS--SSSS--------SSSSSS--SSSS------SSSS--------SSS--SS-----------SSSS------------------
SSSS----SS-SS---S----------------------SSS----SS-------SS---S-----SS---SS---S-------ooo----SS---S----SS---------------SS---S----oooSS------------------------
SSSS----SS-SS---S----------------------SSS----SS-------SS---S-----SS---SS---S--------------SS---S----SS---------------SS---S-------SS------------------------
SSSS----SS-SS---S----------------------SSS----SS-------SS---S-----SS---SS---S-------SSS----SS---S----SS---------------SS---S----SSSSS------------------------
SSSSooooSSoSS---SoU------------------ooSSSooooSS---ooooSS---SoU-ooSSoooSS---SoU-----SSSooooSS---SoU--SC---------------SS---S----SSSSC------------------------
SSSSSSSSSSSSS---SSS-------TT---------SSSSSSSSSSS---SSSSSS---SSS-SSSSSSSSS---SSS--------SSSSSS---SSS--SS--SSSS-TT------SS---S-------SS--SSSS------------##----
--------------------TT----TT----------------------------------------------------------------------------T-----TT--------------------------------------###--SS
--------------------TT----TT----TT----------------------------------------------------------------------------TT----T--------------------------------####--SF
---M---------g------TT----TT----TT-----kk----------------k--------------ggg-----------------------------------TT----T-------------------------------r####--S#
XXXXXXXXXXXXXXXXXXXXXXXXXXXXXXXXXXXXXXXXXXXXXXXXXXXXXXXXXXXXXXXXXXXXXXXXXXXXXXXX---XXXXXXXXXXXXXXXXXXXXXXXXXXXXXXXXXXXXXXXXX---XXXXXXXXXXXX---XXXXXXXXXXX--XX
XXXXXXXXXXXXXXXXXXXXXXXXXXXXXXXXXXXXXXXXXXXXXXXXXXXXXXXXXXXXXXXXXXXXXXXXXXXXXXXX---XXXXXXXXXXXXXXXXXXXXXXXXXXXXXXXXXXXXXXXXX---XXXXXXXXXXXX---XXXXXXXXXXX--XX
