-------------------------------------------------------------------------------------------------------------------------------------------------------------
-------------------------------------------------------------------------------------------------------------------------------------------------------------
-------------------------------------------------------------------------------------------------------------------------------------------------------------
SSSSSSSSSSSSSSSSSSSSSSSSSSSSSSSSSSSSSSSSSSSSSSSSSSSSSSSSSSSSSSSSSSSSSSSSSSSSSSSS--SSSSSSSSSSSSSSSSSSSSSSSSSSSSSSSSSSSSSSSSSSSSSSSSSSSSSSSSSSSSSSSSSSSSSSS--SS
S-SS--SSSSSS--SSSS--------------SS--SSSSSS--SSSSSSSSSSSSSS--SSSS----SSSSS--SSSS---SSSSSS--SSSSSSS--SS--------------------SSSS---------SSSS-------------------
S-SS--SSSSSS--SSSS--------------SS--SSSSSS--SSSSSSSSSSSSSS--SSSS----SSSSS--SSSS---SSSSSS--SSSSSSS--SS--------------------SSSS---------SSSS-------------------
SS--------SS---S------------------------SS---S-----SS---SS---S----SS---SS---S---------SS---S---SS---S----------------SS----------ooS-------------------------
SS--------SS---S------------------------SS---S-----SS---SS---S----SS---SS---S---------SS---S---SS---S----------------SS------------S-------------------------
SS--------SS---S------------------------SS---S-----SS---SS---S----SS---SS---S---------SS---S---SS---S----------------SS----------SSS-------------------------
SS----ooooSS---SoU------------------ooooSS---SoUoooSSoooSS---SoU--SCoooSS---SoU---ooooSS---SoooSS---S----------------SC----------SSC-------------------------
SSSS--SSSSSS---SSS--------TT----SS--SSSSSS---SSSSSSSSSSSSS---SSS--SSSSSSS---SSS---SSSSSS---SSSSSS---S---------TTT----SS--SSSS------S--SSSS-------------##----
S-SS----------------TT----TT----SS----------------------------------------------------------------------TT----TTT-------------------------------------###--TT
S-SS----------------TT----TT----SS----------------------------------------------------------------------TT----TTT------------------------------------####--TF
S--M---------g------TT----TT-----------kk----------------k--------------ggg-----------------------------TT----TTT---T-------------------------------r####--T#
XXXXXXXXXXXXXXXXXXXXXXXXXXXXXXXXXXXXXXXXXXXXXXXXXXXXXXXXXXXXXXXXXXXXXXXXXXXXXXXX--XXXXXXXXXXXXXXXXXXXXXXXXXXXXXXXXXXXXXXXXXXX---XXXXXXXXXX---XXXXXXXXXXXX--XX
XXXXXXXXXXXXXXXXXXXXXXXXXXXXXXXXXXXXXXXXXXXXXXXXXXXXXXXXXXXXXXXXXXXXXXXXXXXXXXXX--XXXXXXXXXXXXXXXXXXXXXXXXXXXXXXXXXXXXXXXXXXX---XXXXXXXXXX---XXXXXXXXXXXX--XX
