-------------------------------------------------------------------------------------------------------------------------------------------------------------
-------------------------------------------------------------------------------------------------------------------------------------------------------------
-------------------------------------------------------------------------------------------------------------------------------------------------------------
SSSSSSSSSSSSSSSSSSSSSSSSSSSSSSSSSSSSSSSSSSSSSSSSSSSSSSSSSSSSSSSSSSSSSSSSSSSSSSSS--SSSSSSSSSSSSSSSSSSSSSSSSSSSSSSSSSSSSSSSSSSSSSSSSSSSSSSSSSSSSS--------------
SSSS--SSSSSS--SSSS-----------------SSSSSSS--SSSSSS--SSSSS--SSSS--SSSS-----SSSSS---SSSSSS--SSSS------SS------------------------SS------SSSS-------------------
SSSS--SSSSSS--SSSS-----------------SSSSSSS--SSSSSS--SSSSS--SSSS--SSSS-----SSSSS---SSSSSS--SSSS------SS------------------------SS------SSSS-------------------
S-SS---S--SS---SSS------------------SS--SS------SS---S--S---SSS---S----SS----SS---S---SS---S----SS--------------------------------SS----------o--------------
S-SS---S--SS---SSS------------------SS--SS------SS---S--S---SSS---S----SS----SS---S---SS---S----SS--------------------------------SS-------------------------
S-SS---S--SS---SSS------------------SS--SS------SS---S--S---SSS---S----SS----SS---S---SS---S----SS--------------------------------SS----------S--------------
SoSS---SooSS---SSS-----------------oSSooSS--ooooSS---SoUS---SSS---SoU--SC-oooSS---SoUoSS---SoU--SC----------------------------oU--SC----------S--SSSSSSU-----
SSSS---SSSSS---SSS--------TT-------SSSSSSS--SSSSSS---SSSS---SSS---SSS--SS-SSSSS---SSSSSS---SSS--SS--SS--------TT--------------SS--SS--SSSS-------------------
S-------------------TT----TT----------------------------------------------------------------------------TT----TT----------SS---------------------------------
S-------------------TT----TT----TT----------------------------------------------------------------------TT----TT----TT----SS--------------------------------F
S--M---------g------TT----TT----TT-----kk----------------k--------------ggg-----------------------------TT----TT----TT----SS------------------------r-------#
XXXXXXXXXXXXXXXXXXXXXXXXXXXXXXXXXXXXXXXXXXXXXXXXXXXXXXXXXXXXXXXXXXXXXXXXXXXXXXXX--XXXXXXXXXXXXXXXXXXXXXXXXXXXXXXXXXXXXXX--XX--XXXXXXXXXXXX---XX--XXXXXXXX--X-
XXXXXXXXXXXXXXXXXXXXXXXXXXXXXXXXXXXXXXXXXXXXXXXXXXXXXXXXXXXXXXXXXXXXXXXXXXXXXXXX--XXXXXXXXXXXXXXXXXXXXXXXXXXXXXXXXXXXXXX--XX--XXXXXXXXXXXX---XX--XXXXXXXX--XX
