-------------------------------------------------------------------------------------------------------------------------------------------------------------
-------------------------------------------------------------------------------------------------------------------------------------------------------------
-------------------------------------------------------------------------------------------------------------------------------------------------------------
SSSSSSSSSSSSSSSSSSSSSSSSSSSSSSSSSSSSSSSSSSSSSSSSSSSSSSSSSSSSSSSSSSSSSSSSSSSSSSSS--SSSSSSSSSSSSSSSSSSSSSSSSSSSSSSSSSSSSSSSSSSSSSSSSSSSSSSSS----SSSSSSSSSSSSSSS
SSSS--SSSSS--SS-------------------SSSS--SSSSSSSSSS--SSSSSS--SSSS---SSSSSS-SS--SS--SSSSSS--SSSSS--SSSSS--SSSS--------------------SSSS-------------------------
SSSS--SSSSS--SS-------------------SSSS--SSSSSSSSSS--SSSSSS--SSSS---SSSSSS-SS--SS--SSSSSS--SSSSS--SSSSS--SSSS--------------------SSSS-------------------------
--SS---S-SS---S---------------------SS---S-S----SS---S--SS---S----S----SS-SSSS--------SS---S-SS---S-SS---S------------------------SS--------SS---------------
--SS---S-SS---S---------------------SS---S-S----SS---S--SS---S----S----SS-SSSS--------SS---S-SS---S-SS---S------------------------SS-------------------------
--SS---S-SS---S---------------------SS---S-S----SS---S--SS---S----S----SS-SSSS--------SS---S-SS---S-SS---S------------------------SS-------------------------
ooSS---SoSS---S-------------------ooSS---SoSooooSS---SoUSS---SoU--SooooSS-SSSS----ooooSS---SoSS---SoSS---SoU--------------------ooSS-------------------------
SSSS---SSSS---S-----------TT-----#SSSS---SSSSSSSSS---SSSSS---SSS--SSSSSSS-SSSSSS--SSSSSS---SSSS---SSSS---SSS--TT----------------SSSS----##-----------##------
--------------------TT----TT----##--------------------------------------------SS------------------------T-----TT-----------SS--S-------###----------###SS----
--------------------TT----TT---###--------------------------------------------SS------------------------------TT----TT-----SS--S------####--SS-----####SS---F
---M---------g------TT----TT--####-----kk----------------k--------------ggg-----------------------------------TT----TT-----SS--S-----#####--------##r##SS---#
XXXXXXXXXXXXXXXXXXXXXXXXXXXXXXXXXXXXXXXXXXXXXXXXXXXXXXXXXXXXXXXXXXXXXXXXXXXXXXXX--XXXXXXXXXXXXXXXXXXXXXXXXXXXXXXXXXXXXXXX--XX--XXXXXXXXXXX----XXXXXXXXXXX--XX
XXXXXXXXXXXXXXXXXXXXXXXXXXXXXXXXXXXXXXXXXXXXXXXXXXXXXXXXXXXXXXXXXXXXXXXXXXXXXXXX--XXXXXXXXXXXXXXXXXXXXXXXXXXXXXXXXXXXXXXX--XX--XXXXXXXXXXX----XXXXXXXXXXX--XX
