-------------------------------------------------------------------------------------------------------------------------------------------------------------
-------------------------------------------------------------------------------------------------------------------------------------------------------------
-------------------------------------------------------------------------------------------------------------------------------------------------------------
SSSSSSSSSSSSSSSSSSSSSSSSSSSSSSSSSSSSSSSSSSSSSSSSSSSSSSSSSSSSSSSSSSSSSSSSSSSSSSSS--SSSSSSSSSSSSSSSSSSSSSSSSSSSSSSSSSSSSSSSSSSSSSSSSSSSSSSSSSSSSSSSSSSSSSSSSSSS
--SS--SSSSSS--SSSSSS------------SS--SSSSSS-SSSSSS--SSSSSS--SSSS--SSSS------SSSSS---SSSSSS--SSSSSSS--SSSS-------------SSSS--S---------------------------------
--SS--SSSSSS--SSSSSS------------SS--SSSSSS-SSSSSS--SSSSSS--SSSS--SSSS------SSSSS---SSSSSS--SSSSSSS--SSSS-------------SSSS--S---------------------------------
SS--------SS---S-SS--------------------SSS-----SS------SS---SSS---S----SS------S----S--SS---S---SS---S----------------SSS------------------------------------
SS--------SS---S-SS--------------------SSS-----SS------SS---SSS---S----SS------S----S--SS---S---SS---S----------------SSS------------------------------------
SS--------SS---S-SS--------------------SSS-----SS------SS---SSS---S----SS------S----S--SS---S---SS---S----------------SSS------------------------------------
SS----ooooSS---SoSS-----------------oo-SSS-ooooSS--ooooSS---SSS---SoU--SC----ooS----SooSS---SoooSS---SoU--------------SSS------------------------------------
SSSS--SSSSSS---SSSS-------TT----SS--SS-SSS-SSSSSS--SSSSSS---SSS---SSS--SS--SSSSS----SSSSS---SSSSSS---SSS------TT------SSS---------------##-----------##------
--SS----------------TT----TT----SS----------------------------------------------------------------------T-----TT-----------------------###----------###SS----
--SS----------------TT----TT----SS----------------------------------------------------------------------------TT----T-----------------####---------####SS---F
---M---------g------TT----TT-----------kk----------------k--------------ggg-----------------------------------TT----T----------------#####--------##r##SS---#
XXXXXXXXXXXXXXXXXXXXXXXXXXXXXXXXXXXXXXXXXXXXXXXXXXXXXXXXXXXXXXXXXXXXXXXXXXXXXXXX--XXXXXXXXXXXXXXXXXXXXXXXXXXXXXXXXXXXXXXXXXX--XXXXXXXXXXXX-XXXXXXXXXXXXXX--XX
XXXXXXXXXXXXXXXXXXXXXXXXXXXXXXXXXXXXXXXXXXXXXXXXXXXXXXXXXXXXXXXXXXXXXXXXXXXXXXXX--XXXXXXXXXXXXXXXXXXXXXXXXXXXXXXXXXXXXXXXXXX--XXXXXXXXXXXX-XXXXXXXXXXXXXX--XX
