-------------------------------------------------------------------------------------------------------------------------------------------------------------
-------------------------------------------------------------------------------------------------------------------------------------------------------------
-------------------------------------------------------------------------------------------------------------------------------------------------------------
SSSSSSSSSSSSSSSSSSSSSSSSSSSSSSSSSSSSSSSSSSSSSSSSSSSSSSSSSSSSSSSSSSSSSSSSSSSSSSSS--SSSSSSSSSSSSSSSSSSSSSSSSSSSSSSS-SSSSSSSSSSSSSSSSSSSSSSSSSSSSSSSSSSSSSSSSSSS
--SS--SSSSSS--S-------------------SSSS--SSSSSSSSSS--SSSS-SSSSS--SSSSSSSSS--SSSSS---SSSSSSSSSSSSSSS--SS---------------------------SS--SSSSS-------------------
--SS--SSSSSS--S-------------------SSSS--SSSSSSSSSS--SSSS-SSSSS--SSSSSSSSS--SSSSS---SSSSSSSSSSSSSSS--SS---------------------------SS--SSSSS-------------------
SS--------SS-----------------------SSS---S------SS---S------SS---S-----SS---S--S----S--SS----SS-SS---S---------------------------SS---S----------------------
SS--------SS-----------------------SSS---S------SS---S------SS---S-----SS---S--S----S--SS----SS-SS---S---------------------------SS---S----------------------
SS--------SS-----------------------SSS---S------SS---S------SS---S-----SS---S--S----S--SS----SS-SS---S---------------------------SS---S----------------------
SS----ooooSS----------------------oSSS---SoUooooSS---SoU-oooSS---SoooooSS---SooS----SoUSSooooSSoSS---S---------------------------SS---SoU--------------------
SSSS--SSSSSS--------------TT-----#SSSS---SSSSSSSSS---SSS-SSSSS---SSSSSSSS---SSSS----SSSSSSSSSSSSSS---S--------T##----------------SS---SSSS------------##-----
--SS----------------TT----TT----##----------------------------------------------------------------------T-----###----------SS------------S-----------###---SS
--SS----------------TT----TT---###----------------------------------------------------------------------TT---####---TT-----SS------------S----------####---SF
---M---------g------TT----TT--####-----kk----------------k--------------ggg-----------------------------TT---####---TT-----SS----------------------#r###---S#
XXXXXXXXXXXXXXXXXXXXXXXXXXXXXXXXXXXXXXXXXXXXXXXXXXXXXXXXXXXXXXXXXXXXXXXXXXXXXXXX--XXXXXXXXXXXXXXXXXXXXXXXXXXXXXXX-XXXXXXX--XX--XXXXXXXXXXX--XXXXXXXXXXXXX--XX
XXXXXXXXXXXXXXXXXXXXXXXXXXXXXXXXXXXXXXXXXXXXXXXXXXXXXXXXXXXXXXXXXXXXXXXXXXXXXXXX--XXXXXXXXXXXXXXXXXXXXXXXXXXXXXXX-XXXXXXX--XX--XXXXXXXXXXX--XXXXXXXXXXXXX--XX
