-------------------------------------------------------------------------------------------------------------------------------------------------------------
-------------------------------------------------------------------------------------------------------------------------------------------------------------
-------------------------------------------------------------------------------------------------------------------------------------------------------------
SSSSSSSSSSSSSSSSSSSSSSSSSSSSSSSSSSSSSSSSSSSSSSSSSSSSSSSSSSSSSSSSSSSSSSSSSSSSSSSS--SSSSSSSSSSSSSSSSSSSSSSSSSSSSSSSSSSSSSSSSSSSSSSSSSSSLSSSSSSSSSSSSSSSSSS-SSSS
--SS--SSSSSS--S------------------SSSSS--SSSSSS--SSSS---SSS--SSSSSSSSSSSSS--SSSS----SSSSSSSSSS--SSS------SSS---------SSS-SSSS---------------------------------
--SS--SSSSSS--S------------------SSSSS--SSSSSS--SSSS---SSS--SSSSSSSSSSSSS--SSSS----SSSSSSSSSS--SSS------SSS---------SSS-SSSS---------------------------------
SS--------SS------------------------SS------SS---S----S-SS---S-----SSSSSS---S----------SS--SS---S---SS---------------S----------oooooo-----------------------
SS--------SS------------------------SS------SS---S----S-SS---S-----SSSSSS---S----------SS--SS---S---SS---------------S---------------------------------------
SS--------SS------------------------SS------SS---S----S-SS---S-----SSSSSS---S----------SS--SS---S---SS---------------S----------SSSSSS-----------------------
SS----ooooSS---------------------oooSS--ooooSS---SoU--SoSS---SoooooSSSSSS---SoU----ooooSSooSS---So--SC---------------So---------SSSSSS-----------------------
SSSS--SSSSSS--------------TT-----SSSSS--SSSSSS---SSS--SSSS---SSSSSSSSSSSS---SSS----SSSSSSSSSS---SS--SS--SSS---TT-----SS-SSSS------------#-------------##-----
--SS----------------TT----TT----T-----------------------------------------------------------------------T-----TT-----------------------##S-----------###---SS
--SS----------------TT----TT---#T-----------------------------------------------------------------------------TT----------------------###S----------####---SF
---M---------g------TT----TT---#T------kk----------------k--------------ggg-----------------------------------TT----T-----------------###S---------#r###---S#
XXXXXXXXXXXXXXXXXXXXXXXXXXXXXXXXXXXXXXXXXXXXXXXXXXXXXXXXXXXXXXXXXXXXXXXXXXXXXXXX--XXXXXXXXXXXXXXXXXXXXXXXXXXXXXXXXXXXXXXXXXX---XXXXXXXXXXX--XXXXXXXXXXXX---XX
XXXXXXXXXXXXXXXXXXXXXXXXXXXXXXXXXXXXXXXXXXXXXXXXXXXXXXXXXXXXXXXXXXXXXXXXXXXXXXXX--XXXXXXXXXXXXXXXXXXXXXXXXXXXXXXXXXXXXXXXXXX---XXXXXXXXXXX--XXXXXXXXXXXX---XX
