-------------------------------------------------------------------------------------------------------------------------------------------------------------
-------------------------------------------------------------------------------------------------------------------------------------------------------------
-------------------------------------------------------------------------------------------------------------------------------------------------------------
SSSSSSSSSSSSSSSSSSSSSSSSSSSSSSSSSSSSSSSSSSSSSSSSSSSSSSSSSSSSSSSSSSSSSSSSSSSSSSSS--SSSSSSSSSSSSSSSSSSSSSSSSSSSSSSSSSSSSSSSSSSSSSSSSSSSSSSSSSSSSSSSSSSSSSSS----
SSSS--SSSS----------------------------SSS--SSSSSSS--SSSS----SSS--SSSS-SS--SSSSSS---SSSSSSSSSS--SSSS---SSSSS--------------SSS---S------SSSS-------------------
SSSS--SSSS----------------------------SSS--SSSSSSS--SSSS----SSS--SSSS-SS--SSSSSS---SSSSSSSSSS--SSSS---SSSSS--------------SSS---S------SSSS-------------------
-SSS---S----SS-------------------------SS---S---SS---S----SS-SS---S---SS---S---S----SSS----SS---S----S----------------------------SS-----------------------SS
-SSS---S----SS-------------------------SS---S---SS---S----SS-SS---S---SS---S---S----SSS----SS---S----S----------------------------SS-------------------------
-SSS---S----SS-------------------------SS---S---SS---S----SS-SS---S---SS---S---S----SSS----SS---S----S----------------------------SS-------------------------
oSSS---SoU--SC------------------------oSS---SoooSS---SoU--SCoSS---SoU-SS---SoooS----SSSooooSS---SoU--S-------------------------U--SC-------------------------
SSSS---SSS--SS--------#-#-------TT----SSS---SSSSSS---SSS--SSSSS---SSS-SS---SSSSS----SSSSSSSSS---SSS--SSSSSS---TT---------SSS---S--SS--SSSS-------------##----
--------------------#-#-#-#T----TT----------------------------------------------------------------------T-----TT---------------------------------SS---###----
------------------#-#-#-#-#T----TT----------------------------------------------------------------------------TT----TT---------------------------SS--####--SF
---M---------g--#-#-#-#-#-#T----TT-----kk----------------k--------------ggg-----------------------------------TT----TT---------------------------SS-r####---#
XXXXXXXXXXXXXXXXXXXXXXXXXXXXXXXXXXXXXXXXXXXXXXXXXXXXXXXXXXXXXXXXXXXXXXXXXXXXXXXX--XXXXXXXXXXXXXXXXXXXXXXXXXXXXXXXXXXXXXXXXXX---XXXXXXXXXXX--XXX--XXXXXXXX----
XXXXXXXXXXXXXXXXXXXXXXXXXXXXXXXXXXXXXXXXXXXXXXXXXXXXXXXXXXXXXXXXXXXXXXXXXXXXXXXX--XXXXXXXXXXXXXXXXXXXXXXXXXXXXXXXXXXXXXXXXXX---XXXXXXXXXXX--XXX--XXXXXXXX----
