-------------------------------------------------------------------------------------------------------------------------------------------------------------
-------------------------------------------------------------------------------------------------------------------------------------------------------------
-------------------------------------------------------------------------------------------------------------------------------------------------------------
SSSSSSSSSSSSSSSSSSSSSSSSSSSSSSSSSSSSSSSSSSSSSSSSSSSSSSSSSSSSSSSSSSSSSSSSSSSSSSSS--SSSSSSSSSSSSSSSSSSSSSSSSSSSSSSSSSSSSSSSSSSSSSSSSSSSLSSSS--------SSSSSSS----
--SS--SSSSSS--SSSS--S-----------SS--SSSSSS-SSSS--SSSSSSSSS--SSSS-----SSSS--SSSS------SSS--SSSS------SSS--------------SSS--SS----------------------S----------
--SS--SSSSSS--SSSS--S-----------SS--SSSSSS-SSSS--SSSSSSSSS--SSSS-----SSSS--SSSS------SSS--SSSS------SSS--------------SSS--SS----------------------S----------
SS--------SS---SSS------------SS--------SS---SS---SS----SS---S----SS---SS---S-----S---SS---S----SS---S----------------SS---S----oooooo------SSS------------SS
SS--------SS---SSS------------SS--------SS---SS---SS----SS---S----SS---SS---S-----S---SS---S----SS---S----------------SS---S---------------------------------
SS--------SS---SSS------------SS--------SS---SS---SS----SS---S----SS---SS---S-----S---SS---S----SS---S----------------SS---S----SSSSSS-----------------------
SS----ooooSS---SSS------------SS----ooooSS-ooSS---SSooooSS---SoU--SC-ooSS---SoU---C---SS---SoU--SC---So--------------oSS---S----SSSSSS-----------S-----------
SSSS--SSSSSS---SSS-------##---SSSS--SSSSSS-SSSS---SSSSSSSS---SSS--SS-SSSS---SSS---S--SSS---SSS--SS---SS-------TT-----SSS---S------------##--------S-##-##----
--SS-----------------SS-###-----SS----------------------------------------------------------------------TT----TT-----------------------###--------S######----
--SS-----------------SS####-----SS----------------------------------------------------------------------TT----TT----T-----------------####--SSS---S######--SF
---M---------g-------SS####------------kk----------------k--------------ggg-----------------------------TT----TT----T-----------------####---------#r####---#
XXXXXXXXXXXXXXXXXXXXXXXXXXXXXXXXXXXXXXXXXXXXXXXXXXXXXXXXXXXXXXXXXXXXXXXXXXXXXXXX--XXXXXXXXXXXXXXXXXXXXXXXXXXXXXXXXXXXXXXXXXX---XXXXXXXXXXX-------XXXXXXXX----
XXXXXXXXXXXXXXXXXXXXXXXXXXXXXXXXXXXXXXXXXXXXXXXXXXXXXXXXXXXXXXXXXXXXXXXXXXXXXXXX--XXXXXXXXXXXXXXXXXXXXXXXXXXXXXXXXXXXXXXXXXX---XXXXXXXXXXX-------XXXXXXXX----
