-------------------------------------------------------------------------------------------------------------------------------------------------------------
-------------------------------------------------------------------------------------------------------------------------------------------------------------
-------------------------------------------------------------------------------------------------------------------------------------------------------------
SSSSSSSSSSSSSSSSSSSSSSSSSSSSSSSSSSSSSSSSSSSSSSSSSSSSSSSSSSSSSSSSSSSSSSSSSSSSSSSS--SSSSSSSSSSSSSSSSSSSSSSSSSSSSSSSSSSSSSSSSSSSSSSSSSSSSSSSS------------SSS----
SSSS--SSSS---SS--SS-------------SS--SSSSSS-SSSSSS--SSSSSS-SSSSS--SSSSSSSS--SSSS----SSSSSS--SSSSSSS------SSSS-------------SSS---SSSSSS------------------------
SSSS--SSSS---SS--SS-------------SS--SSSSSS-SSSSSS--SSSSSS-SSSSS--SSSSSSSS--SSSS----SSSSSS--SSSSSSS------SSSS-------------SSS---SSSSSS------------------------
--SS---S----SSS---S-----------SS--------SS-----SS------SS----SS---S----SS---S----------SS---S--SS---SS-----------------------------SS-------SSS------------SS
--SS---S----SSS---S-----------SS--------SS-----SS------SS----SS---S----SS---S----------SS---S--SS---SS-----------------------------SS------------------------
--SS---S----SSS---S-----------SS--------SS-----SS------SS----SS---S----SS---S----------SS---S--SS---SS-----------------------------SS------------------------
ooSS---SoU--SSS---S-----------SS----ooooSS-ooooSS--ooooSS-oooSS---SoUooSS---SoU----ooooSS---SoUSSU--SC-------------------------ooooSS------------SSSSS-------
SSSS---SSS--SSS---S------#-#--SSSS--SSSSSS-SSSSSS--SSSSSS-SSSSS---SSSSSSS---SSS----SSSSSS---SSSSSS--SS--SSSS--TT---------SSS---SSSSSS---##-------------##----
-----------------------#-#-#----SS----------------------------------------------------------------------T-----TT-----------------------###------------###----
---------------------#-#-#-#----SS----------------------------------------------------------------------------TT----TT----------------####--SSS-------###--SF
---M---------g-----#-#-#-#-#-----------kk----------------k--------------ggg-----------------------------------TT----TT---------------#####----------r-###---#
XXXXXXXXXXXXXXXXXXXXXXXXXXXXXXXXXXXXXXXXXXXXXXXXXXXXXXXXXXXXXXXXXXXXXXXXXXXXXXXX--XXXXXXXXXXXXXXXXXXXXXXXXXXXXXXXXXXXXXXXXXX--XXXXXXXXXXXX-------XXXXXXXX----
XXXXXXXXXXXXXXXXXXXXXXXXXXXXXXXXXXXXXXXXXXXXXXXXXXXXXXXXXXXXXXXXXXXXXXXXXXXXXXXX--XXXXXXXXXXXXXXXXXXXXXXXXXXXXXXXXXXXXXXXXXX--XXXXXXXXXXXX-------XXXXXXXX----
