-------------------------------------------------------------------------------------------------------------------------------------------------------------
-------------------------------------------------------------------------------------------------------------------------------------------------------------
-------------------------------------------------------------------------------------------------------------------------------------------------------------
SSSSSSSSSSSSSSSSSSSSSSSSSSSSSSSSSSSSSSSSSSSSSSSSSSSSSSSSSSSSSSSSSSSSSSSSSSSSSSSS--SSSSSSSSSSSSSSSSSSSSSSSSSSSSSSSSSSSSSSSSSSSSSSSSSSSSSSSS----------SSSSS----
SSSS--SSSSSSSS--SSSS--------------SSSS--SSSS----SSSSSSSSSS--SSSS-----SSSS------S--S-SSSSSSSSS--SSSS-----------------SSSS--SSSS-SSSSSS--SS--------------------
SSSS--SSSSSSSS--SSSS--------------SSSS--SSSS----SSSSSSSSSS--SSSS-----SSSS------S--S-SSSSSSSSS--SSSS-----------------SSSS--SSSS-SSSSSS--SS--------------------
--SS---S----SS---S------------------SS---S----SS--SS----SS---S----SS--S----SS--------SS----SS---S----SS---------------SS---S-------SS---S---SSS------------SS
--SS---S----SS---S------------------SS---S----SS--SS----SS---S----SS--S----SS--------SS----SS---S----SS---------------SS---S-------SS---S--------------------
--SS---S----SS---S------------------SS---S----SS--SS----SS---S----SS--S----SS--------SS----SS---S----SS---------------SS---S-------SS---S--------------------
ooSS---SooooSS---SoU--------------ooSS---SoU--SCooSSooooSS---SoU--SC--SoU--SC-------oSSooooSS---SoU--SC-------------ooSS---SoU-ooooSS---S--------SSS---------
SSSS---SSSSSSS---SSS-----TT-------SSSS---SSS--SSSSSSSSSSSS---SSS--SS--SSS--SS--S--S-SSSSSSSSS---SSS--SS-------TTT---SSSS---SSS-SSSSSS---S#-------------##----
-------------------------TT-----------------------------------------------------------------------------TT-----TT------------------------#------------###----
-------------------------TT----TT-----------------------------------------------------------------------TT-----TT------------------------#--SSS------####--SF
---M---------g-----------TT----TT------kk----------------k--------------ggg-----------------------------TT-----TT---T--------------------#----------r####---#
XXXXXXXXXXXXXXXXXXXXXXXXXXXXXXXXXXXXXXXXXXXXXXXXXXXXXXXXXXXXXXXXXXXXXXXXXXXXXXXX--X-XXXXXXXXXXXXXXXXXXXXXXXXXXXXXXXXXXXXXXXXXXXXXXXXXXXXXX-------XXXXXXXX----
XXXXXXXXXXXXXXXXXXXXXXXXXXXXXXXXXXXXXXXXXXXXXXXXXXXXXXXXXXXXXXXXXXXXXXXXXXXXXXXX--X-XXXXXXXXXXXXXXXXXXXXXXXXXXXXXXXXXXXXXXXXXXXXXXXXXXXXXX-------XXXXXXXX----
