-------------------------------------------------------------------------------------------------------------------------------------------------------------
-------------------------------------------------------------------------------------------------------------------------------------------------------------
-------------------------------------------------------------------------------------------------------------------------------------------------------------
SSSSSSSSSSSSSSSSSSSSSSSSSSSSSSSSSSSSSSSSSSSSSSSSSSSSSSSSSSSSSSSSSSSSSSSSSSSSSSSS--SSSSSSSSSSSSSSSSSSSSSSSSSSSSSSSSSSSSSSSSSSSSSSSSSSSSSSSS-------------------
SSSS--SSSSSS--SSSS-----------------SSS--SSSSSSSS--SSSSSS--SSSSS--SSSSSSSS--SSSS------SSSS--SSSS-SS--SSS------------SSSSS--SSS--------------------------------
SSSS--SSSSSS--SSSS-----------------SSS--SSSSSSSS--SSSSSS--SSSSS--SSSSSSSS--SSSS------SSSS--SSSS-SS--SSS------------SSSSS--SSS--------------------------------
--SS------SS---S--------------------SS---S----SS------SS-----SS---S----SS---S-----S----SS---S---SS---S----------------SS---S----------------SSS--------------
--SS------SS---S--------------------SS---S----SS------SS-----SS---S----SS---S-----S----SS---S---SS---S----------------SS---S---------------------------------
--SS------SS---S--------------------SS---S----SS------SS-----SS---S----SS---S-----S----SS---S---SS---S----------------SS---S---------------------------------
ooSS--ooooSS---SoU-----------------oSS---SoUooSS--ooooSS---ooSS---SoUooSS---SoU---C---oSS---SoU-SS---So------------oooSS---So--------------------SSSSSSU-----
SSSS--SSSSSS---SSS-----##-TT-------SSS---SSSSSSS--SSSSSS---SSSS---SSSSSSS---SSS---S--SSSS---SSS-SS---SS-------TT---SSSSS---SS-----------##-------------------
----------------------###-TT----------------------------------------------------------------------------TT----TT-----------------------###-------------------
---------------------####-TT----TT----------------------------------------------------------------------TT----TT----------------------####--SSS-------------F
---M---------g------#####-TT----TT-----kk----------------k--------------ggg-----------------------------TT----TT----T----------------#####----------r-------#
XXXXXXXXXXXXXXXXXXXXXXXXXXXXXXXXXXXXXXXXXXXXXXXXXXXXXXXXXXXXXXXXXXXXXXXXXXXXXXXX--XXXXXXXXXXXXXXXXXXXXXXXXXXXXXXXXXXXXXXXXXXX-XXXXXXXXXXXX-------XXXXXXXX--X-
XXXXXXXXXXXXXXXXXXXXXXXXXXXXXXXXXXXXXXXXXXXXXXXXXXXXXXXXXXXXXXXXXXXXXXXXXXXXXXXX--XXXXXXXXXXXXXXXXXXXXXXXXXXXXXXXXXXXXXXXXXXX-XXXXXXXXXXXX-------XXXXXXXX--XX
