-------------------------------------------------------------------------------------------------------------------------------------------------------------
-------------------------------------------------------------------------------------------------------------------------------------------------------------
-------------------------------------------------------------------------------------------------------------------------------------------------------------
SSSSSSSSSSSSSSSSSSSSSSSSSSSSSSSSSSSSSSSSSSSSSSSSSSSSSSSSSSSSSSSSSSSSSSSSSSSSSSSS--SSSSSSSSSSSSSSSSSSSSSSSSSSSSSSSSSSSSSSSSSSSSSSSSSSSSSSSS-----------SSSS----
SSSSSSSSSSSS--SSSS-------------------SS--SSSSSS--SSSSSSSSS--SSSS-SSS--SSSS---------SSSSSS--SSSS---------------------SSSSSS--S--------------------------------
SSSSSSSSSSSS--SSSS-------------------SS--SSSSSS--SSSSSSSSS--SSSS-SSS--SSSS---------SSSSSS--SSSS---------------------SSSSSS--S--------------------------------
----SS----SS---S-----------------------------SS---SS----SS---S----SS---S----SS------S--SS---S----S----------------------SS------ooooo-------SSS------------SS
----SS----SS---S-----------------------------SS---SS----SS---S----SS---S----SS------S--SS---S----S----------------------SS-----------------------------------
----SS----SS---S-----------------------------SS---SS----SS---S----SS---S----SS------S--SS---S----S----------------------SS------SSSSS------------------------
ooooSSooooSS---SoU-----------------------ooooSS---SSooooSS---SoU-oSS---SoU--SC------SooSS---SoU--S------------------ooooSS------SSSSS------------SSSS--------
SSSSSSSSSSSS---SSS------##------TT---SS--SSSSSS---SSSSSSSS---SSS-SSS---SSS--SS------SSSSS---SSS--S------------TT----SSSSSS--------------##-------------##----
--------------------TT-###TT----TT---SS-----------------------------------------------------------------TT----TT-----------------------###------------###----
--------------------TT####TT----TT---SS-----------------------------------------------------------------TT----TT----------------------####--SSS------####--SF
---M---------g------TT####TT----TT-----kk----------------k--------------ggg-----------------------------TT----TT----T----------------#####----------r####---#
XXXXXXXXXXXXXXXXXXXXXXXXXXXXXXXXXXXXXXXXXXXXXXXXXXXXXXXXXXXXXXXXXXXXXXXXXXXXXXXX--XXXXXXXXXXXXXXXXXXXXXXXXXXXXXXXXXXXXXXXXXXX--XXXXXXXXXXX-------XXXXXXXX----
XXXXXXXXXXXXXXXXXXXXXXXXXXXXXXXXXXXXXXXXXXXXXXXXXXXXXXXXXXXXXXXXXXXXXXXXXXXXXXXX--XXXXXXXXXXXXXXXXXXXXXXXXXXXXXXXXXXXXXXXXXXX--XXXXXXXXXXX-------XXXXXXXX----
