-------------------------------------------------------------------------------------------------------------------------------------------------------------
-------------------------------------------------------------------------------------------------------------------------------------------------------------
-------------------------------------------------------------------------------------------------------------------------------------------------------------
SSSSSSSSSSSSSSSSSSSSSSSSSSSSSSSSSSSSSSSSSSSSSSSSSSSSSSSSSSSSSSSSSSSSSSSSSSSSSSSS--SSSSSSSSSSSSSSSSSSSSSSSSSSSSSSSSSSSSSSSSSSSSSSSSSSSSSSSS-------SSSSSSSS--SS
SSSSS-SSSSSS--SSSS--SSS--------------SSSSSSSSSS--SSSSSSS--SSSSSSSSSS--SSSS-SSS-----SSSSSSSSSSSSSS--SSS------------------SSSS---------------------------------
SSSSS-SSSSSS--SSSS--SSS--------------SSSSSSSSSS--SSSSSSS--SSSSSSSSSS--SSSS-SSS-----SSSSSSSSSSSSSS--SSS------------------SSSS---------------------------------
S--SS-----SS---SSS---S-----------------SS----SS---S---SS---SS-SS--SS---S----SS------S---SSS----SS----S--------------------------oooo--------SSS--------------
S--SS-----SS---SSS---S-----------------SS----SS---S---SS---SS-SS--SS---S----SS------S---SSS----SS----S-------------------------------------------------------
S--SS-----SS---SSS---S-----------------SS----SS---S---SS---SS-SS--SS---S----SS------S---SSS----SS----S--------------------------SSSS-------------------------
SooSS-ooooSS---SSS---So--------------ooSSooooSS---SoUoSS---SSoSSooSS---SoU-oSS------SoooSSSooooSS----S--------------------------SSSS-------------------------
SSSSS-SSSSSS---SSS---SS---TT---------SSSSSSSSSS---SSSSSS---SSSSSSSSS---SSS-SSS------SSSSSSSSSSSSS----S--------TT--------SSSS------------##----------##-##----
S-------------------------TT----------------------------------------------------------------------------T-----TT-----------------------###---------######--SS
S-------------------------TT----TT----------------------------------------------------------------------TT----TT----TT----------------####--SSS---#######--SF
S--M---------g------------TT----TT-----kk----------------k--------------ggg-----------------------------TT----TT----TT---------------#####-------###r####--S#
XXXXXXXXXXXXXXXXXXXXXXXXXXXXXXXXXXXXXXXXXXXXXXXXXXXXXXXXXXXXXXXXXXXXXXXXXXXXXXXX--XXXXXXXXXXXXXXXXXXXXXXXXXXXXXXXXXXXXXXXXXX---XXXXXXXXXXX-------XXXXXXXX--XX
XXXXXXXXXXXXXXXXXXXXXXXXXXXXXXXXXXXXXXXXXXXXXXXXXXXXXXXXXXXXXXXXXXXXXXXXXXXXXXXX--XXXXXXXXXXXXXXXXXXXXXXXXXXXXXXXXXXXXXXXXXX---XXXXXXXXXXX-------XXXXXXXX--XX
