-------------------------------------------------------------------------------------------------------------------------------------------------------------
-------------------------------------------------------------------------------------------------------------------------------------------------------------
-------------------------------------------------------------------------------------------------------------------------------------------------------------
SSSSSSSSSSSSSSSSSSSSSSSSSSSS---SSSSSSSSSSSSSSSSSSSSSSSSSSSSSSSSSSSSSSSSSSSSSSSSS--SSSSSSSSSSSSSSSSSSSSSSSSSSSSSSSSSSSSSSSSSSSSSSSSSSSSSSSSSSSSSSSSSSSSSS-SSSS
SSSS--SSSS-------------------------SSSSSS--SSSSSS--SSSSSSS--SSSS------SSSSSSSSSS----SSSSS--SSSS---SSSSSS--SSSS-----------------SSSSSS--SS--------------------
SSSS--SSSS-------------------------SSSSSS--SSSSSS--SSSSSSS--SSSS------SSSSSSSSSS----SSSSS--SSSS---SSSSSS--SSSS-----------------SSSSSS--SS--------------------
--SS---S----S--------------------------SS---S--SS---S---SS---S----SS------SS-SS--------SS---S----S----SS---S-----------------------SS---S--------------------
--SS---S----S--------------------------SS---S--SS---S---SS---S----SS------SS-SS--------SS---S----S----SS---S-----------------------SS---S--------------------
--SS---S----S--------------------------SS---S--SS---S---SS---S----SS------SS-SS--------SS---S----S----SS---S-----------------------SS---S--------------------
ooSS---SoU--S----------------------ooooSS---SoUSS---SoUoSS---SoU--SC----ooSSoSS-----oooSS---SoU--S-oooSS---SoU-----------------ooooSS---S--------------------
SSSS---SSS--S-------------TT-----##SSSSSS---SSSSS---SSSSSS---SSS--SS--SSSSSSSSSS----SSSSS---SSS--S-SSSSS---SSSTT---------------SSSSSS---S-------------##-----
--------------------TT----TT----###---------------------------------------------------------------------T-----TT-----------SS------------S-----------###---S-
--------------------TT----TT---####---------------------------------------------------------------------------TT----TT-----SS------------S----------####---SF
---M---------g------TT----TT---####----kk----------------k--------------ggg-----------------------------------TT----TT-----SS------------S---------#r###---S#
XXXXXXXXXXXXXXXXXXXXXXXXXXXXXXXXXXXXXXXXXXXXXXXXXXXXXXXXXXXXXXXXXXXXXXXXXXXXXXXX----XXXXXXXXXXXXXXXXXXXXXXXXXXXXXXXXXXXXX--XX-XXXXXXXXXXXX--XXXXXXXXXXXX---XX
XXXXXXXXXXXXXXXXXXXXXXXXXXXXXXXXXXXXXXXXXXXXXXXXXXXXXXXXXXXXXXXXXXXXXXXXXXXXXXXX----XXXXXXXXXXXXXXXXXXXXXXXXXXXXXXXXXXXXX--XX-XXXXXXXXXXXX--XXXXXXXXXXXX---XX
