-------------------------------------------------------------------------------------------------------------------------------------------------------------
-------------------------------------------------------------------------------------------------------------------------------------------------------------
-------------------------------------------------------------------------------------------------------------------------------------------------------------
SSSSSSSSSSSSSSSSSSSSSSSSSSSSSSSSSSSSSSSSSSSSSSSSSSSSSSSSSSSSSSSSSSSSSSSSSSSSSSSS--SSSSSSSSSSSSSSSSSSSSSSSSSSSSSSSSSSSSSSSSSSSSSSSSSSSLSSSS-------------------
--SS--SSSSSS--SSS----------------SSSSSSSSS-SSS--SS--SSSSSS--SSSSSSSSSSSSSS-SSSSS---SSSSSSSSSS--SSSS------SS--------------------------------------------------
--SS--SSSSSS--SSS----------------SSSSSSSSS-SSS--SS--SSSSSS--SSSSSSSSSSSSSS-SSSSS---SSSSSSSSSS--SSSS------SS--------------------------------------------------
SS--------SS---S--------------------SS--SS--SSSS--------SS---S---SSS----SS-----S----S----SSSS---S----SS-------------------------oooooo------SSS--------------
SS--------SS---S--------------------SS--SS--SSSS--------SS---S---SSS----SS-----S----S----SSSS---S----SS------------------------------------------------------
SS--------SS---S--------------------SS--SS--SSSS--------SS---S---SSS----SS-----S----S----SSSS---S----SS-------------------------SSSSSS-----------------------
SS----ooooSS---So----------------oooSSooSS-oSSSS----ooooSS---SoooSSSooooSS-ooooS----SoUooSSSS---SoU--SC-------------------------SSSSSS-----------SSSSSSU-----
SSSS--SSSSSS---SS---------TT-----SSSSSSSSS-SSSSSSS--SSSSSS---SSSSSSSSSSSSS-SSSSS----SSSSSSSSS---SSS--SS--SS---TT------------------------##-------------------
--SS----------------TT----TT----#---------------SS------------------------------------------------------T-----TT-----------SS----------###-------------------
--SS----------------TT----TT---##---------------SS------------------------------------------------------------TT----TT-----SS---------####--SSS-------------F
---M---------g------TT----TT---##------kk----------------k--------------ggg-----------------------------------TT----TT-----SS---------####----------r-------#
XXXXXXXXXXXXXXXXXXXXXXXXXXXXXXXXXXXXXXXXXXXXXXXXXXXXXXXXXXXXXXXXXXXXXXXXXXXXXXXX--XXXXXXXXXXXXXXXXXXXXXXXXXXXXXXXXXXXXXXX--XX--XXXXXXXXXXX-------XXXXXXXX--X-
XXXXXXXXXXXXXXXXXXXXXXXXXXXXXXXXXXXXXXXXXXXXXXXXXXXXXXXXXXXXXXXXXXXXXXXXXXXXXXXX--XXXXXXXXXXXXXXXXXXXXXXXXXXXXXXXXXXXXXXX--XX--XXXXXXXXXXX-------XXXXXXXX--XX
