-------------------------------------------------------------------------------------------------------------------------------------------------------------
-------------------------------------------------------------------------------------------------------------------------------------------------------------
-------------------------------------------------------------------------------------------------------------------------------------------------------------
SSSSSSSSSSSSSSSSSSSSSSSSSSSSSSSSSSSSSSSSSSSSSSSSSSSSSSSSSSSSSSSSSSSSSSSSSSSSSSSS--SSSSSSSSSSSSSSSSSSSSSSSSSSSSSSSSSSSSSSSSSSSSSSSSSSSSSSSS-----SSSSSSSSSS----
SSSS--SSSSSS--SSSS--------------------SS-SSSSSS--SSSSSSSS--SSSSSSSS--SSSS--SSSS----SSSSSS--SSSSSS--S---------------------SSSS--------------------------------
SSSS--SSSSSS--SSSS--------------------SS-SSSSSS--SSSSSSSS--SSSSSSSS--SSSS--SSSS----SSSSSS--SSSSSS--S---------------------SSSS--------------------------------
-SS-------SS---S-----------------------S-----SS---S----SS---S----SS---SSS---S----------SS---S--SS--------------------SS----------ooo--------SSS------------SS
-SS-------SS---S-----------------------S-----SS---S----SS---S----SS---SSS---S----------SS---S--SS--------------------SS--------------------------------------
-SS-------SS---S-----------------------S-----SS---S----SS---S----SS---SSS---S----------SS---S--SS--------------------SS----------SSS-------------------------
oSS---ooooSS---SoU---------------------S-ooooSS---SoUooSS---SooooSS---SSS---SoU----ooooSS---SoUSS--------------------SC----------SSS-------------------------
SSSS--SSSSSS---SSS--------TT-----------S-SSSSSS---SSSSSSS---SSSSSSS---SSS---SSS----SSSSSS---SSSSS-------------TT-----SS--SSSS-----------##---------##--##----
---S----------------TT----TT----------------------------------------------------------------------------TT----TT-----------------------###--------###-###----
---S----------------TT----TT----TT----------------------------------------------------------------------TT----TT----------------------####--SSS--########--SF
---M---------g------TT----TT----TT-----kk----------------k--------------ggg-----------------------------TT----TT----T----------------#####------####r####---#
XXXXXXXXXXXXXXXXXXXXXXXXXXXXXXXXXXXXXXXXXXXXXXXXXXXXXXXXXXXXXXXXXXXXXXXXXXXXXXXX--XXXXXXXXXXXXXXXXXXXXXXXXXXXXXXXXXXXXXXXXXXX---XXXXXXXXXX-----XXXXXXXXXX----
XXXXXXXXXXXXXXXXXXXXXXXXXXXXXXXXXXXXXXXXXXXXXXXXXXXXXXXXXXXXXXXXXXXXXXXXXXXXXXXX--XXXXXXXXXXXXXXXXXXXXXXXXXXXXXXXXXXXXXXXXXXX---XXXXXXXXXX-----XXXXXXXXXX----
