-------------------------------------------------------------------------------------------------------------------------------------------------------------
-------------------------------------------------------------------------------------------------------------------------------------------------------------
-------------------------------------------------------------------------------------------------------------------------------------------------------------
SSSSSSSSSSSSSSSSSSSSSSSSSSSSSSSSSSSSSSSSSSSSSSSSSSSSSSSSSSSSSSSSSSSSSSSSSSSSSSSS--SSSSSSSSSSSSSSSSSSSSSSSSSSSSSSSSSSSSSSSSSSSSSSSSSSSLSSSSSSSSSSSSSSSSSS-SSSS
SSSS--SSSS-S--SS--------------------SS--SSSS-----SSSSSSSS--SSSS--SSS--SSS--SSSSS---SSSSSSSSSS--SSSS---------------------SSSS---------------------------------
SSSS--SSSS-S--SS--------------------SS--SSSS-----SSSSSSSS--SSSS--SSS--SSS--SSSSS---SSSSSSSSSS--SSSS---------------------SSSS---------------------------------
--SS---S---S---S--------------------SS---S----SS-SS----SS---S-----SS---S-------S----S------SS---S----S--------------------------oooooo-----------------------
--SS---S---S---S--------------------SS---S----SS-SS----SS---S-----SS---S-------S----S------SS---S----S-------------------------------------------------------
--SS---S---S---S--------------------SS---S----SS-SS----SS---S-----SS---S-------S----S------SS---S----S--------------------------SSSSSS-----------------------
ooSS---SoU-S---S--------------------SS---SoU--SC-SSooooSS---SoU--oSS---So--ooooS----SoUooooSS---SoU--S--------------------------SSSSSS-----------------------
SSSS---SSS-S---S----------TT--------SS---SSS--SS-SSSSSSSS---SSS--SSS---SS--SSSSS----SSSSSSSSS---SSS--S--------TT--------SSSS------------#-------------##-----
--------------------TT----TT----TT----------------------------------------------------------------------TT----TT-----------------------##S-----------###---SS
--------------------TT----TT----TT----------------------------------------------------------------------TT----TT----TT----------------###S----------####---SF
---M---------g------TT----TT----TT-----kk----------------k--------------ggg-----------------------------TT----TT----TT----------------###S---------#r###---S#
XXXXXXXXXXXXXXXXXXXXXXXXXXXXXXXXXXXXXXXXXXXXXXXXXXXXXXXXXXXXXXXXXXXXXXXXXXXXXXXX--XXXXXXXXXXXXXXXXXXXXXXXXXXXXXXXXXXXXXXXXXX---XXXXXXXXXXX--XXXXXXXXXXXX---XX
XXXXXXXXXXXXXXXXXXXXXXXXXXXXXXXXXXXXXXXXXXXXXXXXXXXXXXXXXXXXXXXXXXXXXXXXXXXXXXXX--XXXXXXXXXXXXXXXXXXXXXXXXXXXXXXXXXXXXXXXXXX---XXXXXXXXXXX--XXXXXXXXXXXX---XX
