-------------------------------------------------------------------------------------------------------------------------------------------------------------
-------------------------------------------------------------------------------------------------------------------------------------------------------------
-------------------------------------------------------------------------------------------------------------------------------------------------------------
SSSSSSSSSSSSSSSSSSSSSSSSSSSSSSSSSSSSSSSSSSSSSSSSSSSSSSSSSSSSSSSSSSSSSSSSSSSSSSSS--SSSSSSSSSSSSSSSSSSSSSSSSSSSSSSSSSSSSSSSSSSSSSSSSSSSSSSSS-SSSSSSSSSSSSSS-SSS
--SS--SSSSSS--SSS------------------SS-S-SSSSSS--SS-SSSSSSSSSSS--SSSSSSSSS--SSSS-----SSSSSSSSSS--SSSS---------------SSSS--------------------SSS---------------
--SS--SSSSSS--SSS------------------SS-S-SSSSSS--SS-SSSSSSSSSSS--SSSSSSSSS--SSSS-----SSSSSSSSSS--SSSS---------------SSSS--------------------SSS---------------
SS--------SS---S-------------------SS-------SS---S-----SS---SS---S-----SS---S--------S--SS--SS---S-------------SS--------------------------------------------
SS--------SS---S-------------------SS-------SS---S-----SS---SS---S-----SS---S--------S--SS--SS---S-------------SS--------------------------------------------
SS--------SS---S-------------------SS-------SS---S-----SS---SS---S-----SS---S--------S--SS--SS---S-------------SS--------------------------------------------
SS----ooooSS---So------------------SS---ooooSS---S-ooooSSoooSS---SoUoooSS---SoU------SoUSSooSS---SoU-----------SC--------------------------------------------
SSSS--SSSSSS---SS---------TT-----##SS---SSSSSS---S-SSSSSSSSSSS---SSSSSSSS---SSS------SSSSSSSSS---SSS----------TSS--SSSS-----------------##-SSS---------##----
--SS----------------TT----TT----###---------------------------------------------------------------------TT----T------------S-----------###------------###--SS
--SS----------------TT----TT---####---------------------------------------------------------------------TT----T------------S----------####-----------####--SF
---M---------g------TT----TT---####----kk----------------k--------------ggg-----------------------------TT----T-----T------S---------#####----------r####--S#
XXXXXXXXXXXXXXXXXXXXXXXXXXXXXXXXXXXXXXXXXXXXXXXXXXXXXXXXXXXXXXXXXXXXXXXXXXXXXXXX--XXXXXXXXXXXXXXXXXXXXXXXXXXXXXXXXXXXXX---XX--XXXXXXXXXXXX-XXX---XXXXXXXX--XX
XXXXXXXXXXXXXXXXXXXXXXXXXXXXXXXXXXXXXXXXXXXXXXXXXXXXXXXXXXXXXXXXXXXXXXXXXXXXXXXX--XXXXXXXXXXXXXXXXXXXXXXXXXXXXXXXXXXXXX---XX--XXXXXXXXXXXX-XXX---XXXXXXXX--XX
