-------------------------------------------------------------------------------------------------------------------------------------------------------------
-------------------------------------------------------------------------------------------------------------------------------------------------------------
-------------------------------------------------------------------------------------------------------------------------------------------------------------
SSSSSSSSSSSSSSSSSSSSSSSSSSSSSSSSSSSSSSSSSSSSSSSSSSSSSSSSSSSSSSSSSSSSSSSSSSSSSSSS--SSSSSSSSSSSSSSSSSSSSSSSSSSSSSSSSSSSSSSSSSSSSSSSSSSSSSSSSSSSSSSSSSSSSSSS----
--SS--SSSSSS--SSSS--SS----------SS--SSSSSS--SSSS-S-SSSSSS--SSSS-SSSS--SSSS-----S---SSSSSSSSSS--SS-------------------------------------SSSS-SSS---------------
--SS--SSSSSS--SSSS--SS----------SS--SSSSSS--SSSS-S-SSSSSS--SSSS-SSSS--SSSS-----S---SSSSSSSSSS--SS-------------------------------------SSSS-SSS---------------
SS--------SS---S-S---S------------------SS---S---S-----SS---SSS-S-SS---S----SS-S----S--SS--SS---S---------------------------------SS-----------------------SS
SS--------SS---S-S---S------------------SS---S---S-----SS---SSS-S-SS---S----SS-S----S--SS--SS---S---------------------------------SS-------------------------
SS--------SS---S-S---S------------------SS---S---S-----SS---SSS-S-SS---S----SS-S----S--SS--SS---S---------------------------------SS-------------------------
SS----ooooSS---SoS---S--------------ooooSS---SoU-S-ooooSS---SSS-SoSS---SoU--SC-S----SoUSSooSS---S---------------------------------SC-------------------------
SSSS--SSSSSS---SSS---S---TT-----SS--SSSSSS---SSS-S-SSSSSS---SSS-SSSS---SSS--SS-S----SSSSSSSSS---S-------------TT------------------SS--SSSS-SSS---------##----
--SS---------------------TT-----SS----------------------------------------------------------------------TT----TT-----------SS-------------------------###----
--SS---------------------TT----TSS----------------------------------------------------------------------TT----TT----TT-----SS------------------------####--SF
---M---------g-----------TT----T-------kk----------------k--------------ggg-----------------------------TT----TT----TT-----SS-----------------------r####---#
XXXXXXXXXXXXXXXXXXXXXXXXXXXXXXXXXXXXXXXXXXXXXXXXXXXXXXXXXXXXXXXXXXXXXXXXXXXXXXXX--XXXXXXXXXXXXXXXXXXXXXXXXXXXXXXXXXXXXXXX--XX--XXXXXXXXXXX-XXX---XXXXXXXX----
XXXXXXXXXXXXXXXXXXXXXXXXXXXXXXXXXXXXXXXXXXXXXXXXXXXXXXXXXXXXXXXXXXXXXXXXXXXXXXXX--XXXXXXXXXXXXXXXXXXXXXXXXXXXXXXXXXXXXXXX--XX--XXXXXXXXXXX-XXX---XXXXXXXX----
