-------------------------------------------------------------------------------------------------------------------------------------------------------------
-------------------------------------------------------------------------------------------------------------------------------------------------------------
-------------------------------------------------------------------------------------------------------------------------------------------------------------
SSSSSSSSSSSSSSSSSSSSSSSSSSSSSSSSSSSSSSSSSSSSSSSSSSSSSSSSSSSSSSSSSSSSSSSSSSSSSSSS--SSSSSSSLSSSSSSSSSSSSSSSSSSSSSSSSSSSSSSSSSSSSSSSSSSSSSSSSSSSSSSSSSSSSSSSSSSS
--SS--SSSSSS--SS-----------------S--SSSSSS--SSS-SS--SSSSSS--SSSSSSS--SSSS---SSSS-----------SSSSSS--SSSS-----------------SSSS----SSSSS--SSSSS-----------------
--SS--SSSSSS--SS-----------------S--SSSSSS--SSS-SS--SSSSSS--SSSSSSS--SSSS---SSSS-----------SSSSSS--SSSS-----------------SSSS----SSSSS--SSSSS-----------------
SS--------SS---S------------------------SS---S-S--------SS---S---SS---S----S--------oooooo-----SS---S------------------------------SS------------------------
SS--------SS---S------------------------SS---S-S--------SS---S---SS---S----S-------------------SS---S------------------------------SS------------------------
SS--------SS---S------------------------SS---S-S--------SS---S---SS---S----S--------SSSSSS-----SS---S------------------------------SS------------------------
SS----ooooSS---S--------------------ooooSS---SoS----ooooSS---SoUoSS---SoU--S--------SSSSSS-ooooSS---SoU-------------------------oooSS--------------------C---
SSSS--SSSSSS---S------##-TT------S--SSSSSS---SSSSS--SSSSSS---SSSSSS---SSS--SSSSS-----------SSSSSS---SSS-------TT--------SSSS----SSSSS---SSSS-------#-#-------
--SS-----------------###-TT------S--------------SS------------------------------------------------------TT----TT---------------------------------#-#-#-#---#-
--SS----------------####-TT----TTS--------------SS------------------------------------------------------TT----TT----TT---------------------------#-#-#-#---#F
---M---------g-----#####-TT----TT------kk----------------k--------------ggg-----------------------------TT----TT----TT---------------------------#-#r#-#-E-##
XXXXXXXXXXXXXXXXXXXXXXXXXXXXXXXXXXXXXXXXXXXXXXXXXXXXXXXXXXXXXXXXXXXXXXXXXXXXXXXX---XXXXXXXXXXXXXXXXXXXXXXXXXXXXXXXXXXXXXXXXX---XXXXXXXXXXXXX---XXXXXXXXXXXXXX
XXXXXXXXXXXXXXXXXXXXXXXXXXXXXXXXXXXXXXXXXXXXXXXXXXXXXXXXXXXXXXXXXXXXXXXXXXXXXXXX---XXXXXXXXXXXXXXXXXXXXXXXXXXXXXXXXXXXXXXXXX---XXXXXXXXXXXXX---XXXXXXXXXXXXXX
