-------------------------------------------------------------------------------------------------------------------------------------------------------------
-------------------------------------------------------------------------------------------------------------------------------------------------------------
-------------------------------------------------------------------------------------------------------------------------------------------------------------
SSSSSSSSSSSSSSSSSSSSSSSSSSSSSSSSSSSSSSSSSSSSSSSSSSSSSSSSSSSSSSSSSSSSSSSSSSSSSSSS--SSSSSSSSSSSSSSSSSSSSSSSSSSSSSSSSSSSSSSSSSSSSSSSSSSSSSSSSSSSSSSSSSSSSSSS--SS
--SS--SSSSSS--SSSS--------------SSSSS--SS--SSSS----SSSSSS--SSSS-SSSSSSSSS--SSSS------SSSS--SSSS----------------------SSS--SSS--SSSSSS--SSSSSS----------------
--SS--SSSSSS--SSSS--------------SSSSS--SS--SSSS----SSSSSS--SSSS-SSSSSSSSS--SSSS------SSSS--SSSS----------------------SSS--SSS--SSSSSS--SSSSSS----------------
SS--------SS---SSS-----------------SS--SS---S----------SS---S---SSS----SS---S----------SS---S-------------------------SS---S-------SS---S--------------------
SS--------SS---SSS-----------------SS--SS---S----------SS---S---SSS----SS---S----------SS---S-------------------------SS---S-------SS---S--------------------
SS--------SS---SSS-----------------SS--SS---S----------SS---S---SSS----SS---S----------SS---S-------------------------SS---S-------SS---S--------------------
SS----ooooSS---SSS--------------oooSS--SS---SoU----ooooSS---SoU-SSSooooSS---SoU------ooSS---SoU----------------------oSS---So--ooooSS---S--------------------
SSSS--SSSSSS---SSS--------TT----SSSSS--SS---SSS----SSSSSS---SSS-SSSSSSSSS---SSS------SSSS---SSS---------------TT-----SSS---SS--SSSSSS---SSSSS----------##----
--SS----------------TT----TT--------------------------------------------------------S-------------------TT----TT--------------------------------------###----
--SS----------------TT----TT--------------------------------------------------------S-------------------TT----TT----T--------------------------------####--TF
---M---------g------TT----TT-----------kk----------------k--------------ggg---------S-------------------TT----TT----T-------------------------------r####--T#
XXXXXXXXXXXXXXXXXXXXXXXXXXXXXXXXXXXXXXXXXXXXXXXXXXXXXXXXXXXXXXXXXXXXXXXXXXXXXXXX----XXXXXXXXXXXXXXXXXXXXXXXXXXXXXXXXXXXXXXXXXXXXXXXXXXXXXXXXX---XXXXXXXXX--XX
XXXXXXXXXXXXXXXXXXXXXXXXXXXXXXXXXXXXXXXXXXXXXXXXXXXXXXXXXXXXXXXXXXXXXXXXXXXXXXXX----XXXXXXXXXXXXXXXXXXXXXXXXXXXXXXXXXXXXXXXXXXXXXXXXXXXXXXXXX---XXXXXXXXX--XX
