-------------------------------------------------------------------------------------------------------------------------------------------------------------
-------------------------------------------------------------------------------------------------------------------------------------------------------------
-------------------------------------------------------------------------------------------------------------------------------------------------------------
SSSSSSSSSSSSSSSSSSSSSSSSSSSSSSSSSSSSSSSSSSSSSSSSSSSSSSSSSSSSSSSSSSSSSSSSSSSSSSSS--SSSSSSSSSSSSSSSSSSSSSSSSSSSSSSSSSSSSSSSSSSSSSSSSSSSSSSSS------SSSSSSSSSSSSS
SSSS--SSSS----S-------------------SSSSSSSS--SSSS---SSSSSS--SSSS-SSSS--SSSSSSSS-----SSSSSS--SSSSSSS--SSS-------------SSSS--SSSS-SSSSSS--S---------------------
SSSS--SSSS----S-------------------SSSSSSSS--SSSS---SSSSSS--SSSS-SSSS--SSSSSSSS-----SSSSSS--SSSSSSS--SSS-------------SSSS--SSSS-SSSSSS--S---------------------
S-SS---S----SSS--------------------SSS--SS---S---------SS---S---SSSS---S----SS---------SS---S---SS---S----------------SS---S-------SS-------SSS--------------
S-SS---S----SSS--------------------SSS--SS---S---------SS---S---SSSS---S----SS---------SS---S---SS---S----------------SS---S-------SS------------------------
S-SS---S----SSS--------------------SSS--SS---S---------SS---S---SSSS---S----SS---------SS---S---SS---S----------------SS---S-------SS------------------------
SoSS---SoU--SCS-------------------oSSSooSS---SoU---ooooSS---SoU-SSSS---SooooSS-----ooooSS---SoooSS---So-------------ooSS---SoU-ooooSS--------------------C---
SSSS---SSS--SSS-----------TT-----#SSSSSSSS---SSS---SSSSSS---SSS-SSSS---SSSSSSS-----SSSSSS---SSSSSS---SS-------TT----SSSS---SSS-SSSSSS---##---------#-#-------
S-------------------TT----TT----##----------------------------------------------------------------------TT----TT------------------------##-------#-#-#-#---#-
S-------------------TT----TT---###----------------------------------------------------------------------TT----TT------------------------##--SSS--#-#-#-#---#F
S--M---------g------TT----TT--####-----kk----------------k--------------ggg-----------------------------TT----TT----T-------------------##-------#-#r#-#-E-##
XXXXXXXXXXXXXXXXXXXXXXXXXXXXXXXXXXXXXXXXXXXXXXXXXXXXXXXXXXXXXXXXXXXXXXXXXXXXXXXX--XXXXXXXXXXXXXXXXXXXXXXXXXXXXXXXXXXXXXXXXXXXXXXXXXXXXXXXX------XXXXXXXXXXXXX
XXXXXXXXXXXXXXXXXXXXXXXXXXXXXXXXXXXXXXXXXXXXXXXXXXXXXXXXXXXXXXXXXXXXXXXXXXXXXXXX--XXXXXXXXXXXXXXXXXXXXXXXXXXXXXXXXXXXXXXXXXXXXXXXXXXXXXXXX------XXXXXXXXXXXXX
