-------------------------------------------------------------------------------------------------------------------------------------------------------------
-------------------------------------------------------------------------------------------------------------------------------------------------------------
-------------------------------------------------------------------------------------------------------------------------------------------------------------
SSSSSSSSSSSSSSSSSSSSSSSSSSSSSSSSSSSSSSSSSSSSSSSSSSSSSSSSSSSSSSSSSSSSSSSSSSSSSSSS--SSSSSSSSSSSSSSLSSSSSSSSSSSSSSSSSSSSSSSSSSSSSSSSSSSSSSSSSSSSSSSSSSSSSSSS----
SSSSSS-SSSSSS--------------------------SSSSSSSS--SSSSSSSS--SSSS--SSS--SSSSSSSSSS--SSSSSSSSSSSS---------------------SSSS---------SS----SSSS-------------------
SSSSSS-SSSSSS--------------------------SSSSSSSS--SSSSSSSS--SSSS--SSS--SSSSSSSSSS--SSSSSSSSSSSS---------------------SSSS---------SS----SSSS-------------------
---SSS-----SS---------------------------SS---SS---S----SS---S-----SS---S----SSSS-------SS---SSooo--------------SS----------------SSS----------o------------SS
---SSS-----SS---------------------------SS---SS---S----SS---S-----SS---S----SSSS-------SS---SS-----------------SS----------------SSS-------------------------
---SSS-----SS---------------------------SS---SS---S----SS---S-----SS---S----SSSS-------SS---SSSSS--------------SS----------------SSS----------S--------------
oooSSS-ooooSS--------------------------oSSoooSS---SooooSS---SoU--oSS---SoUooSSSS---ooooSSoooSSSSS--------------SC----------------SSC----------S--------------
SSSSSS-SSSSSS-------------TT-----------SSSSSSSS---SSSSSSS---SSS--SSS---SSSSSSSSS---SSSSSSSSSSS----------------TSS--SSSS----------SSS--SSSS---------##--##----
--------------------TT----TT-----TT---------------------------------------------------------------------T-----T------------S----------------------###-###----
--------------------TT----TT-----TT---------------------------------------------------------------------------T------------S---------------------########--SF
---M---------g------TT----TT-----TT----kk----------------k--------------ggg-----------------------------------T-----T------S--------------------####r####---#
XXXXXXXXXXXXXXXXXXXXXXXXXXXXXXXXXXXXXXXXXXXXXXXXXXXXXXXXXXXXXXXXXXXXXXXXXXXXXXXX--XXXXXXXXXXXXXXXXXXXXXXXXXXXXXXXXXXXXX---XX--XXXXXXXXXXXX---XXXXXXXXXXXX----
XXXXXXXXXXXXXXXXXXXXXXXXXXXXXXXXXXXXXXXXXXXXXXXXXXXXXXXXXXXXXXXXXXXXXXXXXXXXXXXX--XXXXXXXXXXXXXXXXXXXXXXXXXXXXXXXXXXXXX---XX--XXXXXXXXXXXX---XXXXXXXXXXXX----
