-------------------------------------------------------------------------------------------------------------------------------------------------------------
-------------------------------------------------------------------------------------------------------------------------------------------------------------
-------------------------------------------------------------------------------------------------------------------------------------------------------------
SSSSSSSSSSSSSSSSSSSSSSSSSSSSSSSSSSSSSSSSSSSSSSSSSSSSSSSSSSSSSSSSSSSSSSSSSSSSSSSS--SSSSSSSSSSSSSSSSSSSSSSSSSSSSSSS-SSSSSSSSSSSSSSSSSSSSSSSS----SSSSSSSSSSS--SS
--SS--SSSSSS--SS------------------SSSSSSS--SSS--SS--SSSSSS--SSS--SSSSSSSS-SSSSSS--SSSSSS--SSSS----------SSSS--------SSSSSSSS---------------------------------
--SS--SSSSSS--SS------------------SSSSSSS--SSS--SS--SSSSSS--SSS--SSSSSSSS-SSSSSS--SSSSSS--SSSS----------SSSS--------SSSSSSSS---------------------------------
SS--------SS---S--------------------SS-SS---S-SS--------SS---S-------SSSS-----SS---S--SS---S----SS--SS---------------S----------oooo--------SS---------------
SS--------SS---S--------------------SS-SS---S-SS--------SS---S-------SSSS-----SS---S--SS---S----SS--SS---------------S---------------------------------------
SS--------SS---S--------------------SS-SS---S-SS--------SS---S-------SSSS-----SS---S--SS---S----SS--SS---------------S----------SSSS-------------------------
SS----ooooSS---S------------------ooSSoSS---SoSS----ooooSS---So--ooooSSSS-ooooSS---SooSS---SoU--SC--SC---------------SoU--------SSSS-------------------------
SSSS--SSSSSS---S----------TT-----#SSSSSSS---SSSSSS--SSSSSS---SS--SSSSSSSS-SSSSSS---SSSSS---SSS--SS--SS--SSSS--TT-----SSSSSSS------------##-------------##----
--SS----------------TT----TT----##--------------SS------------------------------------------------------T-----TT-----------------------###------------###--TT
--SS----------------TT----TT---###--------------SS------------------------------------------------------------TT----------------------####--SS-------####--TF
---M---------g------TT----TT--####-----kk----------------k--------------ggg-----------------------------------TT----T----------------#####----------r####--T#
XXXXXXXXXXXXXXXXXXXXXXXXXXXXXXXXXXXXXXXXXXXXXXXXXXXXXXXXXXXXXXXXXXXXXXXXXXXXXXXX--XXXXXXXXXXXXXXXXXXXXXXXXXXXXXXXXXXXXXXXXXX---XXXXXXXXXXX----XXXXXXXXXXX--XX
XXXXXXXXXXXXXXXXXXXXXXXXXXXXXXXXXXXXXXXXXXXXXXXXXXXXXXXXXXXXXXXXXXXXXXXXXXXXXXXX--XXXXXXXXXXXXXXXXXXXXXXXXXXXXXXXXXXXXXXXXXX---XXXXXXXXXXX----XXXXXXXXXXX--XX
