-------------------------------------------------------------------------------------------------------------------------------------------------------------
-------------------------------------------------------------------------------------------------------------------------------------------------------------
-------------------------------------------------------------------------------------------------------------------------------------------------------------
SSSSSSSSSSSSSSSSSSSSSSSSSSSSSSSSSSSSSSSSSSSSSSSSSSSSSSSSSSSSSSSSSSSSSSSSSSSSSSSS--SSSSSSSLSSSSSSSSSSSSSSSSSSSSSSSSSSSSSSSSSSSSSSSSSSSSSSSSSSSSSSSSSSSSSSSSSSS
--SS--SSSSSS--SSS-----------------SS--SSSS----SSS--SSSSSSSSSSSS--SSSS-------SSSS----------SSSSSSSS--SSSS-----------------SSSS------S-------------------------
--SS--SSSSSS--SSS-----------------SS--SSSS----SSS--SSSSSSSSSSSS--SSSS-------SSSS----------SSSSSSSS--SSSS-----------------SSSS------S-------------------------
SS--------SS---S------------------SS---S----SS-SS---S--SS----SS---S----SSS----------oooooo---SS-SS---S----------------S----------ooS-------------------------
SS--------SS---S------------------SS---S----SS-SS---S--SS----SS---S----SSS-------------------SS-SS---S----------------S------------S-------------------------
SS--------SS---S------------------SS---S----SS-SS---S--SS----SS---S----SSS----------SSSSSS---SS-SS---S----------------S----------SSS-------------------------
SS----ooooSS---So-----------------SS---SoU--SCoSS---SoUSSooooSS---SoU--SCC----------SSSSSSoooSSoSS---SoU--------------C----------SSS-------------------------
SSSS--SSSSSS---SS--------##-----TTSS---SSS--SSSSS---SSSSSSSSSSS---SSS--SSS--SSSS----------SSSSSSSS---SSS------TT------S--SSSS------S----#-------------##-----
--SS--------------------###T----TT----------------------------------------------------------------------TT----TT-----------------------##S-----------###---SS
--SS-------------------####T----TT-----------------------------------------------------------------------T----TT----TT----------------###S----------####---SF
---M---------g--------#####T----TT-----kk----------------k--------------ggg------------------------------T----TT----TT---------------####S---------#r###---S#
XXXXXXXXXXXXXXXXXXXXXXXXXXXXXXXXXXXXXXXXXXXXXXXXXXXXXXXXXXXXXXXXXXXXXXXXXXXXXXXX---XXXXXXXXXXXXXXXXXXXXXXXXXXXXXXXXXXXXXXXXXX---XXXXXXXXXX--XXXXXXXXXXXXX--XX
XXXXXXXXXXXXXXXXXXXXXXXXXXXXXXXXXXXXXXXXXXXXXXXXXXXXXXXXXXXXXXXXXXXXXXXXXXXXXXXX---XXXXXXXXXXXXXXXXXXXXXXXXXXXXXXXXXXXXXXXXXX---XXXXXXXXXX--XXXXXXXXXXXXX--XX
