-------------------------------------------------------------------------------------------------------------------------------------------------------------
-------------------------------------------------------------------------------------------------------------------------------------------------------------
-------------------------------------------------------------------------------------------------------------------------------------------------------------
SSSSSSSSSSSSSSSSSSSSSSSSSSSSSSSSSSSSSSSSSSSSSSSSSSSSSSSSSSSSSSSSSSSSSSSSSSSSSSSS--SSSSSSSSSSSSSSSSSSSSSSSSSSSSSSSSSSSSSSSSSSSSSSSSSSSSSSSS------SSSSSSSSSSSSS
SSSS---SSSSSS-------------------------SSS--SSSS----SSSSSS--SSSSS-SSSSSSSS--SSSS------SSSSSS-SSSSSS--SSSS--SSS------------SSSS------SS------------------------
SSSS---SSSSSS-------------------------SSS--SSSS----SSSSSS--SSSSS-SSSSSSSS--SSSS------SSSSSS-SSSSSS--SSSS--SSS------------SSSS------SS------------------------
--SS-------SS--------------------------SS---S----------SS---S-SS-----SSSS---S-----S------SS-----SS---S---------------SS----------ooSS-------SSS--------------
--SS-------SS--------------------------SS---S----------SS---S-SS-----SSSS---S-----S------SS-----SS---S---------------SS------------SS------------------------
--SS-------SS--------------------------SS---S----------SS---S-SS-----SSSS---S-----S------SS-----SS---S---------------SS----------SSSS------------------------
ooSS---ooooSS-------------------------oSS---SoU----ooooSS---SoSS-ooooSSSS---SoU---C--ooooSS-ooooSS---SoU-------------SC----------SSSS--------------------C---
SSSS---SSSSSS----------##-------TT----SSS---SSS----SSSSSS---SSSS-SSSSSSSS---SSS---S--SSSSSS-SSSSSS---SSS--SSS-TT-----SS--SSSS------SS---##---------#-#-------
----------------------###-TT----TT----------------------------------------------------------------------T-----TT-----------------------###-------#-#-#-#---#-
---------------------####-TT----TT----------------------------------------------------------------------------TT----T------------------###--SSS--#-#-#-#---#F
---M---------g------#####-TT----TT-----kk----------------k--------------ggg-----------------------------------TT----T------------------###-------#-#r#-#-E-##
XXXXXXXXXXXXXXXXXXXXXXXXXXXXXXXXXXXXXXXXXXXXXXXXXXXXXXXXXXXXXXXXXXXXXXXXXXXXXXXX--XXXXXXXXXXXXXXXXXXXXXXXXXXXXXXXXXXXXXXXXXXX---XXXXXXXXXX------XXXXXXXXXXXXX
XXXXXXXXXXXXXXXXXXXXXXXXXXXXXXXXXXXXXXXXXXXXXXXXXXXXXXXXXXXXXXXXXXXXXXXXXXXXXXXX--XXXXXXXXXXXXXXXXXXXXXXXXXXXXXXXXXXXXXXXXXXX---XXXXXXXXXX------XXXXXXXXXXXXX
