-------------------------------------------------------------------------------------------------------------------------------------------------------------
-------------------------------------------------------------------------------------------------------------------------------------------------------------
-------------------------------------------------------------------------------------------------------------------------------------------------------------
SSSSSSSSSSSSSSSSSSSSSSSSSSSSSSSSSSSSSSSSSSSSSSSSSSSSSSSSSSSSSSSSSSSSSSSSSSSSSSSS--SSSSSSSSSSSSSSSSSSSSSSSSSSSSSSSSSSSSSSSSSSSSSSSSSSSLSSSSSSSSSSSSSSSSSSSSSSS
--SS--SSSSSS--SSSS--SSS---------SS--SSSSSS-SSSSS--SSSSSSS--SSSS---SS--SSSS-----S---SSSSSS--SSSSSSSS------SSSS------------------------------------------------
--SS--SSSSSS--SSSS--SSS---------SS--SSSSSS-SSSSS--SSSSSSS--SSSS---SS--SSSS-----S---SSSSSS--SSSSSSSS------SSSS------------------------------------------------
SS--------SS---SSS---S------------------SS--SSSS---S---SS---S----SSS---S----SS-------SSSS---S---S----SS-------------------------oooooo-----------------------
SS--------SS---SSS---S------------------SS--SSSS---S---SS---S----SSS---S----SS-------SSSS---S---S----SS------------------------------------------------------
SS--------SS---SSS---S------------------SS--SSSS---S---SS---S----SSS---S----SS-------SSSS---S---S----SS-------------------------SSSSSS-----------------------
SS----ooooSS---SSS---So-------------ooooSS-oSSSS---SoooSS---SoU--SSS---SoU--SC-----ooSSSS---SoU-SoU--SC-------------------------SSSSSS-----------------------
SSSS--SSSSSS---SSS---SS--TT-----SS--SSSSSS-SSSSS---SSSSSS---SSS--SSS---SSS--SS-S---SSSSSS---SSS-SSS--SS--SSSS-TT------------------------##-----------##------
--SS---------------------TT-----SS----------------------------------------------------------------------T-----TT-----------S-----------###----------###SS----
--SS---------------------TT----TSS----------------------------------------------------------------------------TT----TT-----S-----------###---------####SS---F
---M---------g-----------TT----T-------kk----------------k--------------ggg-----------------------------------TT----TT-----S-----------###--------##r##SS---#
XXXXXXXXXXXXXXXXXXXXXXXXXXXXXXXXXXXXXXXXXXXXXXXXXXXXXXXXXXXXXXXXXXXXXXXXXXXXXXXX---XXXXXXXXXXXXXXXXXXXXXXXXXX-XXXXXXXXXXX--X---XXXXXXXXXXX-XXXXXXXXXXXXXX--XX
XXXXXXXXXXXXXXXXXXXXXXXXXXXXXXXXXXXXXXXXXXXXXXXXXXXXXXXXXXXXXXXXXXXXXXXXXXXXXXXX---XXXXXXXXXXXXXXXXXXXXXXXXXX-XXXXXXXXXXX--X---XXXXXXXXXXX-XXXXXXXXXXXXXX--XX
