-------------------------------------------------------------------------------------------------------------------------------------------------------------
-------------------------------------------------------------------------------------------------------------------------------------------------------------
-------------------------------------------------------------------------------------------------------------------------------------------------------------
SSSSSSSSSSSSSSSSSSSSSSSSSSSS-SSSSSSSSSSSSSSSSSSSSSSSSSSSSSSSSSSSSSSSSSSSSSSSSSSS--SSSSSSSSSSSSSSSSSSSSSSSSSSSSSSSSSSSSSSSSSSSSSSSSSSSLSSSSSSSSSSSSSSSSSSSSSSS
--SS--SSSSSS--SSSS--SSS--------------SS--SSSSSS--SSSSSSSS--SSSS--SSSS------SSSSS---SSSSSSSSSS--SSS------SSSS------------SSSS-----------SSSSSS----------------
--SS--SSSSSS--SSSS--SSS--------------SS--SSSSSS--SSSSSSSS--SSSS--SSSS------SSSSS---SSSSSSSSSS--SSS------SSSS------------SSSS-----------SSSSSS----------------
SS--------SS----SS---S-------------SS--------SS---S----SS---SSS---S----SS------S----S------SS---S---SS--------------------------oooooo-----------------------
SS--------SS----SS---S-------------SS--------SS---S----SS---SSS---S----SS------S----S------SS---S---SS-------------------------------------------------------
SS--------SS----SS---S-------------SS--------SS---S----SS---SSS---S----SS------S----S------SS---S---SS--------------------------SSSSSS-----------------------
SS----ooooSS---oSS---So------------SS----ooooSS---SooooSS---SSS---SoU--SC---oooS----SoUooooSS---SU--SC--------------------------SSSSSS-------------------C---
SSSS--SSSSSS---SSS---SS---##-----#-SSSS--SSSSSS---SSSSSSS---SSS---SSS--SS--SSSSS----SSSSSSSSS---SS--SS--SSSS--TT--------SSSS-----------SSSSSS------#-#-------
--SS---------------------###----##---SS-----------------------------------------------------------------T-----TT-----------------------SS--------#-#-#-#---#-
--SS--------------------####---###---SS-----------------------------------------------------------------------TT----TT-----------------SS--------#-#-#-#---#F
---M---------g---------#####--####-----kk----------------k--------------ggg-----------------------------------TT----TT---------------------------#-#r#-#-E-##
XXXXXXXXXXXXXXXXXXXXXXXXXXXX-XXXXXXXXXXXXXXXXXXXXXXXXXXXXXXXXXXXXXXXXXXXXXXXXXXX--XXXXXXXXXXXXXXXXXXXXXXXXXXXXXXXXXXXXXXXXXX---XXXXXXXXXXXXXX---XXXXXXXXXXXXX
XXXXXXXXXXXXXXXXXXXXXXXXXXXX-XXXXXXXXXXXXXXXXXXXXXXXXXXXXXXXXXXXXXXXXXXXXXXXXXXX--XXXXXXXXXXXXXXXXXXXXXXXXXXXXXXXXXXXXXXXXXX---XXXXXXXXXXXXXX---XXXXXXXXXXXXX
