-------------------------------------------------------------------------------------------------------------------------------------------------------------
-------------------------------------------------------------------------------------------------------------------------------------------------------------
-------------------------------------------------------------------------------------------------------------------------------------------------------------
SSSSSSSSSSSSSSSSSSSSSSSSSSSSSSSSSSSSSSSSSSSSSSSSSSSSSSSSSSSSSSSSSSSSSSSSSSSSSSSS--SSSSSSSLSSSSSSSSSSSSSSSSSSSSSSSSSSSSSSSSSSSSSSSSSSSLSSSS----------SSSSS----
--SS--SSSSSS--SSSS------------------SS---SSSSSS--SSSSSSSS--SSSS-SSSSSSSSS---SSSS----------SSS--SSSS------------------SS-SSSS---------------------------------
--SS--SSSSSS--SSSS------------------SS---SSSSSS--SSSSSSSS--SSSS-SSSSSSSSS---SSSS----------SSS--SSSS------------------SS-SSSS---------------------------------
SS--------SS----SS------------------SS-------SS---S----SS---S------SS--SS-----------oooooo-SS---S----SS---------------S---------oooooo------SSS------------SS
SS--------SS----SS------------------SS-------SS---S----SS---S------SS--SS------------------SS---S----SS---------------S--------------------------------------
SS--------SS----SS------------------SS-------SS---S----SS---S------SS--SS-----------SSSSSS-SS---S----SS---------------S---------SSSSSS-----------------------
SS----ooooSS---oSS------------------SS---ooooSS---SooooSS---SoU-oooSSooSS-----------SSSSSSoSS---SoU--SC---------------S---------SSSSSS-----------SSS---------
SSSS--SSSSSS---SSS--------TT--------SS---SSSSSS---SSSSSSS---SSS-SSSSSSSSS---SSSS----------SSS---SSS--SS-------TT------S-SSSS------------##-------------##----
--SS----------------TT----TT----------------------------------------------------------------------------TT----TT-----------------------###------------###----
--SS----------------TT----TT----TT-----------------------------------------------------------------------T----TT----T------------------###--SSS------####--SF
---M---------g------TT----TT----TT-----kk----------------k--------------ggg------------------------------T----TT----T------------------###----------r####---#
XXXXXXXXXXXXXXXXXXXXXXXXXXXXXXXXXXXXXXXXXXXXXXXXXXXXXXXXXXXXXXXXXXXXXXXXXXXXXXXX---XXXXXXXXXXXXXXXXXXXXXXXXXXXXXXXXXXXXXXXXX---XXXXXXXXXXX-------XXXXXXXX----
XXXXXXXXXXXXXXXXXXXXXXXXXXXXXXXXXXXXXXXXXXXXXXXXXXXXXXXXXXXXXXXXXXXXXXXXXXXXXXXX---XXXXXXXXXXXXXXXXXXXXXXXXXXXXXXXXXXXXXXXXX---XXXXXXXXXXX-------XXXXXXXX----
