-------------------------------------------------------------------------------------------------------------------------------------------------------------
-------------------------------------------------------------------------------------------------------------------------------------------------------------
-------------------------------------------------------------------------------------------------------------------------------------------------------------
SSSSSSSSSSSSSSSSSSSSSSSSSSSSSSSSSSSSSSSSSSSSSSSSSSSSSSSSSSSSSSSSSSSSSSSSSSSSSSSS--SSSSSSSSSSSSSSSSSSSSSSSSSSSSSSSSSSSSSSSSSSSSSSSSSSSSSSSS-------------SSSSSS
SSSS--SSSSSS--SSSS------S---------------SSSSSS--SS--SSSSSS--SSSSSSSSSSSSS--SSSS-----SSSSSSSSSSSSS--SSS------SS-----------SSSS------SSS-----------------------
SSSS--SSSSSS--SSSS------S---------------SSSSSS--SS--SSSSSS--SSSSSSSSSSSSS--SSSS-----SSSSSSSSSSSSS--SSS------SS-----------SSSS------SSS-----------------------
--SS---S--SS---S----SS----------------------SSSS--------SS---S-S----SS-SS---S-----S-----SSS----SS---S-----------------S----------ooSSS------SSS--------------
--SS---S--SS---S----SS----------------------SSSS--------SS---S-S----SS-SS---S-----S-----SSS----SS---S-----------------S------------SSS-----------------------
--SS---S--SS---S----SS----------------------SSSS--------SS---S-S----SS-SS---S-----S-----SSS----SS---S-----------------S----------SSSSS-----------------------
ooSS---SooSS---SoU--SC------------------ooooSSSS----ooooSS---SoSooooSSoSS---SoU---C-ooooSSSooooSS---So----------------C----------SSSSS-----------SSSSSS------
SSSS---SSSSS---SSS--SS--STT-----TT------SSSSSSSSSS--SSSSSS---SSSSSSSSSSSS---SSS---S-SSSSSSSSSSSSS---SS------SSTT------S--SSSS------SSS--##-------------------
-------------------------TTT----TT--------------SS------------------------------------------------------T-----TT-----------------------###-------------SS----
-------------------------TTT----TT----TT--------SS------------------------------------------------------TT----TT----TT-----------------###--SSS--------SS---F
---M---------g-----------TTT----TT----Tkk----------------k--------------ggg-----------------------------TT----TT----TT-----------------###----------r--SS---#
XXXXXXXXXXXXXXXXXXXXXXXXXXXXXXXXXXXXXXXXXXXXXXXXXXXXXXXXXXXXXXXXXXXXXXXXXXXXXXXX--XXXXXXXXXXXXXXXXXXXXXXXXXXXXXXXXXXXXXXXXXXX---XXXXXXXXXX-------XXXXXXXX--XX
XXXXXXXXXXXXXXXXXXXXXXXXXXXXXXXXXXXXXXXXXXXXXXXXXXXXXXXXXXXXXXXXXXXXXXXXXXXXXXXX--XXXXXXXXXXXXXXXXXXXXXXXXXXXXXXXXXXXXXXXXXXX---XXXXXXXXXX-------XXXXXXXX--XX
