-------------------------------------------------------------------------------------------------------------------------------------------------------------
-------------------------------------------------------------------------------------------------------------------------------------------------------------
-------------------------------------------------------------------------------------------------------------------------------------------------------------
SSSSSSSSSSSSSSSSSSSSSSSSSSSSSSSSSSSSSSSSSSSSSSSSSSSSSSSSSSSSSSSSSSSSSSSSSSSSSSSS--SSSSSSSSSSSSSSSSSSSSSSSSSSSSSSSSSSSSSSSSSSSSSSSSSSSSSSSSSSSSSSSSSSSSSSS----
SSSS--SSSS-SSS--SS---------------------SSS--SSSS-SSSSSSSSS--SSSS-SSS--SSSS-SSSSS---SSSSSS--SSSSS--------------------SSSS-------------------------------------
SSSS--SSSS-SSS--SS---------------------SSS--SSSS-SSSSSSSSS--SSSS-SSS--SSSS-SSSSS---SSSSSS--SSSSS--------------------SSSS-------------------------------------
--SS---S----SS---S----------------------SS---S-----SS---SS---S----SS---S-------S----S--SS---S-SS-----------------------------------------------------------SS
--SS---S----SS---S----------------------SS---S-----SS---SS---S----SS---S-------S----S--SS---S-SS-------------------------------------------------------------
--SS---S----SS---S----------------------SS---S-----SS---SS---S----SS---S-------S----S--SS---S-SS-------------------------------------------------------------
ooSS---SoU-oSS---S---------------------oSS---SoU-ooSSoooSS---SoU-oSS---SoU-ooooS----SooSS---SoSS-------------------------------------------------------------
SSSS---SSS-SSS---S--------TT----TT-----SSS---SSS-SSSSSSSSS---SSS-SSS---SSS-SSSSS----SSSSS---SSSS--------------TTT---SSSS----------------##----------##-##----
--------------------TT----TT----TT----------------------------------------------------------------------TT----TTT----------S-----------###---------######----
--------------------TT----TT----TT----T-----------------------------------------------------------------TT----TTT----------S----------####--------#######--SF
---M---------g------TT----TT----TT----Tkk----------------k--------------ggg-----------------------------TT----TTT---T------S---------#####-------###r####---#
XXXXXXXXXXXXXXXXXXXXXXXXXXXXXXXXXXXXXXXXXXXXXXXXXXXXXXXXXXXXXXXXXXXXXXXXXXXXXXXX--XXXXXXXXXXXXXXXXXXXXXXXXXXXXXXXXXXXXXX---X--XXXXXXXXXXXXXXXXXXXXXXXXXXX----
XXXXXXXXXXXXXXXXXXXXXXXXXXXXXXXXXXXXXXXXXXXXXXXXXXXXXXXXXXXXXXXXXXXXXXXXXXXXXXXX--XXXXXXXXXXXXXXXXXXXXXXXXXXXXXXXXXXXXXX---X--XXXXXXXXXXXXXXXXXXXXXXXXXXX----
