-------------------------------------------------------------------------------------------------------------------------------------------------------------------------------------------------------
-------------------------------------------------------------------------------------------------------------------------------------------------------------------------------------------------------
-------------------------------------------------------------------------------------------------------------------------------------------------------------------------------------------------------
-------------------------------------------------------------------------------------------------------------------------------------------------------------------------------------------------------
-------------------------------------------------------------------------------------------------------------------------------------------------------------------------------------------------------
-------------------------------------------------------------------------------------------------------------------------------------------------------------------------------------------------------
--##----------------S!!S-----SSS----S!--------------##--------------------SSSSSS-SSSSSS-S---SSS!-SSSS----S!!S--SS----S!!S-SSS----S!!SSSSS-------------------------------SSSSSSSSSSSSS----------##------
-###-----------------------------------------------###--------------------------------------------------------------------------------------------------------------------------------------#-###------
####----------------------------------------------####------------------------------------------------------------------------------------------------------#------------------------------######------
####--------------------------------------#------#####-----------1----------g------------------------------------------------------------------------------##-----------------------------#######------
####-----------------SS---S----------S---##-----######----tt-------------S------S--------------C----------SS----------SS----------SS-----#--#----------###-##---------@S-----------------########------
####------------------------------------###----#######----tt-----------------------------------------------------------------------------#--##--------####-###--------------------------#########------
####-----------------------------------####tt-########----tt-----------------------------------------------------------------------------#--###------#####-####-----tt---------------tt##########-----F
###M----------------------------------#####tt#########gg--tt--------------------------------ggg----------k---------------g---------------#--####----######-#####----tt------g--------tt##########-----#
XXXXXXXXXXXXXXXXXXXXXXXXXXXXXXXXXXXXXXXXXXXXXXXXXXXXXXXXXXXXXXXXXXXXXX--XXXXXXXXXXXXXXX---XXXXXXXXXXXXXXXXXXXXXXXXXXXXXXXXXXXXXXXXXXXXXXXXXXXXXXXXXXXXXXXX-XXXXXXXXXXXXXXXXXXX-XXXXXXXXXXXXXXXXXXXXXXXX
XXXXXXXXXXXXXXXXXXXXXXXXXXXXXXXXXXXXXXXXXXXXXXXXXXXXXXXXXXXXXXXXXXXXXX--XXXXXXXXXXXXXXX---XXXXXXXXXXXXXXXXXXXXXXXXXXXXXXXXXXXXXXXXXXXXXXXXXXXXXXXXXXXXXXXX-XXXXXXXXXXXXXXXXXXX-XXXXXXXXXXXXXXXXXXXXXXXX
