-------------------------------------------------------------------------------------------------------------------------------------------------------------------------------------------------------
-------------------------------------------------------------------------------------------------------------------------------------------------------------------------------------------------------
-------------------------------------------------------------------------------------------------------------------------------------------------------------------------------------------------------
-------------------------------------------------------------------------------------------------------------------------------------------------------------------------------------------------------
-------------------------------------------------------------------------------------------------------------------------------------------------------------------------------------------------------
-------------------------------------------------------------------------------------------------------------------------------------------------------------------------------------------------------
--##----------------S!!SSSS!--------S---------------##---------SSSSSSS----SS-----SSSSSS-S-SSSS----S!!S--SSS!---SS!-------SSSSSSS------------------------------------SSS!------S!!S-------------##------
-###-----------------------------------------------###--------------------------------------------------------------------------------------------------------------------------------------#-###------
####----------------------------------------------####---------------------------------------------------------------------------------------#---------------------------------------------######------
####---------------------------------------------#####----------------------g---------------------------------------------------------------##--------------------------------------------#######------
####-----------------SS----C-----SU-------#-----######-----#------------------S@S------------------SS------C-----C----S@S------------------###----------##--#----------C-------SS--------########------
####-------------------------------------##----#######-----##-----------------------------------------------------------------------------####---------###--##--------------------------#########------
####------------------------------------###tt-########-----###------------------------------------------------------------------------tt-######-------####--###----------------------#-##########-----F
###M-----------------------------------####tt#########gg---####-----------------------------ggg----------k---------------g------------tt########-----#####--####------------g-------#############-----#
XXXXXXXXXXXXXXXXXXXXXXXXXXXXXXXXXXXXXXXXXXXXXXXXXXXXXXXXXXXXXXXXXXXXX---XXXXXXXXXXXXXXX---XXXXXXXXXXXXXXXXXXXXXXXXXXXXXXXXXXXXX-XXXXXXXXXXXXXXXXXXXXXXXXXX--XXXXXXXXXXXXXXXXXXXXXXXXXXXXXXXXXXXXXXXXXXX
XXXXXXXXXXXXXXXXXXXXXXXXXXXXXXXXXXXXXXXXXXXXXXXXXXXXXXXXXXXXXXXXXXXXX---XXXXXXXXXXXXXXX---XXXXXXXXXXXXXXXXXXXXXXXXXXXXXXXXXXXXX-XXXXXXXXXXXXXXXXXXXXXXXXXX--XXXXXXXXXXXXXXXXXXXXXXXXXXXXXXXXXXXXXXXXXXX
