-------------------------------------------------------------------------------------------------------------------------------------------------------------------------------------------------------
-------------------------------------------------------------------------------------------------------------------------------------------------------------------------------------------------------
-------------------------------------------------------------------------------------------------------------------------------------------------------------------------------------------------------
-------------------------------------------------------------------------------------------------------------------------------------------------------------------------------------------------------
-------------------------------------------------------------------------------------------------------------------------------------------------------------------------------------------------------
-------------------------------------------------------------------------------------------------------------------------------------------------------------------------------------------------------
--##-------------------SSSSS------------------------##---------------S----SS-----SSSSSS-S--SSS----S!!S---SSS----S!--------SSS----S!!S-----------------------------SSS----S!!S----------------#-##------
-###-----------------------------------------------###--------------------------------------------------------------------------------------------------------------------------------------#####------
####----------------------------------------------####-------------------------------------------------------------------------------------------------------------------------------------######------
####---------------------------------------------#####-------------1--------g-------------------------------------------------------------------------------------------------------------#######------
####----------------S@S-------------------tt----######------tt----------------S@S------------------SS------------S-----S----------SS------#-#----------##t-##-------------SS-------------########------
####-----------------------------------tt-tt---#######------tt---------------------------------------------------------------------------##-##--------###t-###--------------------------#########------
####-------------------------tt--------tt-tt--########------tt--------------------------------------------------------------------------###-###------####t-####---------------------tt-##########-----F
###M-------------------------tt--------tt-tt--########gg----tt------------------------------ggg----------k---------------g-------------####-####----#####t-#####------------g--#----tt###########-----#
XXXXXXXXXXXXXXXXXXXXXXXXXXXXXXXXXXXXXXXXXXXXXXXXXXXXXXXXXXXXXXXXXXXXX---XXXXXXXXXXXXXXX--XXXXXXXXXXXXXXXXXXXXXXXXXXXXXXXXXXXXXXXXXXXXXXXXXXXXXXXXXXXXXXXXX-XXXXXXXXXXXXXXXXXXXXXXXXXXXXXXXXXXXXXXXXXXXX
XXXXXXXXXXXXXXXXXXXXXXXXXXXXXXXXXXXXXXXXXXXXXXXXXXXXXXXXXXXXXXXXXXXXX---XXXXXXXXXXXXXXX--XXXXXXXXXXXXXXXXXXXXXXXXXXXXXXXXXXXXXXXXXXXXXXXXXXXXXXXXXXXXXXXXX-XXXXXXXXXXXXXXXXXXXXXXXXXXXXXXXXXXXXXXXXXXXX
