-------------------------------------------------------------------------------------------------------------------------------------------------------------------------------------------------------
-------------------------------------------------------------------------------------------------------------------------------------------------------------------------------------------------------
-------------------------------------------------------------------------------------------------------------------------------------------------------------------------------------------------------
-------------------------------------------------------------------------------------------------------------------------------------------------------------------------------------------------------
-------------------------------------------------------------------------------------------------------------------------------------------------------------------------------------------------------
-------------------------------------------------------------------------------------------------------------------------------------------------------------------------------------------------------
--##-----------S!!S-----SSSSSSS-----SSS-----------------------------SS-----SSS!--SSSSSS-S---SSS-SSS!--------SSSSS---SSS----SS----S!!S-----------SSS-------------SSSSSSSS---SSSSSSSSSS----------##------
-###------------------------------------------------------------------------------------------------------------------------------------------------------------------------------------------###------
####------------------------------------------------#----------------------------------------------------------------------------------------#---------------------------------------------#-####------
####------------------------------------------------#-----------------------g---------------------------------------------------------------##--------------------------------------------#######------
####------------SS---S@S---------S----------------###-------tt----------------C-S------------------C-----S@S-----S----------------SS-------###----------##-#-----------------------------########------
####------------------------------------#--------####t------tt---------------------------------------------------------------------------#####---------###-##---------------------------#########------
####------------------------------------##------#####t------tt--------------------------------------------------------------------------######--------####-###-----------------------t-##########-----F
###M------------------------------------###----######tgg----tt------------------------------ggg----------k---------------g-------------#######-------#####-####-------------g--------t###########-----#
XXXXXXXXXXXXXXXXXXXXXXXXXXXXXX-XXXXXXXXXXXXXXXXXXXXXXXXXXXXXXXXXXXXXX----XXXXXXXXXXXXXX---XXXXXXXXXXXXXXXXXXXXXXXXXXXXXXXXXXXXXXXXXXXXXXXXXXXXXXXXXXXXXXXX-XXXXXXXXXXX---XXXXXXXXXXX-XXXXXXXXXXXXXXXXXX
XXXXXXXXXXXXXXXXXXXXXXXXXXXXXX-XXXXXXXXXXXXXXXXXXXXXXXXXXXXXXXXXXXXXX----XXXXXXXXXXXXXX---XXXXXXXXXXXXXXXXXXXXXXXXXXXXXXXXXXXXXXXXXXXXXXXXXXXXXXXXXXXXXXXX-XXXXXXXXXXX---XXXXXXXXXXX-XXXXXXXXXXXXXXXXXX
