-------------------------------------------------------------------------------------------------------------------------------------------------------------------------------------------------------
-------------------------------------------------------------------------------------------------------------------------------------------------------------------------------------------------------
-------------------------------------------------------------------------------------------------------------------------------------------------------------------------------------------------------
-------------------------------------------------------------------------------------------------------------------------------------------------------------------------------------------------------
-------------------------------------------------------------------------------------------------------------------------------------------------------------------------------------------------------
-------------------------------------------------------------------------------------------------------------------------------------------------------------------------------------------------------
####-----SSS----S!!S-SSS----S!!S--------------------##------------SSSS-----SSS!-SSSSSSS----SSS----S!!S--------SSS----S!---SSS----S!!S-----------------------------SSS----S!!S----SS----------####------
####-----------------------------------------------###--------------------------------------------------------------------------------------------------------------------------------------#####------
####----------------------------------------------####-------------------------------------------------------------------------------------------------------------------------------------######------
####---------------------------------------------#####----------------------g-------------------------------------------------------------------------------------------------------------#######------
####-------------SS----------SS----------#------######----tt---S@S------------CS-------------------SS------S----------SS----------SS------###----------###--#-------------SS-------------########------
####------------------------------------##-----#######----tt-----------------------------------------------------------------------------#####--------####--##--------------------------#########------
####-----------------------------------###-tt-########----tt----------------------------------------------------------------------------#######------#####--###-----------------#---tt-##########-----F
###M----------------------------------####-tt#########gg--tt--------------------------------ggg----------k---------------g-------------#########----######--####------------g--##---tt###########-----#
XXXXXXXXXXXXXXXXXXXXXXXXXXXXXXXXXXXXXXXXXXXXXXXXXXXXXXXXXXXXXXXXXXXXXX---XXXXXXXXXXXXX---XXXXXXXXXXXXXXXXXXXXXXXXXXXXXXXXXXXXXXXXXXXXXXXXXXXXXXXXXXXXXXXXX--XXXXXXXXXXXXXXXXXXXXXXXXXXXXXXXXXXXXXXXXXXX
XXXXXXXXXXXXXXXXXXXXXXXXXXXXXXXXXXXXXXXXXXXXXXXXXXXXXXXXXXXXXXXXXXXXXX---XXXXXXXXXXXXX---XXXXXXXXXXXXXXXXXXXXXXXXXXXXXXXXXXXXXXXXXXXXXXXXXXXXXXXXXXXXXXXXX--XXXXXXXXXXXXXXXXXXXXXXXXXXXXXXXXXXXXXXXXXXX
