-------------------------------------------------------------------------------------------------------------------------------------------------------------------------------------------------------
-------------------------------------------------------------------------------------------------------------------------------------------------------------------------------------------------------
-------------------------------------------------------------------------------------------------------------------------------------------------------------------------------------------------------
-------------------------------------------------------------------------------------------------------------------------------------------------------------------------------------------------------
-------------------------------------------------------------------------------------------------------------------------------------------------------------------------------------------------------
-------------------------------------------------------------------------------------------------------------------------------------------------------------------------------------------------------
--##------------SSSSSS--SSSSSS---------------------##-----------SSSSSS-----SSS!!!SSSSSS-S---SSS!-----SSS----S!!S--SSSSSSSSS----S!S!!S---------------------------SSSSSSSS---SSS!S!!S-----------##----@--
-###----------------------------------------------###----------------------------------------------------------------------------------------------------------------------------------------###-------
####---------------------------------------------####---------------------------------------------------------------------------------------------------------------------------------------####-------
####--------------------------------------#------####-----------------------g--------------------------------------------------------------------------------------------------------------#####-------
####------------------@S-----------------##----tt####----------S--------------CSS--------------C-------------SS-@S--------------S-SS------#-#----------##--#---S--------------C-SS------#-######----!--
####------------------------------------###----tt####------------------------------------------------------------------------------------##-##--------###--##--------------------------#########-------
####--------------------------------tt-####----tt####-----------------------------------------------------------------------------------###-###------####--###------------------------##########------F
###M--------------------------------tt#####----tt####-gg------------------------------------ggg----------k---------------g-------------####-####----#####--####-------------g--------###########------#
XXXXXXXXXXXXXXXXXXXXXXXXXXXXXXXXXXXXXXXXXXXXXXXXXXXXXXXXXXXXXXXXXXXXXX---XXXXXXXXXXXXX----XXXXXXXXXXXXXXXXXXXXXXXXXXXXXXXXXXXXXXXXXXXXXXXXXXXXXXXXXXXXXXX--XXXXXXXXXXX---XXXXXXXXXXXXXXXXXXXXXXXXXXXXXX
XXXXXXXXXXXXXXXXXXXXXXXXXXXXXXXXXXXXXXXXXXXXXXXXXXXXXXXXXXXXXXXXXXXXXX---XXXXXXXXXXXXX----XXXXXXXXXXXXXXXXXXXXXXXXXXXXXXXXXXXXXXXXXXXXXXXXXXXXXXXXXXXXXXX--XXXXXXXXXXX---XXXXXXXXXXXXXXXXXXXXXXXXXXXXXX
