-------------------------------------------------------------------------------------------------------------------------------------------------------------------------------------------------------
-------------------------------------------------------------------------------------------------------------------------------------------------------------------------------------------------------
-------------------------------------------------------------------------------------------------------------------------------------------------------------------------------------------------------
-------------------------------------------------------------------------------------------------------------------------------------------------------------------------------------------------------
-------------------------------------------------------------------------------------------------------------------------------------------------------------------------------------------------------
-------------------------------------------------------------------------------------------------------------------------------------------------------------------------------------------------------
-##------SSS----S!!S-SSS----S!!S-----------------------------------SSS---S----S!!S-SSSS-S-SSSSS---S!!S---SSS----S!!S-----SSSSSSS####-------------SSSSS----------S----S!!SSSS----S!!S-----------##------
###-----------------------------------------------------------------------------------------------------------------------------####----------------------------------------------------------###------
###-----------------------------------------------------------------------------------------------------------------------------####-------------------------------------------------------#-####------
###-------------------------------------------------------------------------g---------------------------------------------------####------------------------------------------------------#######------
###---S----------SS----------SS-----------------tt---------tt------------------SS------------------SS------------SS---S@S-------####-----#--#-----------##--#---------SS---------SS------########------
###-------------------------------------tt------tt-tt------tt-------------------------------------------------------------------####----##--##---------###--##--------------------------#########------
###-------------------------------------tt------tt-tt------tt-------------------------------------------------------------------####---###--###-------####--###------------------------##########-----F
###M------------------------------------tt------tt-tt-gg---tt-------------------------------ggg---------#k---------------g------####--####--####------####--####------------g---------###########-----#
XXXXXXXXXXXXXXXXXXXXXXXXXXXXXXXXXXXXXXXXXXXXXXXXXXXXXXXXXXXXXXXXXXXXX---XXXXXXXXXXXXXXX---XXXXXXXXXXXXXXXXXXXXXXXXXXXXXXXXXXXXX-XXXXXXXXXXXXXXXXXXXXXXXXXX--XXXXXXXXXXXXXXXXXXXXXXXXXXXXXXXXXXXXXXXXXXX
XXXXXXXXXXXXXXXXXXXXXXXXXXXXXXXXXXXXXXXXXXXXXXXXXXXXXXXXXXXXXXXXXXXXX---XXXXXXXXXXXXXXX---XXXXXXXXXXXXXXXXXXXXXXXXXXXXXXXXXXXXX-XXXXXXXXXXXXXXXXXXXXXXXXXX--XXXXXXXXXXXXXXXXXXXXXXXXXXXXXXXXXXXXXXXXXXX
