-------------------------------------------------------------------------------------------------------------------------------------------------------------------------------------------------------
-------------------------------------------------------------------------------------------------------------------------------------------------------------------------------------------------------
-------------------------------------------------------------------------------------------------------------------------------------------------------------------------------------------------------
-------------------------------------------------------------------------------------------------------------------------------------------------------------------------------------------------------
-------------------------------------------------------------------------------------------------------------------------------------------------------------------------------------------------------
-------------------------------------------------------------------------------------------------------------------------------------------------------------------------------------------------------
--##---------SSS----S!SSS----S!!S-------------------##------------SSSS----SSS!-----SSSS-S---SSS!--SSS----S!!S--SSSS-SSS!----S----S!!S-----------SSSSSS-----------S----S!!SSS--S!!S------------##-------
-###-----------------------------------------------###---------------------------------------------------------------------------------------------------------------------------------------###-------
####----------------------------------------------####--------------------------------------------------------------------------------------------------------------------------------------####-------
####---------------------------------------------#####----------------------g--------------------------------------------------------------------------------------------------------------#####-------
####------S----------S--------SS----------##----######---------S@S-----------C-----------------C----------SS-----------C----------SS------#-#-----------##--#----------SS------SS---------######-------
####-------------------------------------###---#######-----------------------------------------------------------------------------------##-##---------###--##---------------------------#######-------
####------------------------------------####--########----------------------------------------------------------------------------------###-###-------####--###----------------------#t-########------F
###M-----------------------------------#####-#########gg------------------------------------ggg----------k---------------g-------------####-####------####--####------------g-------##t#########------#
XXXXXXXXXXXXXXXXXXXXXXXXXXXXXXXXXXXXXXXXXXXX-XXXXXXXXXXXXXXXXXXXXXXXX---XXXXXXXXXXXXXXX---XXXXXXXXXXXXXXXXXXXXXXXXXXXXXXXXXXXXXXXXXXXXXXXXXXXXXXXXXXXXXXXX--XXXXXXXXXXXXXXXXXXXXXXXXXXXXXXXXXXXXXXXXXXX
XXXXXXXXXXXXXXXXXXXXXXXXXXXXXXXXXXXXXXXXXXXX-XXXXXXXXXXXXXXXXXXXXXXXX---XXXXXXXXXXXXXXX---XXXXXXXXXXXXXXXXXXXXXXXXXXXXXXXXXXXXXXXXXXXXXXXXXXXXXXXXXXXXXXXX--XXXXXXXXXXXXXXXXXXXXXXXXXXXXXXXXXXXXXXXXXXX
