-------------------------------------------------------------------------------------------------------------------------------------------------------------------------------------------------------
-------------------------------------------------------------------------------------------------------------------------------------------------------------------------------------------------------
-------------------------------------------------------------------------------------------------------------------------------------------------------------------------------------------------------
-------------------------------------------------------------------------------------------------------------------------------------------------------------------------------------------------------
-------------------------------------------------------------------------------------------------------------------------------------------------------------------------------------------------------
-------------------------------------------------------------------------------------------------------------------------------------------------------------------------------------------------------
-##-----SSS----S!!S-S!!SS--SSS!--------------------------------------S----SSS!---SSSSSS-S---SSS!----SSSSSSS---SSS!-------SSSSSS--S!!S-------------------------------SSS!---------------------#-##------
###------------------------------------------------#----------------------------------------------------------------------------------------------------------------------------------------#####------
###-----------------------------------------------##---------------------------------------------------------------------------------------------------------------------------------------######------
###----------------------------------------------###------------------------g-------------------------------------------------------------------------------------------------------------#######------
###-------------SS---SS-------C----S------------####--------tt---------------C-----------------C-----------------C----S@S---------SS------#--#----------##-#-----------C--S!S------------########------
###--------------------------------------------#####tt------tt---------------------------------------------------------------------------##--##--------###-##---------------------------#########------
###----------------------------------------tt-######tt------tt--------------------------------------------------------------------------t##--###------####-###----------------------tt-##########-----F
###M---------------------------------------tt#######ttgg----tt------------------------------ggg----------k---------------g-------------#t##--####----#####-####-------------g-------tt###########-----#
XXXXXXXXXXXXXXXXXXXXXXXXXXXXXXXXXXXXXXXXXXXXXXXXXXXXXXXXXXXXXXXXXXXXX---XXXXXXXXXXXXXX----XXXXXXXXXXXXXXX---XXXXXXXXXXXXXXXXXXXXXXXXXXXXXXXXXXXXXXXXXXXXXX-XXXXXXXXXXXXXXXXXXXXXXXXXXXXXXXXXXXXXXXXXXXX
XXXXXXXXXXXXXXXXXXXXXXXXXXXXXXXXXXXXXXXXXXXXXXXXXXXXXXXXXXXXXXXXXXXXX---XXXXXXXXXXXXXX----XXXXXXXXXXXXXXX---XXXXXXXXXXXXXXXXXXXXXXXXXXXXXXXXXXXXXXXXXXXXXX-XXXXXXXXXXXXXXXXXXXXXXXXXXXXXXXXXXXXXXXXXXXX
