-------------------------------------------------------------------------------------------------------------------------------------------------------------------------------------------------------
-------------------------------------------------------------------------------------------------------------------------------------------------------------------------------------------------------
-------------------------------------------------------------------------------------------------------------------------------------------------------------------------------------------------------
-------------------------------------------------------------------------------------------------------------------------------------------------------------------------------------------------------
-------------------------------------------------------------------------------------------------------------------------------------------------------------------------------------------------------
-------------------------------------------------------------------------------------------------------------------------------------------------------------------------------------------------------
--##----SSSS--SSS----S!!S--------------------------##-------------SSSS--S--------SSSSSS-S--SSS----S!!S------SSSSSS---S!!S--SS----S!!S------------------------------SSSSSSSSS----S!!S----------##-------
-###----------------------------------------------###----------------------------------------------------------------------------------------------------------------------------------------###-------
####---------------------------------------------####-------------------------------------------------------------------------------------------------------------------------------------#-####-------
####--------------------------------------------#####-----------------------g-------------------------------------------------------------------------------------------------------------######-------
####------------------SS-----------------------######----------S@S------------S@S------------------SS-----@S----------SS----------SS------###----------##--#-----@S--------------SS------#######-------
####-----------------------------------tt------######------------------------------------------------------------------------------------#####--------###--##tt-------------------------########-------
####------------------------#tt--------tt------######----------------------------------------------------#------------------------------#######------####--##tt------------------------#########------F
###M-----------------------##tt--------tt------######-gg------------------------------------ggg---------#k---------------g-------------#########----#####--##tt-------------g---------##########------#
XXXXXXXXXXXXXXXXXXXXXXXXXXXXXXXXXXXXXXXXXXXXXXXXXXXXXXXXXXXXXXXXXXXXX---XXXXXXXXXXXXXXX---XXXXXXXXXXXXXXXXXXXXXXXXXXXXXXXXXXXXXXXXXXXXXXXXXXXXXXXXXXXXXXX--XXXXXXXXXXXXXXXXXXXXXXXXXXXXXXXXXXXXXXXXXXXX
XXXXXXXXXXXXXXXXXXXXXXXXXXXXXXXXXXXXXXXXXXXXXXXXXXXXXXXXXXXXXXXXXXXXX---XXXXXXXXXXXXXXX---XXXXXXXXXXXXXXXXXXXXXXXXXXXXXXXXXXXXXXXXXXXXXXXXXXXXXXXXXXXXXXX--XXXXXXXXXXXXXXXXXXXXXXXXXXXXXXXXXXXXXXXXXXXX
