-------------------------------------------------------------------------------------------------------------------------------------------------------------------------------------------------------
-------------------------------------------------------------------------------------------------------------------------------------------------------------------------------------------------------
-------------------------------------------------------------------------------------------------------------------------------------------------------------------------------------------------------
-------------------------------------------------------------------------------------------------------------------------------------------------------------------------------------------------------
-------------------------------------------------------------------------------------------------------------------------------------------------------------------------------------------------------
-------------------------------------------------------------------------------------------------------------------------------------------------------------------------------------------------------
---##------------SSSSSS-SSS!--------S---------------##------------SSSS----SSS!----SSSSS-S----SSSSSSSSS---S!!S-------SSS----S!!S--##--------------------------------SSSSSSSSS--S!!S------------##----!S-
--###----------------------------------------------###--------------------------------------------------------------------------###----------------------------------------------------------###-------
-####---------------------------------------------####--------------------------------------------------------------------------###---------------------------------------------------------####-------
#####--------------------------------------------#####----------------------g---------------------------------------------------###---------#----------------------------------------------#####-------
#####----------------------C-----SU-------#-----######---------S@S-----------C------------S@S-------------SS-----S----------SS--###--------###----------##--#------------------SS---------######----S--
#####------------------------------------##----#######--------------------------------------------------------------------------###-------####---------###--##------------------------#--#######-------
#####-----------------------------------###---########--------------------------------------------------------------------------###---tt-######-------####--###----------------------##-########------F
###M#----------------------------------####--#########gg------------------------------------ggg----------k-----#---------g------###---tt########-----#####--####------------g-------############------#
XXXXXXXXXXXXXXXXXXXXXXXXXXXXXXXXXXXXXXXXXXXXXXXXXXXXXXXXXXXXXXXXXXXXX---XXXXXXXXXXXXXXX---XXXXXXXXXXXXXXXXXXXXXXXXXXXXXXXXXXXXXXXXXXXXXXXXXXXXXXXXXXXXXXXX--XXXXXXXXXXXXXXXXXXXXXXXXXXXXXXXXXXXXXXXXXXX
XXXXXXXXXXXXXXXXXXXXXXXXXXXXXXXXXXXXXXXXXXXXXXXXXXXXXXXXXXXXXXXXXXXXX---XXXXXXXXXXXXXXX---XXXXXXXXXXXXXXXXXXXXXXXXXXXXXXXXXXXXXXXXXXXXXXXXXXXXXXXXXXXXXXXX--XXXXXXXXXXXXXXXXXXXXXXXXXXXXXXXXXXXXXXXXXXX
