-------------------------------------------------------------------------------------------------------------------------------------------------------------------------------------------------------
-------------------------------------------------------------------------------------------------------------------------------------------------------------------------------------------------------
-------------------------------------------------------------------------------------------------------------------------------------------------------------------------------------------------------
-------------------------------------------------------------------------------------------------------------------------------------------------------------------------------------------------------
-------------------------------------------------------------------------------------------------------------------------------------------------------------------------------------------------------
-------------------------------------------------------------------------------------------------------------------------------------------------------------------------------------------------------
--##-----SSS----S!!-----SSSSSS----S!!S-------------##-------------------SSS----S!!S--SS-S---SSSSSS--SSSSSSSSSSSSS----S!!S-SSS----S!!S-----------------------------------SSSSSS-----------------##------
-###-----------------------------------------------##---------------------------------------------------------------------------------------------------------------------------------------#-###------
####----------------------------------------------###--------------------------------------------------------------------------------------------------------------------------------------######------
####---------------------------------------------####------------1----------g-------------------------------------------------------------------------------------------------------------#######------
####-------------SS--S@S-----------SS------#----#####-----tt--------------------SS----------------@S------------------SS----------SS------#-#-----------##--#---------@S-----------------########------
####--------------------------------------##---######-----tt-----------------------------------------------------------------------------##-##--------####--##--------------------------#########------
####-------------------------------------###--#######-----tt----------------------------------------------------------------------------###-###------#####--###-----tt--------------tt-##########-----F
###M------------------------------------####--#######-gg--tt--------------------------------ggg----------k---------------g-------------####-####----######--####----tt------g-------tt###########-----#
XXXXXXXXXXXXXXXXXXXXXXXXXXXXXXXXXXXXXXXXXXXXXXXXXXXXXXXXXXXXXXXXXXXXXX--XXXXXXXXXXXXXXX---XXXXXXXXXXXXXXXXXXXXX-XXXXXXXXXXXXXXXXXXXXXXXXXXXXXXXXXXXXXXXXXX--XXXXXXXXXXXXXXXXXXXXXXXXXXXXXXXXXXXXXXXXXXX
XXXXXXXXXXXXXXXXXXXXXXXXXXXXXXXXXXXXXXXXXXXXXXXXXXXXXXXXXXXXXXXXXXXXXX--XXXXXXXXXXXXXXX---XXXXXXXXXXXXXXXXXXXXX-XXXXXXXXXXXXXXXXXXXXXXXXXXXXXXXXXXXXXXXXXX--XXXXXXXXXXXXXXXXXXXXXXXXXXXXXXXXXXXXXXXXXXX
