-------------------------------------------------------------------------------------------------------------------------------------------------------------------------------------------------------
-------------------------------------------------------------------------------------------------------------------------------------------------------------------------------------------------------
-------------------------------------------------------------------------------------------------------------------------------------------------------------------------------------------------------
-------------------------------------------------------------------------------------------------------------------------------------------------------------------------------------------------------
-------------------------------------------------------------------------------------------------------------------------------------------------------------------------------------------------------
-------------------------------------------------------------------------------------------------------------------------------------------------------------------------------------------------------
####--SSSSSS--SSS----S!!S-----------SS--------------##--------------------------SSSSSSS-S---SSSSSSSSSSSSSSSS--SSS----S!!SSS----S!!!-SSSS---------------------------------S!!S----S-------------##------
####-----------------------------------------------###--------------------------------------------------------------------------------------------------------------------------------------#-###------
####----------------------------------------------####-------------------------------------------------------------------------------------------------------------------------------------######------
####---------------------------------------------#####-----------1----------g-------------------------------------------------------------------------------------------------------------#######------
####-S----------------SS---------S------#-------######----tt-----------------S@S--------------------------------------SS--------SSSS-----#--#----------##--#--------------SS-----------#-########------
####------------------------------------##-----#######----tt----------------------------------------------------------------------------##--##--------###--##-------------------------###########------
####-------------------------#----------###---########----tt----------------------------------------------------------------------------##--###------####--###------#-----------#----############-----F
###M-----------------------###----------####--########gg--tt--------------------------------ggg----------k---------------g--------------##--####----#####--####----##-------g--##---#############-----#
XXXXXXXXXXXXXXXXXXXXXXXXXXXXXXXXXXXXXXXXXXXXXXXXXXXXXXXXXXXXXXXXXXXXXX--XXXXXXXXXXXXXX----XXXXXXXXXXXXXXXXXXXXXXXXXXXXXXXXXXXXXXXXXXXXXXXXXXXXXXXXXXXXXXX--XXXXXXXXXXXXXXXXXXXXXXXXXXXXXXXXXXXXXXXXXXXX
XXXXXXXXXXXXXXXXXXXXXXXXXXXXXXXXXXXXXXXXXXXXXXXXXXXXXXXXXXXXXXXXXXXXXX--XXXXXXXXXXXXXX----XXXXXXXXXXXXXXXXXXXXXXXXXXXXXXXXXXXXXXXXXXXXXXXXXXXXXXXXXXXXXXX--XXXXXXXXXXXXXXXXXXXXXXXXXXXXXXXXXXXXXXXXXXXX
