-------------------------------------------------------------------------------------------------------------------------------------------------------------------------------------------------------
-------------------------------------------------------------------------------------------------------------------------------------------------------------------------------------------------------
-------------------------------------------------------------------------------------------------------------------------------------------------------------------------------------------------------
-------------------------------------------------------------------------------------------------------------------------------------------------------------------------------------------------------
-------------------------------------------------------------------------------------------------------------------------------------------------------------------------------------------------------
-------------------------------------------------------------------------------------------------------------------------------------------------------------------------------------------------------
--##-SSSSS!SSSSSS!-SSS!----SSSSS--------------------##-SSS-------------------S!!SSSSSSS-S---SSS!--S-SSSSSSS---SSS----S--SSSSSS--S!!S------------SSSSS-------------------SSSSSSS!!S------------##-------
-###-----------------------------------------------###---------------------------------------------------------------------------------------------------------------------------------------###-------
####----------------------------------------------####--------------------------------------------------------------------------------------------------------------------------------------####-------
####---------------------------------------------#####-----------1----------g--------------------------------------------------------------------------------------------------------------#####-------
####------C------C----C------------------------t######----tt------------------SS---------------C---S-------S----------@S---------SS-------#--#----------##--#---------@S-------SS---------######-------
####-----------------------------------tt------t######----tt-----------------------------------------------------------------------------##--##--------###--##------------------------#--#######-------
####-----------------------------------tt------t######----tt---------------------------------------------------------------------------####--###------####--###-----tt---------------##-########------F
###M-----------------------------------tt------t######gg--tt--------------------------------ggg----------k---------------g------------#####--###-----#####--####----tt------g-------############------#
XXXXXXXXXXXXXXXXXXXXXXXXXXXXXXXXXXXXXXXXXXXXXXXXXXXXXXXXXXXXXXXXXXXXXX--XXXXXXXXXXXXXXX---XXXXXXXXXXXXXXXXXXXXXXXXXXXXXXXXXXXXXXXXXXXXXXXXXXXXXXXXXXXXXXXX--XXXXXXXXXXXXXXXXXX-XXXXXXXXXXXXXXXXXXXXXXXX
XXXXXXXXXXXXXXXXXXXXXXXXXXXXXXXXXXXXXXXXXXXXXXXXXXXXXXXXXXXXXXXXXXXXXX--XXXXXXXXXXXXXXX---XXXXXXXXXXXXXXXXXXXXXXXXXXXXXXXXXXXXXXXXXXXXXXXXXXXXXXXXXXXXXXXX--XXXXXXXXXXXXXXXXXX-XXXXXXXXXXXXXXXXXXXXXXXX
