-------------------------------------------------------------------------------------------------------------------------------------------------------------------------------------------------------
-------------------------------------------------------------------------------------------------------------------------------------------------------------------------------------------------------
-------------------------------------------------------------------------------------------------------------------------------------------------------------------------------------------------------
-------------------------------------------------------------------------------------------------------------------------------------------------------------------------------------------------------
-------------------------------------------------------------------------------------------------------------------------------------------------------------------------------------------------------
-------------------------------------------------------------------------------------------------------------------------------------------------------------------------------------------------------
--##---------SSS----S!!S-SSS!-----------------------#-------------------SS----S!!S--SSS----SSS----S!!S--------SSS----S!!SSS----S!!!!S---------------------------SSSSS--SSS----S!!S-----------#-##------
-###-----------------------------------------------##---------------------------------------------------------------------------------------------------------------------------------------#####------
####----------------------------------------------###--------------------------------------------------------------------------------------------------------------------------------------######------
####---------------------------------------------####-----------------------g-------------------------------------------------------------------------------------------------------------#######------
####-----------------SS-----C-------------##----#####-------tt-----------------SS------------------SS------S----------SS--------SSSS------#-#----------###--#--S---------------SS--------########------
####-------------------------------------###---######t------tt---------------------------------------------------------------------------##-##--------####--##--------------------------#########------
####-----------------------------#------####--#######t------tt--------------------------------------------------------------------------###-###------#####--###----------------------#-##########-----F
###M-----------------------------##----#####-########tgg----tt------------------------------ggg---------#k---------------g-------------####-####----######--###-------------g-------#############-----#
XXXXXXXXXXXXXXXXXXXXXXXXXXXXXXXXXXXXXXXXXXXX-XXXXXXXXXXXXXXXXXXXXXXXXX--XXXXXXXXXXXXXX---XXXXXXXXXXXXXXXXXXXXXXXXXXXXXXXXXXXXXXXXXXXXXXXXXXXXXXXXXXXXXXXXX--XXXXXXXXXXXXXXXXXXXXXXXXXXXXXXXXXXXXXXXXXXX
XXXXXXXXXXXXXXXXXXXXXXXXXXXXXXXXXXXXXXXXXXXX-XXXXXXXXXXXXXXXXXXXXXXXXX--XXXXXXXXXXXXXX---XXXXXXXXXXXXXXXXXXXXXXXXXXXXXXXXXXXXXXXXXXXXXXXXXXXXXXXXXXXXXXXXX--XXXXXXXXXXXXXXXXXXXXXXXXXXXXXXXXXXXXXXXXXXX
