-------------------------------------------------------------------------------------------------------------------------------------------------------------------------------------------------------
-------------------------------------------------------------------------------------------------------------------------------------------------------------------------------------------------------
-------------------------------------------------------------------------------------------------------------------------------------------------------------------------------------------------------
-------------------------------------------------------------------------------------------------------------------------------------------------------------------------------------------------------
-------------------------------------------------------------------------------------------------------------------------------------------------------------------------------------------------------
-------------------------------------------------------------------------------------------------------------------------------------------------------------------------------------------------------
--##-----S!!SSSSSSSS----SSSSSSSS---SS---------------##--------------SS----SSS!------SSS-S---SSS!----SSSSS-----SSS----S!!SSSSSSSSSSS!S--------------------------------SSSSSS--------------------##------
-###-----------------------------------------------###----------------------------------------------------------------------------------------------------------------------------------------###------
####----------------------------------------------####-------------------------------------------------------------------------------------------------------------------------------------#-####------
####---------------------------------------------#####----------------------g-------------------------------------------------------------------------------------------------------------#######------
####------SS---------S@S------------------##----######-----#-----------------C-----S-----------C-----------S----------SS-----------S------#--#---------##--#---------------!S------------########------
####-------------------------------------###---#######-----##----------------------------------------------------------------------------##--##-------###--##---------------------------#########------
####------------------------------------####t-########-----###--------------------------------------------------------------------------###--###-----####--###------#---------------tt-##########tt---F
###M-----------------------------------#####t#########gg---####----#------------------------ggg----------k---------------g-------------####--####---#####--####----##-------g-------tt###########tt---#
XXXXXXXXXXXXXXXXXXXXXXXXXXXXXX---XXXXXXXXXXXXXXXXXXXXXXXXXXXXXXXXXXXX---XXXXXXXXXXXXXXX---XXXXXXXXXXXXXXXXXXXXXXXXXXXXXXXXXXXXXXXXXXXXXXXXXXXXXXXXXXXXXXX--XXXXXXXXXXXXXXXXXXXXXXXXXXXXXXXXXXXXXXXXXXXX
XXXXXXXXXXXXXXXXXXXXXXXXXXXXXX---XXXXXXXXXXXXXXXXXXXXXXXXXXXXXXXXXXXX---XXXXXXXXXXXXXXX---XXXXXXXXXXXXXXXXXXXXXXXXXXXXXXXXXXXXXXXXXXXXXXXXXXXXXXXXXXXXXXX--XXXXXXXXXXXXXXXXXXXXXXXXXXXXXXXXXXXXXXXXXXXX
