-------------------------------------------------------------------------------------------------------------------------------------------------------------------------------------------------------
-------------------------------------------------------------------------------------------------------------------------------------------------------------------------------------------------------
-------------------------------------------------------------------------------------------------------------------------------------------------------------------------------------------------------
-------------------------------------------------------------------------------------------------------------------------------------------------------------------------------------------------------
-------------------------------------------------------------------------------------------------------------------------------------------------------------------------------------------------------
-------------------------------------------------------------------------------------------------------------------------------------------------------------------------------------------------------
-##---SSS----S!!S---S!!S@-----------SSS------------##-----------SSSSSS----SSS!---SSSSSS-S----SSSSSSSS---SSS!--SSS!--SS!SSS----S!!S!!S---------------------------------SSS----S!!S------------##--------
###-----------------------------------------------###---------------------------------------------------------------------------------------------------------------------------------------###--------
###----------------------------------------------####--------------------------------------------------------------------------------------------------------------------------------------####--------
###---------------------------------------------#####-----------------------g-------------------------------------------------------------------------------------------------------------#####--------
###S----------SS-----SS-!--!-----S-------#-----######-----#------------------C--S----------@S--------------C-----C----C--------SS-SS--------#----------##--#------------------SS---------######-#------
###-------------------------------------##----#######-----##-----------------------------------------------------------------------------#--##--------###--##---------------------------#######-##-----
###------------------------------------###tt-########-----###---------------------------------------------------------------------------##--###------####--###------tt--------------tt-########-###---F
###M---------------#-------------------###tt#########-gg--####------------------------------ggg----------k---------------g-------------###--####----#####--####-----tt------g-------tt#########-####--#
XXXXXXXXXXXXXXXXXXXXXXXXXXXXXXXXXXXXXXXXXXXXXXXXXXXXXXXXXXXXXXXXXXXXX---XXXXXXXXXXXXXXX---XXXXXXXXX---XXXXXXXXXXXXXXXXXXXXXXXXXXXXXXXXXXXXXXXXXXXXXXXXXXX--XXXXXXXXXXXXXXXXXXXXXXXXXXXXXXXXXXXXXXXXXXXX
XXXXXXXXXXXXXXXXXXXXXXXXXXXXXXXXXXXXXXXXXXXXXXXXXXXXXXXXXXXXXXXXXXXXX---XXXXXXXXXXXXXXX---XXXXXXXXX---XXXXXXXXXXXXXXXXXXXXXXXXXXXXXXXXXXXXXXXXXXXXXXXXXXX--XXXXXXXXXXXXXXXXXXXXXXXXXXXXXXXXXXXXXXXXXXXX
