-------------------------------------------------------------------------------------------------------------------------------------------------------------------------------------------------------
-------------------------------------------------------------------------------------------------------------------------------------------------------------------------------------------------------
-------------------------------------------------------------------------------------------------------------------------------------------------------------------------------------------------------
-------------------------------------------------------------------------------------------------------------------------------------------------------------------------------------------------------
-------------------------------------------------------------------------------------------------------------------------------------------------------------------------------------------------------
-------------------------------------------------------------------------------------------------------------------------------------------------------------------------------------------------------
--##---SSS!---SS----S!!S-----SSS----S!---------------#---------------S----SSSSSSSSSSSSS-S---SSS!-SS!S-SSSS----SSS----S!!SSSSSSSSSSSSS------------SSSSSS----------------SSSSSS------------------##------
-###------------------------------------------------##----------------------------------------------------------------------------------------------------------------------------------------###------
####-----------------------------------------------###-------------------------------------------------------------------------------------------------------------------------------------#-####------
####----------------------------------------------####----------------------g-------------------------------------------------------------------------------------------------------------#######------
####------C----------SS---S----------S---------tt#####-----tt----------------------------------C---S-------S----------SS------------------#--#--S-------##--#---------S------------------########------
####-----------------------------------tt------tt#####-----tt----------------------------------------------------------------------------##--##--------###--##-------#------------------#########------
####-----------------------------------tt------tt#####-----tt---------------------------------------------------------------------------###--###-------###--##------##--------------tt-##########-----F
###M-----------------------------------tt------tt#####gg---tt-------------------------------ggg----------k---------------g-------------####--###-------###--###----###------g-------tt###########-----#
XXXXXXXXXXXXXXXXXXXXXXXXXXXXXXXXXXXXXXXXXXXXXXXXXXXXXXXXXXXXXXXXXXXXX---XXXXXXXXXXXXXXX---XXXXXXXXXXXXXXXXXXXXXXXXXXXXXXXXXXXXXXXXXXXXXXXXXXXXXXXXXXXXXXXX--XXXXXXXXXXXXXXXXXXXXXXXXXXXXXXXXXXXXXXXXXXX
XXXXXXXXXXXXXXXXXXXXXXXXXXXXXXXXXXXXXXXXXXXXXXXXXXXXXXXXXXXXXXXXXXXXX---XXXXXXXXXXXXXXX---XXXXXXXXXXXXXXXXXXXXXXXXXXXXXXXXXXXXXXXXXXXXXXXXXXXXXXXXXXXXXXXX--XXXXXXXXXXXXXXXXXXXXXXXXXXXXXXXXXXXXXXXXXXX
