-------------------------------------------------------------------------------------------------------------------------------------------------------------------------------------------------------
-------------------------------------------------------------------------------------------------------------------------------------------------------------------------------------------------------
-------------------------------------------------------------------------------------------------------------------------------------------------------------------------------------------------------
-------------------------------------------------------------------------------------------------------------------------------------------------------------------------------------------------------
-------------------------------------------------------------------------------------------------------------------------------------------------------------------------------------------------------
-------------------------------------------------------------------------------------------------------------------------------------------------------------------------------------------------------
---##------------!S----SSSSS-----------------------##-------------SSSS----SS-----SSSSSS----SSSSS--SSS----S!!S--SS----S!!S-SSS----S!!S-----------------------------------SSSSSSSS-------------##--------
--###---------------------------------------------###---------------------------------------------------------------------------------------------------------------------------------------###--------
-####--------------------------------------------####--------------------------------------------------------------------------------------------------------------------------------------####--------
#####-------------------------------------------#####-----------------------g-------------------------------------------------------------------------------------------------------------#####--------
#####------------S--S@S-------------------#----######-----------@S------------S@S-------------------------SS----------SS----------SS------#-#-----------##--#----------S-----------------######-##-----
#####----------------------------------tt##t---######------------------------------------------------------------------------------------##-##---------###--##--------------------------#######-##-----
#####-----------------------tt---------tt##t---######-----------------------------------------------------------------------------------###-###------#####--###-----tt--------------tt-########-##t---F
###M#-----------------------tt#--------tt##t---######-gg------------------------------------ggg----------k---------------g-------------####-####----######--####----tt------g-------tt#########-##t---#
XXXXXXXXXXXXXXXXXXXXXXXXXXXXXXXXXXXXXXXXXXXXXXXXXXXXXXXXXXXXXXXXXXXXX---XXXXXXXXXXXXXX---XXXXXXXXXXXXXXXXXXXXXXXXXXXXXXXXXXXXXXXXXXXXXXXXXXXXXXXXXXXXXXXXX--XXXXXXXXXXXXXXXXXXXXXXXXXXXXXXXXXXXXXXXXXXX
XXXXXXXXXXXXXXXXXXXXXXXXXXXXXXXXXXXXXXXXXXXXXXXXXXXXXXXXXXXXXXXXXXXXX---XXXXXXXXXXXXXX---XXXXXXXXXXXXXXXXXXXXXXXXXXXXXXXXXXXXXXXXXXXXXXXXXXXXXXXXXXXXXXXXX--XXXXXXXXXXXXXXXXXXXXXXXXXXXXXXXXXXXXXXXXXXX
