-------------------------------------------------------------------------------------------------------------------------------------------------------------------------------------------------------
-------------------------------------------------------------------------------------------------------------------------------------------------------------------------------------------------------
-------------------------------------------------------------------------------------------------------------------------------------------------------------------------------------------------------
-------------------------------------------------------------------------------------------------------------------------------------------------------------------------------------------------------
-------------------------------------------------------------------------------------------------------------------------------------------------------------------------------------------------------
-------------------------------------------------------------------------------------------------------------------------------------------------------------------------------------------------------
#-##--------SSS----S!!--SSS----S--------------------##------------SSSS--SSSSS----SSSSSS-S---SSSSS--SSS----S!--SSS!-----SSSSSS----S!!S-----------------------------SSSSS----S!!S--------------#-##------
####-----------------------------------------------###--------------------------------------------------------------------------------------------------------------------------------------#####------
####----------------------------------------------####-------------------------------------------------------------------------------------------------------------------------------------######------
####---------------------------------------------#####----------------------g-------------------------------------------------------------------------------------------------------------#######------
####----------------SS-------------------------t######---------S@S------------S@S--------------------------S-----C---@S-----------SS-----#--#----------###--#tt-------------SS-----------########------
####-----------------------------------tt------t######----------------------------------------------------------------------------------##--##--------####--#tt-------------------------#########------
####-----------------------------------tt------t######----------------------------------------------------------------------------------##--###------#####--#tt---------------------tt-##########-----F
###M-----------------------------------tt------t######gg------------------------------------ggg----------k---------------g-------------###--####----######--#tt-------------g-------tt###########-----#
XXXXXXXXXXXXXXXXXXXXXXXXXXXXXXXXXXXXXXXXXXXXXXXXXXXXXXXXXXXXXXXXXXXXXX----XXXXXXXXXXXXX---XXXXXXXXXXXXXXXXXXXXXXXXXXXXXXXXXXXXXXXXXXXXXXXXXXXXXXXXXXXXXXXX--XXXXXXXXXXXXXXXXXXXXXXXXXXXXXXXXXXXXXXXXXXX
XXXXXXXXXXXXXXXXXXXXXXXXXXXXXXXXXXXXXXXXXXXXXXXXXXXXXXXXXXXXXXXXXXXXXX----XXXXXXXXXXXXX---XXXXXXXXXXXXXXXXXXXXXXXXXXXXXXXXXXXXXXXXXXXXXXXXXXXXXXXXXXXXXXXX--XXXXXXXXXXXXXXXXXXXXXXXXXXXXXXXXXXXXXXXXXXX
