-------------------------------------------------------------------------------------------------------------------------------------------------------------------------------------------------------
-------------------------------------------------------------------------------------------------------------------------------------------------------------------------------------------------------
-------------------------------------------------------------------------------------------------------------------------------------------------------------------------------------------------------
-------------------------------------------------------------------------------------------------------------------------------------------------------------------------------------------------------
-------------------------------------------------------------------------------------------------------------------------------------------------------------------------------------------------------
-------------------------------------------------------------------------------------------------------------------------------------------------------------------------------------------------------
--##------------S!SSS!--------------SSS-------------##---------------------SSS!-SSSSSSS----SSS----S!!S--------SSS----S!!SSSS----S!!S-------------------------------SSS----S!!S-SSSSS----------##-------
-###-----------------------------------------------###---------------------------------------------------------------------------------------------------------------------------------------###-------
####----------------------------------------------####--------------------------------------------------------------------------------------------------------------------------------------####-------
####---------------------------------------------#####-----------1----------g--------------------------------------------------------------------------------------------------------------#####-------
####-------------S---C-----SU----!--------##----######----tt------------------CS-------------------SS------S----------SS---------SS------#--#-----------#--##--------------SS-------------######-------
####-------------------------------------###---#######----tt----------------------------------------------------------------------------##--##---------##--###---------------------------#######-------
####------------------------------------####--########----tt---------------------------------------------------------------------------###--###------####--####---------------------t-#-########------F
###M-----------------------------------#####-#########gg--tt--------------------------------ggg----------k---------------g------------####--####----#####--#####------------g-------t###########------#
XXXXXXXXXXXXXXXXXXXXXXXXXXXXXXXXXXXXXXXXXXXX-XXXXXXXXXXXXXXXXXXXXXXXXX---XXXXXXXXXXXXX---XXXXXXXXXXXXXXXXXXXXXXXXXXXXXXXXXXXXXXXXXXXXXXXXXXXXXXXXXXXXXXXXXXXXXXXXXXXXXXXXXXXXXXXXXXXXXXXXXXXXXXXXXXXXXX
XXXXXXXXXXXXXXXXXXXXXXXXXXXXXXXXXXXXXXXXXXXX-XXXXXXXXXXXXXXXXXXXXXXXXX---XXXXXXXXXXXXX---XXXXXXXXXXXXXXXXXXXXXXXXXXXXXXXXXXXXXXXXXXXXXXXXXXXXXXXXXXXXXXXXXXXXXXXXXXXXXXXXXXXXXXXXXXXXXXXXXXXXXXXXXXXXXX
