-------------------------------------------------------------------------------------------------------------------------------------------------------------------------------------------------------
-------------------------------------------------------------------------------------------------------------------------------------------------------------------------------------------------------
-------------------------------------------------------------------------------------------------------------------------------------------------------------------------------------------------------
-------------------------------------------------------------------------------------------------------------------------------------------------------------------------------------------------------
-------------------------------------------------------------------------------------------------------------------------------------------------------------------------------------------------------
-------------------------------------------------------------------------------------------------------------------------------------------------------------------------------------------------------
#-##---------SSS----S!!SSSSSSS---------------------##-------------SSSS----SSS!----SSSSS-S----SSSSSSSS---SSS!SSSSS----S!!S--SS----S!!--------------------------------------SSS----S!!S---------##-------
####----------------------------------------------###----------------------------------------------------------------------------------------------------------------------------------------###-------
####---------------------------------------------####---------------------------------------------------------------------------------------------------------------------------------------####-------
####---------------------------------------------####-----------------------g--------------------------------------------------------------------------------------------------------------#####-------
####------S----------SS------------------------#t####----------S@S-----------C-------------@S--------------C----------SS----------SS-----#--#----------##--#-----------S----------SS------######-------
####-----------------------------------tt------#t####-----------------------------------------------------------------------------------##--##--------###--##----------------------------#######-------
####--------------------------t--------tt------#t####----------------------------------------------------------------------------------###--###------####--###-----t-----------------tt-########------F
###M--------------------------t--------tt------#t####-gg------------------------------------ggg----------k---------------g------------####--####----#####--####----t--------g--------tt#########------#
XXXXXXXXXXXXXXXXXXXXXXXXXXXXXXXXXXXXXXXXXXXXXXXXXXXXXXXXXXXXXXXXXXXXX---XXXXXXXXXXXXXXX---XXXXXXXXX---XXXXXXXXXXXXXXXXXXXXXXXXXXXXXXXXXXXXXXXXXXXXXXXXXXX--XXXXXXXXXXXXXXXXXXXXXXXXXXXXXXXXXXXXXXXXXXXX
XXXXXXXXXXXXXXXXXXXXXXXXXXXXXXXXXXXXXXXXXXXXXXXXXXXXXXXXXXXXXXXXXXXXX---XXXXXXXXXXXXXXX---XXXXXXXXX---XXXXXXXXXXXXXXXXXXXXXXXXXXXXXXXXXXXXXXXXXXXXXXXXXXX--XXXXXXXXXXXXXXXXXXXXXXXXXXXXXXXXXXXXXXXXXXXX
