-------------------------------------------------------------------------------------------------------------------------------------------------------------------------------------------------------
-------------------------------------------------------------------------------------------------------------------------------------------------------------------------------------------------------
-------------------------------------------------------------------------------------------------------------------------------------------------------------------------------------------------------
-------------------------------------------------------------------------------------------------------------------------------------------------------------------------------------------------------
-------------------------------------------------------------------------------------------------------------------------------------------------------------------------------------------------------
-------------------------------------------------------------------------------------------------------------------------------------------------------------------------------------------------------
##-SSSSSSSS---SSS!--SSS----S!!S----------------------------------SSSSS----SSS!---SSSSSS-S---SSS-SSS!---SSSS---SSS----S!!S--SS----S!!------------S-----------------SSS----S!!S-----------------##-------
##-------------------------------------------------#-----------------------------------------------------------------------------------------------------------------------------------------###-------
##------------------------------------------------##----------------------------------------------------------------------------------------------------------------------------------------####-------
##-------------------------------1---------------###------------------------g--------------------------------------------------------------------------------------------------------------#####-------
##S--------------C----------SS------------------####--------tt-S@------------C---------------------C-------S----------SS----------SS------#--#---------##--#--------------SS--------------######-------
##---------------------------------------------#####tt------tt---------------------------------------------------------------------------##--##-------###--##----------------------------#######-------
##-----------------------------------------tt-######tt------tt------------------------------------------------------------------------tt-##--###-----####--###------------------#---ttt-########------F
##-M---------------------------------------tt#######ttgg----tt------------------------------ggg----------k---------------g------------tt###--###----#####--####-------------g--##---ttt#########------#
XXXXXXXXX---XXXXXXXXXXXXXXXXXXXXXXXXXXXXXXXXXXXXXXXXXXXXXXXXXXXXXXXXX---XXXXXXXXXXXXXXX---XXXXXXXXXXXXXXXXXXXXXXXXXXXXXXXXXXXXXXXXXXXXXXXXXXXXXXXXXXXXXXX--XXXXXXXXXXXXXXXXXXXXXXXXXXXXXXXXXXXXXXXXXXXX
XXXXXXXXX---XXXXXXXXXXXXXXXXXXXXXXXXXXXXXXXXXXXXXXXXXXXXXXXXXXXXXXXXX---XXXXXXXXXXXXXXX---XXXXXXXXXXXXXXXXXXXXXXXXXXXXXXXXXXXXXXXXXXXXXXXXXXXXXXXXXXXXXXX--XXXXXXXXXXXXXXXXXXXXXXXXXXXXXXXXXXXXXXXXXXXX
