-------------------------------------------------------------------------------------------------------------------------------------------------------------------------------------------------------
-------------------------------------------------------------------------------------------------------------------------------------------------------------------------------------------------------
-------------------------------------------------------------------------------------------------------------------------------------------------------------------------------------------------------
-------------------------------------------------------------------------------------------------------------------------------------------------------------------------------------------------------
-------------------------------------------------------------------------------------------------------------------------------------------------------------------------------------------------------
-------------------------------------------------------------------------------------------------------------------------------------------------------------------------------------------------------
--##---------SSS----S!!S---SSS!---------------------#------------SSSSS----SS-----SSSSSS----SSS----S!!S------SSSSSS--------SSS----S!-----------------------------SSSS-SSS----S!!S-------------#-##------
-###-----------------------------------------------##---------------------------------------------------------------------------------------------------------------------------------------#####------
####----------------------------------------------###----------------------------------------------------------------------------------------#---------------------------------------------######------
####---------------------------------------------####-----------------------g---------------------------------------------------------------##--------------------------------------------#######------
####-----------------SS-------C--!--------------#####-------tt----------------S@S------------------SS-----@S-----------S----------S--------###---------##--#-----------------SS----------########------
####-------------------------------------------######t------tt----------------------------------------------------------------------------####--------###--##---------------------------#########------
####---------------------------------------tt-#######t------tt-------------------------------------------#----------------------------tt-######------####--###-----------------------tt##########-----F
###M---------------------------------------tt########tgg----tt------------------------------ggg---------#k---------------g------------tt########----#####--####-------------g---#----tt##########-----#
XXXXXXXXXXXXXXXXXXXXXXXXXXXXXXXXXXXXXXXXXXXXXXXXXXXXXXXXXXXXXXXXXXXXX---XXXXXXXXXXXXXX---XXXXXXXXXXXXXXXXXXXXXXXXXXXXXXXXXXXXXXXXXXXXXXXXXXXXXXXXXXXXXXXX--XXXXXXXXXXXXXXXXXXXXXXXXXXXXXXXXXXXXXXXXXXXX
XXXXXXXXXXXXXXXXXXXXXXXXXXXXXXXXXXXXXXXXXXXXXXXXXXXXXXXXXXXXXXXXXXXXX---XXXXXXXXXXXXXX---XXXXXXXXXXXXXXXXXXXXXXXXXXXXXXXXXXXXXXXXXXXXXXXXXXXXXXXXXXXXXXXX--XXXXXXXXXXXXXXXXXXXXXXXXXXXXXXXXXXXXXXXXXXXX
