-------------------------------------------------------------------------------------------------------------------------------------------------------------------------------------------------------
-------------------------------------------------------------------------------------------------------------------------------------------------------------------------------------------------------
-------------------------------------------------------------------------------------------------------------------------------------------------------------------------------------------------------
-------------------------------------------------------------------------------------------------------------------------------------------------------------------------------------------------------
-------------------------------------------------------------------------------------------------------------------------------------------------------------------------------------------------------
-------------------------------------------------------------------------------------------------------------------------------------------------------------------------------------------------------
-##-SSSSSSS---SSS!----SSSSSS-SSS----S!----------------------------SSSS--SSS-----SSSSSSS-S---SSS!--SSS----S!!S---S!SS-S!!S-SSSSS--S!!S----------------------------------SSSSSS-S!!S------------##-------
###------------------------------------------------------------------------------------------------------------------------------------------------------------------------------------------###-------
###-----------------------------------------------#-----------------------------------------------------------------------------------------------------------------------------------------####-------
###----------------------------------------------##-------------------------g--------------------------------------------------------------------------------------------------------------#####-------
###--------------C--@S---------------S--#-------###--------tt--S@S-----------S@S---------------C----------SS-----C----SS----------SS------#--#----------##-#----------S--------SS---------######-------
###-------------------------------------##-----####tt------tt----------------------------------------------------------------------------##--##--------###-##--------#-------------------#######-------
###-------------------------------------###----####tt------tt---------------------------------------------------------------------------###--###------####-###------##---------------#t-########------F
###M------------------------------------####---####tt-gg---tt-------------------------------ggg----------k-----#---------g-------------####--####----#####-####----###------g-------##t#########------#
XXXXXXXXX---XXXXXXXXXXXXXXXXXXXXXXXXXXXXXXXXXXXXXXXXXXXXXXXXXXXXXXXXXX--XXXXXXXXXXXXXX----XXXXXXXXXXXXXXXXXXXXXXXXXXXXXXXXXXXXXXXXXXXXXXXXXXXXXXXXXXXXXXXX-XXXXXXXXXXXXXXXXXXXXXXXXXXXXXXXXXXXXXXXXXXXX
XXXXXXXXX---XXXXXXXXXXXXXXXXXXXXXXXXXXXXXXXXXXXXXXXXXXXXXXXXXXXXXXXXXX--XXXXXXXXXXXXXX----XXXXXXXXXXXXXXXXXXXXXXXXXXXXXXXXXXXXXXXXXXXXXXXXXXXXXXXXXXXXXXXX-XXXXXXXXXXXXXXXXXXXXXXXXXXXXXXXXXXXXXXXXXXXX
