-------------------------------------------------------------------------------------------------------------------------------------------------------------------------------------------------------
-------------------------------------------------------------------------------------------------------------------------------------------------------------------------------------------------------
-------------------------------------------------------------------------------------------------------------------------------------------------------------------------------------------------------
-------------------------------------------------------------------------------------------------------------------------------------------------------------------------------------------------------
-------------------------------------------------------------------------------------------------------------------------------------------------------------------------------------------------------
-------------------------------------------------------------------------------------------------------------------------------------------------------------------------------------------------------
--##---------SSS----S!!SSSSS-----------------------##------------SSSSS----SS-----SSSSSS-S---SSSSSS-SSS----S!!SSSS----S!!S---S----S!!S---------------------------SSSSSSSS-SSS----S!!S---------##--------
-###----------------------------------------------###---------------------------------------------------------------------------------------------------------------------------------------###--------
####----------------------------------------------###--------------------------------------------------------------------------------------------------------------------------------------####--------
####--------------------------------------#-------###-----------------------g-------------------------------------------------------------------------------------------------------------#####--------
####------S----------SS-------------------#-#--#--###-------------------------S@S---------@S---------------SS---------SS----------SS------#-#----------##--#---------------------SS------######--------
####-----------------------------------tt-###--##-###------------------------------------------------------------------------------------##-##--------###--##---------------------------#######--------
####-------------------------tt--------tt-###--######-----------------------------------------------------------------------------------###-###------####--###----------------------tt-########-------F
###M-------------------------tt--------tt-###--######-gg------------------------------------ggg----------k---------------g-#-----------####-####----#####--####-------------g-------tt#########-------#
XXXXXXXXXXXXXXXXXXXXXXXXXXXXXXXXXXXXXXXXXXXXXXXXXXXXXXXXXXXXXXXXXXXXX---XXXXXXXXXXXXXXX---XXXXXXXXXXXXXXXXXXXXXXXXXXXXXXXXXXXXXXXXXXXXXXXXXXXXXXXXXXXXXXX--XXXXXXXXXXXXXXXXXXXXXXXXXXXXXXXXXXXXXXXXXXXX
XXXXXXXXXXXXXXXXXXXXXXXXXXXXXXXXXXXXXXXXXXXXXXXXXXXXXXXXXXXXXXXXXXXXX---XXXXXXXXXXXXXXX---XXXXXXXXXXXXXXXXXXXXXXXXXXXXXXXXXXXXXXXXXXXXXXXXXXXXXXXXXXXXXXX--XXXXXXXXXXXXXXXXXXXXXXXXXXXXXXXXXXXXXXXXXXXX
