-------------------------------------------------------------------------------------------------------------------------------------------------------------------------------------------------------
-------------------------------------------------------------------------------------------------------------------------------------------------------------------------------------------------------
-------------------------------------------------------------------------------------------------------------------------------------------------------------------------------------------------------
-------------------------------------------------------------------------------------------------------------------------------------------------------------------------------------------------------
-------------------------------------------------------------------------------------------------------------------------------------------------------------------------------------------------------
-------------------------------------------------------------------------------------------------------------------------------------------------------------------------------------------------------
-##----------SSS----S!!SSSSSS--------------------------------------SSS----SSS!##-SSSSSS-S---SSS!----SSSSSSSSSS-SSS----S!!S----SSSSSS-----------------------------------SSS----S!!S-----------##--------
###---------------------------------------------------------------------------##------------------------------------------------------------------------------------------------------------###--------
###---------------------------------------------------------------------------##-----------------------------------------------------------------------------------------------------------####--------
###-------------------------------------------------------------------------g-##----------------------------------------------------------------------------------------------------------#####--------
###------------------SS-------------------------###------------SS!S----------C##S--------------C-S@S-------------------SS----------------#--#-----------##-#-------------------SS--------######--------
###------------------------------------tt--t---#####--------------------------##--------------------------------------------------------##--##---------###-##---------------------------#######--------
###--------------------------tt--------tt--t--#######-----tt------------------##---------------------------------------------#---------###--###-------####-###------#---------------tt-########-------F
###M-------------------------tt--------tt--t--########gg--tt------------------##------------ggg----------k---------------g--##--------####--####-----#####-####----##-------g-------tt#########-------#
XXXXXXXXXXXXXXXXXXXXXXXXXXXXXXXXXXXXXXXXXXXXXXXXXXXXXXXXXXXXXXXXXXXXX---XXXXXXXXXXXXXXX---XXXXXXXXXXXXXXXXXXXXXXXXXXXXXXXXXXXXXXXXXXXXXXXXXXXXXXXXXXXXXXXX-XXXXXXXXXXXXXXXXXXXXXXXXXXXXXXXXXXXXXXXXXXXX
XXXXXXXXXXXXXXXXXXXXXXXXXXXXXXXXXXXXXXXXXXXXXXXXXXXXXXXXXXXXXXXXXXXXX---XXXXXXXXXXXXXXX---XXXXXXXXXXXXXXXXXXXXXXXXXXXXXXXXXXXXXXXXXXXXXXXXXXXXXXXXXXXXXXXX-XXXXXXXXXXXXXXXXXXXXXXXXXXXXXXXXXXXXXXXXXXXX
