-------------------------------------------------------------------------------------------------------------------------------------------------------------------------------------------------------
-------------------------------------------------------------------------------------------------------------------------------------------------------------------------------------------------------
-------------------------------------------------------------------------------------------------------------------------------------------------------------------------------------------------------
-------------------------------------------------------------------------------------------------------------------------------------------------------------------------------------------------------
-------------------------------------------------------------------------------------------------------------------------------------------------------------------------------------------------------
-------------------------------------------------------------------------------------------------------------------------------------------------------------------------------------------------------
-##----------SSS----SSS----S!!S--------------------------------SSSSSSS---SSSS----SSSSSS-S---SSSSSSSSS---SSS!--SSS!--SSS!--SSS----S!!------------SSSSSS------------SSS----S!!S---SSS-----------##-------
###------------------------------------------------#------------------------------------------------------------------------------------------#----------------------------------------------###-------
###-----------------------------------------------##-----------------------------------------------------------------------------------------##---------------------------------------------####-------
###-----------------------------------------------##------------------------g---------------------------------------------------------------###--------------------------------------------#####-------
###--------------S----------SS---!--------------tt###-------##----------------S@S--------------------------C-----C-----C----------SS-------####S--------##--#--S----------SS-------------#######-------
###-------------------------------------tt------tt####-----###----------------------------------------------------------------------------#####--------###--##--------------------------########-------
###-------------------------------------tt------tt####----####------------------------------------------------------------------------tt-######-------####--###---------------------tt-#########------F
###M------------------------------------tt------tt####gg-#####------------------------------ggg----------k---------------g------------tt#######-------####--###-------------g--#----tt##########------#
XXXXXXXXXXXXXXXXXXXXXXXXXXXXXXXXXXXXXXXXXXXXXXXXXXXXXXXXXXXXXX-XXXXXX---XXXXXXXXXXXXXX----XXXXXXXXX---XXXXXXXXXXXXXXXXXXXXXXXXXXXXXXXXXXXXXXXXXXXXXXXXXXXX--XXXXXXXXXXXXXXXXXXXXXXXXXXXXXXXXXXXXXXXXXXX
XXXXXXXXXXXXXXXXXXXXXXXXXXXXXXXXXXXXXXXXXXXXXXXXXXXXXXXXXXXXXX-XXXXXX---XXXXXXXXXXXXXX----XXXXXXXXX---XXXXXXXXXXXXXXXXXXXXXXXXXXXXXXXXXXXXXXXXXXXXXXXXXXXX--XXXXXXXXXXXXXXXXXXXXXXXXXXXXXXXXXXXXXXXXXXX
