-------------------------------------------------------------------------------------------------------------------------------------------------------------------------------------------------------
-------------------------------------------------------------------------------------------------------------------------------------------------------------------------------------------------------
-------------------------------------------------------------------------------------------------------------------------------------------------------------------------------------------------------
-------------------------------------------------------------------------------------------------------------------------------------------------------------------------------------------------------
-------------------------------------------------------------------------------------------------------------------------------------------------------------------------------------------------------
-------------------------------------------------------------------------------------------------------------------------------------------------------------------------------------------------------
#-##----SSS----S!!S----SSSSS-----------------------##-------------SSSS--SSS----S!!S--SS----SSSS----SSS----S!!SSSS@SSSSSS--SSS----S!!S---------------------------SSS----S!!S---S!!S------------##-------
####----------------------------------------------###----------------------------------------------------------------------------------------------------------------------------------------###-------
####---------------------------------------------####---------------------------------------------------------------------------------------------------------------------------------------####-------
####--------------------------------------------#####-----------------------g--------------------------------------------------------------------------------------------------------------#####-------
####-S----------SS--S@S------------------------######------tt--S@S--------------SS--------------S----------SS----!----------------SS------##-----------##--#-S----------SS-----SS---------######-------
####-----------------------------------tt-----#######------tt----------------------------------------------------------------------------####---------###--##----------------------------#######-------
####-------------------------tt--------tt-tt-########------tt---------------------------------------------------------------------------######-------####--##------------------------#t-########------F
###M-------------------------tt--------tt-tt#########-gg---tt-------------------------------ggg----------k---------------g-------------#########----#####--##---------------g-------##t#########------#
XXXXXXXXXXXXXXXXXXXXXXXXXXXXXXXXXXXXXXXXXXXXXXXXXXXXXXXXXXXXXXXXXXXXXX--XXXXXXXXXXXXXX---XXXXXXXXXXXXXXXXXXXXXXXXXXXXXXXXXXXXXXXXXXXXXXXXXXXXXXXXXXXXXXXX--XXXXXXXXXXXXXXXXXXXXXXXXXXXXXXXXXXXXXXXXXXXX
XXXXXXXXXXXXXXXXXXXXXXXXXXXXXXXXXXXXXXXXXXXXXXXXXXXXXXXXXXXXXXXXXXXXXX--XXXXXXXXXXXXXX---XXXXXXXXXXXXXXXXXXXXXXXXXXXXXXXXXXXXXXXXXXXXXXXXXXXXXXXXXXXXXXXX--XXXXXXXXXXXXXXXXXXXXXXXXXXXXXXXXXXXXXXXXXXXX
