-------------------------------------------------------------------------------------------------------------------------------------------------------------------------------------------------------
-------------------------------------------------------------------------------------------------------------------------------------------------------------------------------------------------------
-------------------------------------------------------------------------------------------------------------------------------------------------------------------------------------------------------
-------------------------------------------------------------------------------------------------------------------------------------------------------------------------------------------------------
-------------------------------------------------------------------------------------------------------------------------------------------------------------------------------------------------------
-------------------------------------------------------------------------------------------------------------------------------------------------------------------------------------------------------
-##------SSS----S!!S--!-----------------------------##------------SSSS--SS----S!!S--SSS-S---SSS!--------SSS----S!!S--S!!SSSSS----S!!S---------------------------------S!!SSSS----S!!---------##-----!S-
###------------------------------------------------###--------------------------------------------------------------------------------------------------------------------------------------###--------
###-----------------------------------------------####--------------------------------------------------------------------------------------#----------------------------------------------####--------
###----------------------------------------------#####----------------------g--------------------------------------------------------------##---------------------------------------------#####--------
###--------------SS--@S!S-----------------##----######-----#---S@S-------------SS--------------C-----S----------SS----SS----------SS------###----------###--#----------SS---------SS-----######-----S--
###--------------------------------------###---#######-----##----------------------------------------------------------------------------#####--------####--##--------------------------#######--------
###-------------------------tt----------####t-########-----###--------------------------------------------------------------------------#######------#####--###-----tt--------------tt-########-------F
###M------------------------tt---------#####t#########gg---####-----------------------------ggg----------k---------------g-------------#########----######--####----tt------g-------tt#########-------#
XXXXXXXXXXXXXXXXXXXXXXXXXXXXXXXXXXXXXXXXXXXXXXXXXXXXXXXXXXXXXXXXXXXXXX---XXXXXXXXXXXXXX---XXXXXXXXXXXXXXXXXXXXXXXXXXXXXXXXXXXXXXXXXXXXXXXXXXXXXXXXXXXXXXXX--XXXXXXXXXXXXXXXXXXXXXXXXXXXXXXXXXXXXXXXXXXX
XXXXXXXXXXXXXXXXXXXXXXXXXXXXXXXXXXXXXXXXXXXXXXXXXXXXXXXXXXXXXXXXXXXXXX---XXXXXXXXXXXXXX---XXXXXXXXXXXXXXXXXXXXXXXXXXXXXXXXXXXXXXXXXXXXXXXXXXXXXXXXXXXXXXXX--XXXXXXXXXXXXXXXXXXXXXXXXXXXXXXXXXXXXXXXXXXX
