-------------------------------------------------------------------------------------------------------------------------------------------------------------------------------------------------------
-------------------------------------------------------------------------------------------------------------------------------------------------------------------------------------------------------
-------------------------------------------------------------------------------------------------------------------------------------------------------------------------------------------------------
-------------------------------------------------------------------------------------------------------------------------------------------------------------------------------------------------------
-------------------------------------------------------------------------------------------------------------------------------------------------------------------------------------------------------
-------------------------------------------------------------------------------------------------------------------------------------------------------------------------------------------------------
--##------SS----S!!S--!-----------------------------##------------SSSS--SS----S!!SSSSSS----SSSSSSSSSS---SSS!-SSSS!SSSSSS--SSS----S!!S----------------------------S----S!!SSS----S!!S---------####------
-###-----------------------------------------------###----------------------------------------------------------------------------------------#---------------------------------------------#####------
####----------------------------------------------####---------------------------------------------------------------------------------------##--------------------------------------------######------
####---------------------------------------------#####----------------------g---------------------------------------------------------------###-------------------------------------------#######------
####-------------SS--@S!S-----------------#-----######---------S@S-------------SS--------------------------C-----C----------------SS-------####--------##--#-----------SS--------SS------########------
####-------------------------------------##----#######------------------------------------------------------------------------------------#####-------###--##---------------------------#########------
####------------------------tt----------###----#######--------------------------------------------------------------------------------tt-######------####--###----------------------tt-##########-----F
###M------------------------tt---------####----#######gg------------------------------------ggg----------k---------------g------------tt########----#####--####-------------g-------tt###########-----#
XXXXXXXXXXXXXXXXXXXXXXXXXXXXXXXXXXXXXXXXXXXXXXXXXXXXXXXXXXXXXXXXXXXXXX--XXXXXXXXXXXXXX---XXXXXXXXXX---XXXXXXXXXXXXXXXXXXXXXXXXXXXXXXXXXXXXXXXXXXXXXXXXXXX--XXXXXXXXXXXXXXXXXXXXXXXXXXXXXXXXXXXXXXXXXXXX
XXXXXXXXXXXXXXXXXXXXXXXXXXXXXXXXXXXXXXXXXXXXXXXXXXXXXXXXXXXXXXXXXXXXXX--XXXXXXXXXXXXXX---XXXXXXXXXX---XXXXXXXXXXXXXXXXXXXXXXXXXXXXXXXXXXXXXXXXXXXXXXXXXXX--XXXXXXXXXXXXXXXXXXXXXXXXXXXXXXXXXXXXXXXXXXXX
