-------------------------------------------------------------------------------------------------------------------------------------------------------------------------------------------------------
-------------------------------------------------------------------------------------------------------------------------------------------------------------------------------------------------------
-------------------------------------------------------------------------------------------------------------------------------------------------------------------------------------------------------
-------------------------------------------------------------------------------------------------------------------------------------------------------------------------------------------------------
-------------------------------------------------------------------------------------------------------------------------------------------------------------------------------------------------------
-------------------------------------------------------------------------------------------------------------------------------------------------------------------------------------------------------
##-SSSSSSSS---SSS!-----SSSSSS-------SS-------------##-----------SSSSSS----SSS!---SSSSSS-S---SSSSSSSSS---SSS!SSSSS!-------SSS----S!!!S-----------SSSSS--------------------S!!S----------------##--------
##------------------------------------------------###---------------------------------------------------------------------------------------------------------------------------------------###--------
##-----------------------------------------------####--------------------------------------------------------------------------------------------------------------------------------------####--------
##----------------------------------------------#####-----------------------g-------------------------------------------------------------------------------------------------------------#####--------
##S--------------C--S@S------------------------######-------##-S-------------C-----------------------------C-----C----S----------SSS------#--#----------##--#-------------SS-------------######--tt----
##--------------------------------------------#######------###---------------------------------------------------------------------------##--##--------###--##------tt------------------#######--tt----
##---------------------------#------------tt-########-----####--------------------------------------------------------------------------###--###------####--###-----tt----------#---tt-########--tt---F
##-M-------------------------##-----------tt#########-gg-#####------------------------------ggg----------k---------------g-------------####--###-----#####--###-----tt------g--##---tt#########--tt---#
XXXXXXXXX---XXXXXXXXXXXXXXXXXXXXXXXXXXXXXXXXXXXXXXXXXXXXXXXXXXXXXXXXX---XXXXXXXXXXXXXXX---XXXXXXXXX---XXXXXXXXXXXXXXXXXXXXXXXXXXXXXXXXXXXXXXXXXXXXXXXXXXXX--XXXXXXXXXXXXXXXXXXXXXXXXXXXXXXXXXXXXXXXXXXX
XXXXXXXXX---XXXXXXXXXXXXXXXXXXXXXXXXXXXXXXXXXXXXXXXXXXXXXXXXXXXXXXXXX---XXXXXXXXXXXXXXX---XXXXXXXXX---XXXXXXXXXXXXXXXXXXXXXXXXXXXXXXXXXXXXXXXXXXXXXXXXXXXX--XXXXXXXXXXXXXXXXXXXXXXXXXXXXXXXXXXXXXXXXXXX
