-------------------------------------------------------------------------------------------------------------------------------------------------------------------------------------------------------
-------------------------------------------------------------------------------------------------------------------------------------------------------------------------------------------------------
-------------------------------------------------------------------------------------------------------------------------------------------------------------------------------------------------------
-------------------------------------------------------------------------------------------------------------------------------------------------------------------------------------------------------
-------------------------------------------------------------------------------------------------------------------------------------------------------------------------------------------------------
-------------------------------------------------------------------------------------------------------------------------------------------------------------------------------------------------------
-##----------SSS----S!!S--SSSSSS----S!!------------##---------------SS-----------SSSSSS-S-SSS----S!!S---SSS----S!!---S!!SSSSSSS--------------------------------------SSS----S!!S-------------##--------
###-----------------------------------------------###---------------------------------------------------------------------------------------------------------------------------------------###--------
###-----------------------------------------------###----------------------------------------------------------------------------------------#---------------------------------------------####--------
###---------------------------------------#-------###-----------------------g---------------------------------------------------------------##--------------------------------------------#####--------
###------------------SS--------------SS--##-----#####------#------------------S@S-----------------SS------------SS----SS-------------------###---------###--#----------------SS----------######--------
###-------------------------------------###----######------##-----------------------------------------------------------------------------####--------####--##--------------------------#######--------
###------------------------------------####---#######------###------------------------------------------------------------------------tt-######------#####--###-----t---------------tt-########-------F
###M-----------------------------------####--########-gg---####----#------------------------ggg----------k---------------g------------tt########----######--####----t-------g-------tt#########-------#
XXXXXXXXXXXXXXXXXXXXXXXXXXXXXXXXXXXXXXXXXXXXXXXXXXXXXXXXXXXXXXXXXXXXX---XXXXXXXXXXXXXXX---XXXXXXXXXXXXXXXXXXXXXXXXXXXXXXXXXXXXXXXXXXXXXXXXXXXXXXXXXXXXXXXX--XXXXXXXXXXXXXXXXXXXXXXXXXXXXXXXXXXXXXXXXXXX
XXXXXXXXXXXXXXXXXXXXXXXXXXXXXXXXXXXXXXXXXXXXXXXXXXXXXXXXXXXXXXXXXXXXX---XXXXXXXXXXXXXXX---XXXXXXXXXXXXXXXXXXXXXXXXXXXXXXXXXXXXXXXXXXXXXXXXXXXXXXXXXXXXXXXX--XXXXXXXXXXXXXXXXXXXXXXXXXXXXXXXXXXXXXXXXXXX
