-------------------------------------------------------------------------------------------------------------------------------------------------------------------------------------------------------
-------------------------------------------------------------------------------------------------------------------------------------------------------------------------------------------------------
-------------------------------------------------------------------------------------------------------------------------------------------------------------------------------------------------------
-------------------------------------------------------------------------------------------------------------------------------------------------------------------------------------------------------
-------------------------------------------------------------------------------------------------------------------------------------------------------------------------------------------------------
-------------------------------------------------------------------------------------------------------------------------------------------------------------------------------------------------------
-##!S--------SSS----S!--SSSSSSSS-S!!S--------------##---------------SS----SSS!---SSSSSS------SSSSSSSSSSSSSS---SSS!-------SSSSSSS-S!!S-----------SSS-------------SSSSSSSS---SSS!----------------##------
###-----------------------------------------------###-----------------------------------------------------------------------------------------------------------------------------------------###------
###-----------------------------------------------###--------------------------------------------------------------------------------------------------------------------------------------#-####------
###-----------------------------------------------###-----------------------g-------------------------------------------------------------------------------------------------------------#######------
###S------S----------S@S----------SS------#----#--###------#-----------------C------------S@S--------------------C----S@S---------SS------#--#----------##--#-----------------C----------########------
###--------------------------------------##----##-###------##----------------------------------------------------------------------------##--##--------###--##--------------------------#########------
###-------------------------------------###----######------###--------------------------------------------------------------------------###--##-------####--###---------------------tt-##########-----F
###M-----------------------------------####----######-gg---####----#------------------------ggg----------k---------------g-------------####--##------#####--####------------g-------tt###########-----#
XXXXXXXXXXXXXXXXXXXXXXXXXXXXXX--XXXXXXXXXXXXXXXXXXXXXXXXXXXXXXXXXXXXX---XXXXXXXXXXXXXX---XXXXXXXXXXXXXXXX---XXXXXXXXXXXXXXXXXXX-XXXXXXXXXXXXXXXXXXXXXXXXXX--XXXXXXXXXX---XXXXXXXXXXXXXXXXXXXXXXXXXXXXXX
XXXXXXXXXXXXXXXXXXXXXXXXXXXXXX--XXXXXXXXXXXXXXXXXXXXXXXXXXXXXXXXXXXXX---XXXXXXXXXXXXXX---XXXXXXXXXXXXXXXX---XXXXXXXXXXXXXXXXXXX-XXXXXXXXXXXXXXXXXXXXXXXXXX--XXXXXXXXXX---XXXXXXXXXXXXXXXXXXXXXXXXXXXXXX
