-------------------------------------------------------------------------------------------------------------------------------------------------------------------------------------------------------
-------------------------------------------------------------------------------------------------------------------------------------------------------------------------------------------------------
-------------------------------------------------------------------------------------------------------------------------------------------------------------------------------------------------------
-------------------------------------------------------------------------------------------------------------------------------------------------------------------------------------------------------
-------------------------------------------------------------------------------------------------------------------------------------------------------------------------------------------------------
-------------------------------------------------------------------------------------------------------------------------------------------------------------------------------------------------------
-##--------SSSSSSS------SSSSSS-----------------------------------SSSSS----SSS!---SSSSSS-S---SSSSSSSSSSSSSSS---SSS!---S!!S-SSS----------------------------------------SS!SS----S!!S------------##-------
###------------------------------------------------#-----------------------------------------------------------------------------------------------------------------------------------------###-------
###-----------------------------------------------##----------------------------------------------------------------------------------------------------------------------------------------####-------
###----------------------------------------------###------------------------g---------------------------------------------------------------#----------------------------------------------#####-------
###-------S----------S@S------------------tt----####--------tt---------------C-----------------------------------C----SS-----!S------------##----------###--#----------C-------SS---------######-------
###------------------------------------tt-tt----####tt------tt----------------------------------------------------------------------------####--------####--##---------------------------#######-------
###---------------------------t--------tt-tt----####tt------tt------------------------------------------------------------------------tt-######------#####--###-----t----------------#t-########------F
###M--------------------------t--------tt-tt----####ttgg----tt------------------------------ggg----------k---------------g------------tt########----######--####----t-------g-------##t#########------#
XXXXXXXXXXXXXXXXX-XXXXXXXXXXXXXXXXXXXXXXXXXXXXXXXXXXXXXXXXXXXXXXXXXXX---XXXXXXXXXXXXXXX---XXXXXXXXXXXXXXX---XXXXXXXXXXXXXXXXXXXXXXXXXXXXXXXXXXXXXXXXXXXXXX--XXXXXXXXXXXXXXXXXXXXXXXXXXXXXXXXXXXXXXXXXXX
XXXXXXXXXXXXXXXXX-XXXXXXXXXXXXXXXXXXXXXXXXXXXXXXXXXXXXXXXXXXXXXXXXXXX---XXXXXXXXXXXXXXX---XXXXXXXXXXXXXXX---XXXXXXXXXXXXXXXXXXXXXXXXXXXXXXXXXXXXXXXXXXXXXX--XXXXXXXXXXXXXXXXXXXXXXXXXXXXXXXXXXXXXXXXXXX
