-------------------------------------------------------------------------------------------------------------------------------------------------------------------------------------------------------
-------------------------------------------------------------------------------------------------------------------------------------------------------------------------------------------------------
-------------------------------------------------------------------------------------------------------------------------------------------------------------------------------------------------------
-------------------------------------------------------------------------------------------------------------------------------------------------------------------------------------------------------
-------------------------------------------------------------------------------------------------------------------------------------------------------------------------------------------------------
-------------------------------------------------------------------------------------------------------------------------------------------------------------------------------------------------------
--##------------SSSS---SSSSSS-----------------------##------------SSSS----SSSS!!SSSSSSS-S---SS----S!!S----S!S-SSS-SSSSSSSS---SSS-S!!S-----------------------------------SSSSSSSS-------------#-##------
-###-----------------------------------------------###--------------------------------------------------------------------------------------------------------------------------------------#####------
####----------------------------------------------####-----------------------------------------------------------------------------------------------------#-------------------------------######------
####---------------------------------------------#####----------------------g-----------------------------------------------------------------------------##------------------------------#######------
####----------------S@S-------------------------######----#-------------------SS-------------------SS------S-----S----------------SS-----#--#----------#-####--------S@S-----------------########------
####-----------------------------------t-------#######----##----------------------------------------------------------------------------##--##--------########--------------------------#########------
####-------------------------tt--------t---tt-########----###--------------------------------------------#------------------------------##--###------##########---------------------tt-##########-----F
###M-------------------------tt--------t---tt#########gg--####------------------------------ggg---------#k---------------g-------------###--####----############------------g-------tt###########-----#
XXXXXXXXXXXXXXXXXXXXXXXXXXXXXXXXXXXXXXXXXXXXXXXXXXXXXXXXXXXXXXXXXXXXX---XXXXXXXXXXXXXXX---XXXXXXXXXXXXXXXXXXXXXXXXXXXXXX---XXXXXXXXXXXXXXXXXXXXXXXXXXXXXXXXXXXXXXXXXXXXXXXXXXXXXXXXXXXXXXXXXXXXXXXXXXXX
XXXXXXXXXXXXXXXXXXXXXXXXXXXXXXXXXXXXXXXXXXXXXXXXXXXXXXXXXXXXXXXXXXXXX---XXXXXXXXXXXXXXX---XXXXXXXXXXXXXXXXXXXXXXXXXXXXXX---XXXXXXXXXXXXXXXXXXXXXXXXXXXXXXXXXXXXXXXXXXXXXXXXXXXXXXXXXXXXXXXXXXXXXXXXXXXX
