-------------------------------------------------------------------------------------------------------------------------------------------------------------------------------------------------------
-------------------------------------------------------------------------------------------------------------------------------------------------------------------------------------------------------
-------------------------------------------------------------------------------------------------------------------------------------------------------------------------------------------------------
-------------------------------------------------------------------------------------------------------------------------------------------------------------------------------------------------------
-------------------------------------------------------------------------------------------------------------------------------------------------------------------------------------------------------
-------------------------------------------------------------------------------------------------------------------------------------------------------------------------------------------------------
####----------SSS!------SSSSSSS---------------------##------------------SS----S!!S-SSSS-----SSS!---SSS----S!SSSSS----S!!S-SSSSSS-S!!S-----------------------------------------SSSSSSS---------##----@--
####-----------------------------------------------###---------------------------------------------------------------------------------------------------------------------------------------###-------
####----------------------------------------------####--------------------------------------------------------------------------------------------------------------------------------------####-------
####--------------------------------------#------#####----------------------g--------------------------------------------------------------------------------------------------------------#####-------
####-------------C---S@S-----------------##-----######-----tt------------------SS--------------C-----------S----------SS----------SS-------#-----------##--#--------tt--------------------######----!--
####-----------------------------------tt##t---#######-----tt----------------------------------------------------------------------------#-##---------###--##t------tt-------------------#######-------
####-----------------------------------tt##t---#######-----tt---------------------------------------------------------------------------##-###-------####--##t------tt---------------tt-########------F
###M-----------------------------------tt##t---#######gg---tt-------------------------------ggg----------k---------------g-------------###-####-----#####--##t------tt------g--------tt#########------#
XXXXXXXXXXXXXXXXXXXXXXXXXXXXXX-XXXXXXXXXXXXXXXXXXXXXXXXXXXXXXXXXXXXXXX--XXXXXXXXXXXXXX----XXXXXXXXXXXXXXXXXXXXXXXXXXXXXXXXXXXXXXXXXXXXXXXXXXXXXXXXXXXXXXX--XXXXXXXXXXXXXXXXXXXXXXXXX-XXXXXXXXXXXXXXXXXX
XXXXXXXXXXXXXXXXXXXXXXXXXXXXXX-XXXXXXXXXXXXXXXXXXXXXXXXXXXXXXXXXXXXXXX--XXXXXXXXXXXXXX----XXXXXXXXXXXXXXXXXXXXXXXXXXXXXXXXXXXXXXXXXXXXXXXXXXXXXXXXXXXXXXX--XXXXXXXXXXXXXXXXXXXXXXXXX-XXXXXXXXXXXXXXXXXX
