-------------------------------------------------------------------------------------------------------------------------------------------------------------------------------------------------------
-------------------------------------------------------------------------------------------------------------------------------------------------------------------------------------------------------
-------------------------------------------------------------------------------------------------------------------------------------------------------------------------------------------------------
-------------------------------------------------------------------------------------------------------------------------------------------------------------------------------------------------------
-------------------------------------------------------------------------------------------------------------------------------------------------------------------------------------------------------
-------------------------------------------------------------------------------------------------------------------------------------------------------------------------------------------------------
#-##----SSSSSSSSS!------SSS----S----SSS-------------##---------------S---S----S!!S--SSS-S---SSS!--SSS----S!!S--SS----S!!-SSS----SS!!S---------------------------SSS----S!!S---SSSSSS----------##-------
####-----------------------------------------------###---------------------------------------------------------------------------------------------------------------------------------------###-------
####----------------------------------------------####--------------------------------------------------------------------------------------------------------------------------------------####-------
####--------------------------------------#------#####----------------------g--------------------------------------------------------------------------------------------------------------#####-------
####-------------C---S-----------S-------##-----######-----tt------------------SS--------------C----------SS----------SS----------SS------#--#----------##--#-----------SS---S------------######-------
####------------------------------------###t---#######-----tt----------------------------------------------------------------------------##--##--------###--##---------------------------#######-#-----
####------------------------------------###t--########-----tt---------------------------------------------------------------------------###--###------####--###----------------------tt-########-##---F
###M------------------------------------###t-#########gg---tt-------------------------------ggg----------k---------------g-------------####--####----#####--###-------------g--------tt#########-##---#
XXXXXXXXXXXXXX-XXXXXXXXXXXXXXXXXXXXXXXXXXXXXXXXXXXXXXXXXXXXXXXXXXXXXX---XXXXXXXXXXXXXX----XXXXXXXXXXXXXXXXXXXXXXXXXXXXXXXXXXXXXXXXXXXXXXXXXXXXXXXXXXXXXXXX--XXXXXXXXXXXXXXXXXXXXXXXXXXXXXXXXXXXXXXXXXXX
XXXXXXXXXXXXXX-XXXXXXXXXXXXXXXXXXXXXXXXXXXXXXXXXXXXXXXXXXXXXXXXXXXXXX---XXXXXXXXXXXXXX----XXXXXXXXXXXXXXXXXXXXXXXXXXXXXXXXXXXXXXXXXXXXXXXXXXXXXXXXXXXXXXXX--XXXXXXXXXXXXXXXXXXXXXXXXXXXXXXXXXXXXXXXXXXX
