-------------------------------------------------------------------------------------------------------------------------------------------------------------------------------------------------------
-------------------------------------------------------------------------------------------------------------------------------------------------------------------------------------------------------
-------------------------------------------------------------------------------------------------------------------------------------------------------------------------------------------------------
-------------------------------------------------------------------------------------------------------------------------------------------------------------------------------------------------------
-------------------------------------------------------------------------------------------------------------------------------------------------------------------------------------------------------
-------------------------------------------------------------------------------------------------------------------------------------------------------------------------------------------------------
--##---------SSS----S!-SSSS------------------------##-------------SSSS----SSS----SSSSSS-S---SSS!----SSSSSSS---SSS!SSSSS!SSSS----S!----------------------------------S----S!!S------------------##------
-###----------------------------------------------###-----------------------------------------------------------------------------------------------------------------------------------------###------
####----------------------------------------------###----------------------------------------------------------------------------------------------------------------------------------------####------
####----------------------------------------------###-----------------------g---------------------------------------------------------------#---------------------------------------------#-#####------
####------S----------SS-------------------------tt###----------S@S------------S@S--------------C-----------------C-----S---------S---------##-----------##--#-------------SS-------------########------
####-----------------------------------ttt------tt###-------------------------------------------------------------------------------------####---------###--##--------------------------#########------
####-------------------------tt--------ttt------tt###---------------------------------------------------------------------------------tt-######------#####--###-----------------#---tt-##########-----F
###M-------------------------tt--------ttt------tt###-gg------------------------------------ggg----------k---------------g------------tt########----######--####------------g--##---tt###########-----#
XXXXXXXXXXXXXXXXXXXXXXXXXXXXXXXXXXXXXXXXXXXXXXXXXXXXXXXXXXXXXXXXXXXXX---XXXXXXXXXXXXXXX---XXXXXXXXXXXXXXX---XXXXXXXXXXXXXXXXXXXXXXXXXXXXXXXXXXXXXXXXXXXXXX--XXXXXXXXXXXXXXXXXXXXXXXXXXXXXXXXXXXXXXXXXXX
XXXXXXXXXXXXXXXXXXXXXXXXXXXXXXXXXXXXXXXXXXXXXXXXXXXXXXXXXXXXXXXXXXXXX---XXXXXXXXXXXXXXX---XXXXXXXXXXXXXXX---XXXXXXXXXXXXXXXXXXXXXXXXXXXXXXXXXXXXXXXXXXXXXX--XXXXXXXXXXXXXXXXXXXXXXXXXXXXXXXXXXXXXXXXXXX
