-------------------------------------------------------------------------------------------------------------------------------------------------------------------------------------------------------
-------------------------------------------------------------------------------------------------------------------------------------------------------------------------------------------------------
-------------------------------------------------------------------------------------------------------------------------------------------------------------------------------------------------------
-------------------------------------------------------------------------------------------------------------------------------------------------------------------------------------------------------
-------------------------------------------------------------------------------------------------------------------------------------------------------------------------------------------------------
-------------------------------------------------------------------------------------------------------------------------------------------------------------------------------------------------------
--##------------S!SSS!--------------S-----------------------------------SSSSSS---SSSSSS-S---SS----S!!S---SSSS-SSS!--SSS!----S----S!!S------------SSS-------------SSSSSS-SSSSSSSS--------------##-------
-###-----------------------------------------------#-----------------------------------------------------------------------------------------------------------------------------------------###-------
####----------------------------------------------###---------------------------------------------------------------------------------------------------------------------------------------####-------
####---------------------------------------------####------------1----------g-------------------------------------------------------------------------------------------------------------######-------
####-------------S---C-----SU----!-----#--------#####-----tt------------------S@S------------------SS------------C-----C----------SS-----#--#----------##--#----S------S-----------------#######-------
####-----------------------------------##------######t----tt----------------------------------------------------------------------------##--##--------###--##---------------------------########-------
####-----------------------------------###-tt-#######t----tt---------------------------------------------------------------------------###--###------####--###----------------------tt-#########------F
###M-----------------------------------###-tt########tgg--tt--------------------------------ggg---------#k---------------g------------####--####----#####--####-------------g-------tt##########------#
XXXXXXXXXXXXXXXXXXXXXXXXXXXXXXXXXXXXXXXXXXXXXXXXXXXXXXXXXXXXXXXXXXXXXX--XXXXXXXXXXXXXXX---XXXXXXXXXXXXXXXXXXXXXXXXXXXXXXXXXXXXXXXXXXXXXXXXXXXXXXXXXXXXXXX--XXXXXXXXXXXXXXXXXXX--XXXXXXXXXXXXXXXXXXXXXXX
XXXXXXXXXXXXXXXXXXXXXXXXXXXXXXXXXXXXXXXXXXXXXXXXXXXXXXXXXXXXXXXXXXXXXX--XXXXXXXXXXXXXXX---XXXXXXXXXXXXXXXXXXXXXXXXXXXXXXXXXXXXXXXXXXXXXXXXXXXXXXXXXXXXXXX--XXXXXXXXXXXXXXXXXXX--XXXXXXXXXXXXXXXXXXXXXXX
