-------------------------------------------------------------------------------------------------------------------------------------------------------------------------------------------------------
-------------------------------------------------------------------------------------------------------------------------------------------------------------------------------------------------------
-------------------------------------------------------------------------------------------------------------------------------------------------------------------------------------------------------
-------------------------------------------------------------------------------------------------------------------------------------------------------------------------------------------------------
-------------------------------------------------------------------------------------------------------------------------------------------------------------------------------------------------------
-------------------------------------------------------------------------------------------------------------------------------------------------------------------------------------------------------
-##-----------SS----S!!SSSS!------------------------##------------SSSS----------SSSSSSS-S---SS--SSS!----SSS----S!!---S!!S-SSS----S!!S---------------------------------SSSSS----S!!S-----------##-------
###------------------------------------------------###---------------------------------------------------------------------------------------------------------------------------------------###-------
###-----------------------------------------------####--------------------------------------------------------------------------------------------------------------------------------------####-------
###----------------------------------------------#####----------------------g---------------------------------------------------------------#----------------------------------------------#####-------
###------------------SS----C-----S-------------t######----tt-----------------S@S-------------------C------------SS----SS----------SS------#-#-----------##--#-------------------SS--------######-------
###------------------------------------tt------t######----tt-----------------------------------------------------------------------------##-##---------###--##-------------------------#-#######-------
###------------------------------------tt------t######----tt----------------------------------------------------------------------------###-###------#####--###-----tt----------------##########------F
###M-----------------------------------tt------t######gg--tt--------------------------------ggg----------k---------------g-------------####-####----######--####----tt------g--------###########------#
XXXXXXXXXXXXXXXXXXXXXXXXXXXXXXXXXXXXXXXXXXXXXXXXXXXXXXXXXXXXXXXXXXXXX---XXXXXXXXXXXXXX----XXXXXXXXXXXXXXXXXXXXXXXXXXXXXXXXXXXXXXXXXXXXXXXXXXXXXXXXXXXXXXXX--XXXXXXXXXXXXXXXXXXXXXXXXXXXXXXXXXXXXXXXXXXX
XXXXXXXXXXXXXXXXXXXXXXXXXXXXXXXXXXXXXXXXXXXXXXXXXXXXXXXXXXXXXXXXXXXXX---XXXXXXXXXXXXXX----XXXXXXXXXXXXXXXXXXXXXXXXXXXXXXXXXXXXXXXXXXXXXXXXXXXXXXXXXXXXXXXX--XXXXXXXXXXXXXXXXXXXXXXXXXXXXXXXXXXXXXXXXXXX
