-------------------------------------------------------------------------------------------------------------------------------------------------------------------------------------------------------
-------------------------------------------------------------------------------------------------------------------------------------------------------------------------------------------------------
-------------------------------------------------------------------------------------------------------------------------------------------------------------------------------------------------------
-------------------------------------------------------------------------------------------------------------------------------------------------------------------------------------------------------
-------------------------------------------------------------------------------------------------------------------------------------------------------------------------------------------------------
-------------------------------------------------------------------------------------------------------------------------------------------------------------------------------------------------------
--##----------SSSSSS----------@-----S---------------##------------SSSS---S----S!!SSSSSS-S----SSSSSSSS---SSS!--SSS----S!!S-SSS----S!!---------------------------------------SSSSSSS------------##-------
-###-----------------------------------------------###---------------------------------------------------------------------------------------------------------------------------------------###-------
####----------------------------------------------####--------------------------------------------------------------------------------------------------------------------------------------####-------
####---------------------------------------------#####----------------------g--------------------------------------------------------------------------------------------------------------#####-------
####-----------------SU----!--!--!--------#-----######----#--------------------SS----------@S--------------C----------SS----------SS-------##----------##--##------------SS---------------######-------
####-------------------------------------##----#######----##------------------------------------------------------------------------------####--------###--###---------------------------#######-------
####------------------------------------###---########----###-------------------------------------------------------------------------tt-######------####--####-----tt--------------ttt-########------F
###M-----------------------------------####--#########gg--####------------------------------ggg----------k---------------g------------tt########----#####--#####----tt------g-------ttt#########------#
XXXXXXXXXXXXXXXXXXXXXXXXXXXXXXXXXXXXXXXXXXXXXXXXXXXXXXXXXXXXXXXXXXXXX---XXXXXXXXXXXXXXX---XXXXXXXXX---XXXXXXXXXXXXXXXXXXXXXXXXXXXXXXXXXXXXXXXXXXXXXXXXXXX--XXXXXXXXXXXXXXXXXXXXXX-XXXXXXXXXXXXXXXXXXXXX
XXXXXXXXXXXXXXXXXXXXXXXXXXXXXXXXXXXXXXXXXXXXXXXXXXXXXXXXXXXXXXXXXXXXX---XXXXXXXXXXXXXXX---XXXXXXXXX---XXXXXXXXXXXXXXXXXXXXXXXXXXXXXXXXXXXXXXXXXXXXXXXXXXX--XXXXXXXXXXXXXXXXXXXXXX-XXXXXXXXXXXXXXXXXXXXX
