-------------------------------------------------------------------------------------------------------------------------------------------------------------------------------------------------------
-------------------------------------------------------------------------------------------------------------------------------------------------------------------------------------------------------
-------------------------------------------------------------------------------------------------------------------------------------------------------------------------------------------------------
-------------------------------------------------------------------------------------------------------------------------------------------------------------------------------------------------------
-------------------------------------------------------------------------------------------------------------------------------------------------------------------------------------------------------
-------------------------------------------------------------------------------------------------------------------------------------------------------------------------------------------------------
-##------SSSSSS-----SSS----S!!S---------------------##-S-------SSSSSSS----SSSS!!-SSSSSS-S---SS-------SSSSSS-SSSSS----S!!S-SSS----S!!S-------------------------------SSS!-----------------------##---!S-
###------------------------------------------------###--------------------------------------------------------------------------------------------------------------------------------------#-###------
###-----------------------------------------------####-------------------------------------------------------------------------------------------------------------------------------------######------
###----------------------------------------------#####----------------------g-------------------------------------------------------------------------------------------------------------#######------
###--------------S----------SS------------------######-------#----------------SSS-----------------S@S------S----------SS----------SS-----#--#-----------##--#----------C----S------------########---S--
###----------------------------------------#---#######------##---------------------------------------------------------------------------#--##---------###--##--------------------------#########------
###------------------------------------tt-##t-########-----###--------------------------------------------------------------------------##--###-------####--###---------------------tt-##########-----F
###M-----------------------------------tt###t#########gg--####------------------------------ggg----------k---------------g-------------###--####----######--####------------g-------tt###########-----#
XXXXXXXXXXXXXXXXXXXXXXXXXXXXXXXXXXXXXXXXXXXXXXXXXXXXXXXXXXXXXXXXXXXXX---XXXXXXXXXXXXXXX---XXXXXXXXXXXXXXXXXXXXXXXXXXXXXXXXXXXXXXXXXXXXXXXXXXXXXXXXXXXXXXXX--XXXXXXXXXXXXXXXXXXXXXXXXXXXXXXXXXXXXXXXXXXX
XXXXXXXXXXXXXXXXXXXXXXXXXXXXXXXXXXXXXXXXXXXXXXXXXXXXXXXXXXXXXXXXXXXXX---XXXXXXXXXXXXXXX---XXXXXXXXXXXXXXXXXXXXXXXXXXXXXXXXXXXXXXXXXXXXXXXXXXXXXXXXXXXXXXXX--XXXXXXXXXXXXXXXXXXXXXXXXXXXXXXXXXXXXXXXXXXX
