-------------------------------------------------------------------------------------------------------------------------------------------------------------------------------------------------------
-------------------------------------------------------------------------------------------------------------------------------------------------------------------------------------------------------
-------------------------------------------------------------------------------------------------------------------------------------------------------------------------------------------------------
-------------------------------------------------------------------------------------------------------------------------------------------------------------------------------------------------------
-------------------------------------------------------------------------------------------------------------------------------------------------------------------------------------------------------
-------------------------------------------------------------------------------------------------------------------------------------------------------------------------------------------------------
--##--------SSSSSS----S!!S----SS----S-----------------------------SSSS----SSS----SSSSSS-S--!!SSSSSS#SSS--SSS----S!!S----SSSSS----S!!S---------------------------SS----S!!S-SSSSSSS------------##-------
-###-----------------------------------------------------------------------------------------------#-----------------------------------------------------------------------------------------###-------
####-----------------------------------------------------------------------------------------------#----------------------------------------------------------------------------------------####-------
####------------------------------------------------------------------------g----------------------#---------------------------------------------------------------------------------------#####-------
####-------------------SS--------------#----------#--------tt--S@S------------S@S----------SS------#-------------SS---@S----------SS--------#----------###--#----------SS-S---------------######tt-----
####-----------------------------------##--------##tt------tt--------------------------------------#-------------------------------------#--##--------####--##---------------------------#######tt-----
####-------------------------#---------###------###tt------tt--------------------------------------#------------------------------------##--###------#####--###---------------------tt--########tt----F
###M------------------------##---------####----####tt-gg---tt-------------------------------ggg----#-----k---------------g-------------###--####----######--####------------g-------tt##########tt----#
XXXXXXXXXXXXXXXXXXXXXXXXXXXXXXXXXXXXXXXXXXXXXXXXXXXXXXXXXXXXXXXXXXXXX---XXXXXXXXXXXXXXX---XXXXXXXXXXXXXXXXXXXXXXXXXXXXXXXXXXXXXXXXXXXXXXXXXXXXXXXXXXXXXXXX--XXXXXXXXXXXXXXXXXXXXX-XXXXXXXXXXXXXXXXXXXXX
XXXXXXXXXXXXXXXXXXXXXXXXXXXXXXXXXXXXXXXXXXXXXXXXXXXXXXXXXXXXXXXXXXXXX---XXXXXXXXXXXXXXX---XXXXXXXXXXXXXXXXXXXXXXXXXXXXXXXXXXXXXXXXXXXXXXXXXXXXXXXXXXXXXXXX--XXXXXXXXXXXXXXXXXXXXX-XXXXXXXXXXXXXXXXXXXXX
