-------------------------------------------------------------------------------------------------------------------------------------------------------------------------------------------------------
-------------------------------------------------------------------------------------------------------------------------------------------------------------------------------------------------------
-------------------------------------------------------------------------------------------------------------------------------------------------------------------------------------------------------
-------------------------------------------------------------------------------------------------------------------------------------------------------------------------------------------------------
-------------------------------------------------------------------------------------------------------------------------------------------------------------------------------------------------------
-------------------------------------------------------------------------------------------------------------------------------------------------------------------------------------------------------
--##-------SSSSSS-SSS!-------SSS----S---------------##------------SSSS----SS-----SSSSSS-S--SSS----S!!S--SSS----S!!SSSSSS--SSS----S!!S---------------------------------SSSSSS-SSSSSSS---------##--------
-###-----------------------------------------------###----------------------------------------------------------------------------------------#---------------------------------------------###--------
####----------------------------------------------####---------------------------------------------------------------------------------------##--------------------------------------------####--------
####---------------------------------------------#####----------------------g---------------------------------------------------------------###-------------------------------------------#####--------
####-----------------C-----------------#--------######----#----S@S------------S@S------------------SS-----------SS----------------SS-------####--------##--#----------------S------------######--t-----
####-----------------------------------##------#######----##------------------------------------------------------------------------------#####-------###--###--------------------------#######--t-----
####-----------------------------------###-----#######----###---------------------------------------------------------------------------#######------####--####-----tt--------------tt-########--t----F
###M-----------------------------------####----#######gg--###-------------------------------ggg----------k---------------g-------------#########----#####--#####----tt------g-------tt#########--t----#
XXXXXXXXXXXXXXXXXXXXXXXXXXXXXXXXXXXXXXXXXXXXXXXXXXXXXXXXXXXXXXXXXXXXX---XXXXXXXXXXXXXXX--XXXXXXXXXXXXXXXXXXXXXXXXXXXXXXXXXXXXXXXXXXXXXXXXXXXXXXXXXXXXXXXX--XXXXXXXXXXXXXXXXXXXXXXXX-XXXXXXXXXXXXXXXXXXX
XXXXXXXXXXXXXXXXXXXXXXXXXXXXXXXXXXXXXXXXXXXXXXXXXXXXXXXXXXXXXXXXXXXXX---XXXXXXXXXXXXXXX--XXXXXXXXXXXXXXXXXXXXXXXXXXXXXXXXXXXXXXXXXXXXXXXXXXXXXXXXXXXXXXXX--XXXXXXXXXXXXXXXXXXXXXXXX-XXXXXXXXXXXXXXXXXXX
