-------------------------------------------------------------------------------------------------------------------------------------------------------------------------------------------------------
-------------------------------------------------------------------------------------------------------------------------------------------------------------------------------------------------------
-------------------------------------------------------------------------------------------------------------------------------------------------------------------------------------------------------
-------------------------------------------------------------------------------------------------------------------------------------------------------------------------------------------------------
-------------------------------------------------------------------------------------------------------------------------------------------------------------------------------------------------------
-------------------------------------------------------------------------------------------------------------------------------------------------------------------------------------------------------
-##----------SSS----S!!S-----SSS----S!--------------#--------------SSS----SSS!-@-SSSSSS-S---SSS!--S!!S----SSSSSSSSSS------SSS----S!!----------------------------------------------------------##----@--
###------------------------------------------------##----------------------------------------------------------------------------------------------------------------------------------------###-------
###-----------------------------------------------###----------------------------------------------------------------------------------------#----------------------------------------------####-------
###----------------------------------------------####-----------------------g---------------------------------------------------------------##---------------------------------------------#####-------
###------------------SS--------------S----------#####-----tt-----------------C-!S--------------C---SS------------------S----------SS-------###---------##--##------------SS!S------------#######----!--
###--------------------------------------------######t----tt------------------------------------------------------------------------------####--------###--###--------------------------########-------
###------------------------#---------------tt-#######t----tt---------------------------------------------#----------------------------tt-######------####--####-----tt--------------tt-#########------F
###M----------------------##---------------tt########tgg--tt--------------------------------ggg---------#k---------------g------------tt########----#####--#####----tt------g-------tt##########------#
XXXXXXXXXXXXXXXXXXXXXXXXXXXXXXXXXXXXXXXXXXXXXXXXXXXXXXXXXXXXXXXXXXXXX---XXXXXXXXXXXXXXX---XXXXXXXXXXXXXXXXXXXXXXXXXXXXXXXXXXXXXXXXXXXXXXXXXXXXXXXXXXXXXXX--XXXXXXXXXXXXXXXXXXXXXXXXXXXXXXXXXXXXXXXXXXXX
XXXXXXXXXXXXXXXXXXXXXXXXXXXXXXXXXXXXXXXXXXXXXXXXXXXXXXXXXXXXXXXXXXXXX---XXXXXXXXXXXXXXX---XXXXXXXXXXXXXXXXXXXXXXXXXXXXXXXXXXXXXXXXXXXXXXXXXXXXXXXXXXXXXXX--XXXXXXXXXXXXXXXXXXXXXXXXXXXXXXXXXXXXXXXXXXXX
