-------------------------------------------------------------------------------------------------------------------------------------------------------------------------------------------------------
-------------------------------------------------------------------------------------------------------------------------------------------------------------------------------------------------------
-------------------------------------------------------------------------------------------------------------------------------------------------------------------------------------------------------
-------------------------------------------------------------------------------------------------------------------------------------------------------------------------------------------------------
-------------------------------------------------------------------------------------------------------------------------------------------------------------------------------------------------------
-------------------------------------------------------------------------------------------------------------------------------------------------------------------------------------------------------
-##-----SSS----S!!S-S!!S-SSSS-----------------------##---------------S--SSSSSS---SSSSSS-S---SSS!SSSSSSSSSSS----S!!S--S!!S-SSS----S!!S------------------------------------S!!S-----------------##-------
###------------------------------------------------###---------------------------------------------------------------------------------------------------------------------------------------###-------
###-----------------------------------------------####--------------------------------------------------------------------------------------------------------------------------------------####-------
###----------------------------------------------#####----------------------g-------------------------------------------------------------------------------------------------------------######-------
###--S----------SS---SS-------------------------######-----tt-----------------S@S--------------C----------------SS----SS----------SS-----#--#----------###--#-------------SS-------------#######-------
###------------------------------------tt-tt----######-----tt----------------------------------------------------------------------------#--##--------####--##--------------------------########-------
###--------------------------tt--------tt-tt----######-----tt---------------------------------------------------------------------------##--###------#####--###-----tt----------#---tt-#########------F
###M-------------------------tt--------tt-tt----######gg---tt-------------------------------ggg----------k---------------g-------------###--####----######--####----tt------g--##---tt##########------#
XXXXXXXXXXXXXXXXXXXXXXXXXXXXXXXXXXXXXXXXXXXXXXXXXXXXXXXXXXXXXXXXXXXXX---XXXXXXXXXXXXXXX---XXXXXXXXXXXXXXXXXXXXXXXXXXXXXXXXXXXXXXXXXXXXXXXXXXXXXXXXXXXXXXXX--XXXXXXXXXXXXXXXXXXXXXXXXXXXXXXXXXXXXXXXXXXX
XXXXXXXXXXXXXXXXXXXXXXXXXXXXXXXXXXXXXXXXXXXXXXXXXXXXXXXXXXXXXXXXXXXXX---XXXXXXXXXXXXXXX---XXXXXXXXXXXXXXXXXXXXXXXXXXXXXXXXXXXXXXXXXXXXXXXXXXXXXXXXXXXXXXXX--XXXXXXXXXXXXXXXXXXXXXXXXXXXXXXXXXXXXXXXXXXX
