-------------------------------------------------------------------------------------------------------------------------------------------------------------------------------------------------------
-------------------------------------------------------------------------------------------------------------------------------------------------------------------------------------------------------
-------------------------------------------------------------------------------------------------------------------------------------------------------------------------------------------------------
-------------------------------------------------------------------------------------------------------------------------------------------------------------------------------------------------------
-------------------------------------------------------------------------------------------------------------------------------------------------------------------------------------------------------
-------------------------------------------------------------------------------------------------------------------------------------------------------------------------------------------------------
-##SSSSSSSS---SSS!--S!!SSSS!--------S-----------------------------SSSS--SSS------SSSSSS-S--SSS----S!!S------SSSSSS---S!!S-SSS----S!!S--------------------------SSS----S!!S---SSSSSS----------#-##------
###-----------------------------------------------------------------------------------------------------------------------------------------------------------------------------------------#####------
###----------------------------------------------------------------------------------------------------------------------------------------------------------------------------------------######------
###-------------------------------------------------------------------------g-------------------------------------------------------------------------------------------------------------#######------
###--------------C---SS----C-----S-----#----------##--------tt----------------S@S------------------SS-----@S----------SS----------SS-------#------------##--#----------SS--@S------------########------
###------------------------------------##--------###tt------tt---------------------------------------------------------------------------#-##----------###--##--------------------------#########------
###------------------------------------###------####tt------tt-------------------------------------------#-----------------------------###-###--------####--##----------------------tt-##########-----F
###M-----------------------------------####----#####ttgg----tt------------------------------ggg---------#k---------------g-------------###-####------#####--##--------------g-------tt###########-----#
XXXXXXXXX---XXXXXXXXXXXXXXXXXXXXXXXXXXXXXXXXXXXXXXXXXXXXXXXXXXXXXXXXX---XXXXXXXXXXXXXXX---XXXXXXXXXXXXXXXXXXXXXXXXXXXXXXXXXXXXXXXXXXXXXXXXXXXXXXXXXXXXXXXX--XXXXXXXXXXXXXXXXXXXXXXXXXXXXXXXXXXXXXXXXXXX
XXXXXXXXX---XXXXXXXXXXXXXXXXXXXXXXXXXXXXXXXXXXXXXXXXXXXXXXXXXXXXXXXXX---XXXXXXXXXXXXXXX---XXXXXXXXXXXXXXXXXXXXXXXXXXXXXXXXXXXXXXXXXXXXXXXXXXXXXXXXXXXXXXXX--XXXXXXXXXXXXXXXXXXXXXXXXXXXXXXXXXXXXXXXXXXX
