-------------------------------------------------------------------------------------------------------------------------------------------------------------------------------------------------------
-------------------------------------------------------------------------------------------------------------------------------------------------------------------------------------------------------
-------------------------------------------------------------------------------------------------------------------------------------------------------------------------------------------------------
-------------------------------------------------------------------------------------------------------------------------------------------------------------------------------------------------------
-------------------------------------------------------------------------------------------------------------------------------------------------------------------------------------------------------
-------------------------------------------------------------------------------------------------------------------------------------------------------------------------------------------------------
--##--SSSS!--SSS----S!!S----------------------------##-------------------SSSSSSSSSSSSSS-S---SSS!-------SSSSSS-SSS----S!!SSSSSS---S!!S----------------------------------------SSS----S---------##-------
-###-----------------------------------------------###---------------------------------------------------------------------------------------------------------------------------------------###-------
####----------------------------------------------####-----------------------------------------------------------------------------------------------------#--------------------------------####-------
####----------------------------------------------####-----------1----------g-----------------------------------------------------------------------------##-------------------------------#####-------
####------C----------SS------------------------#--####----tt-----------------------------------C-----SU---------------SS----------SS-----#--#----------######------------SS!--------------######-tt----
####-----------------------------------tt-tt---##-####----tt----------------------------------------------------------------------------##--##--------########---------------------------#######-tt----
####-------------------------tt--------tt-tt---#######----tt---------------------------------------------------------------------------###--###------##########-----tt---------------tt-########-tt---F
###M----------------------#--tt--------tt-tt---#######gg--tt--------------------------------ggg----------k---------------g------------####--####----############----tt------g--------tt#########-tt---#
XXXXXXXXXXXXXXXXXXXXXXXXXXXXXXXXXXXXXXXXXXXXXXXXXXXXXXXXXXXXXXXXXXXXXX--XXXXXXX-XXXXXX----XXXXXXXXXXXXXXXXXXXXXXXXXXXXXXXXXXXXXXXXXXXXXXXXXXXXXXXXXXXXXXXXXXXXXXXXXXXXXXXXXXXXXXXXXXXXXXXXXXXXXXXXXXXXX
XXXXXXXXXXXXXXXXXXXXXXXXXXXXXXXXXXXXXXXXXXXXXXXXXXXXXXXXXXXXXXXXXXXXXX--XXXXXXX-XXXXXX----XXXXXXXXXXXXXXXXXXXXXXXXXXXXXXXXXXXXXXXXXXXXXXXXXXXXXXXXXXXXXXXXXXXXXXXXXXXXXXXXXXXXXXXXXXXXXXXXXXXXXXXXXXXXX
