-------------------------------------------------------------------------------------------------------------------------------------------------------------------------------------------------------
-------------------------------------------------------------------------------------------------------------------------------------------------------------------------------------------------------
-------------------------------------------------------------------------------------------------------------------------------------------------------------------------------------------------------
-------------------------------------------------------------------------------------------------------------------------------------------------------------------------------------------------------
-------------------------------------------------------------------------------------------------------------------------------------------------------------------------------------------------------
-------------------------------------------------------------------------------------------------------------------------------------------------------------------------------------------------------
-##-----SSS----S!!S---!--------------SSS-----------##------------SSSSS---S----S!!S-SSSS-S---SSS---SSS----S!!S---SS----S!!S--S----S!!S---------------------------SS----S!!-SSSSSS!S------------##----@--
###-----------------------------------------------###----------------------------------------------------------------------------------------------------------------------------------------###-------
###----------------------------------------------####---------------------------------------------------------------------------------------------------------------------------------------####-------
###---------------------------------------------#####-----------------------g--------------------------------------------------------------------------------------------------------------#####-------
###-------------SS---@S!S---------------#------######-----------S--------------SS--------------S----------SS-----------SS---------SS-----#--#----------##--#-----------SSS------S---------######----!--
###-------------------------------------##-----######-----------------------------------------------------------------------------------##--##--------###--##----------------------------#######-------
###-------------------------tt----------###----######----------------------------------------------------------------------------------###--###------####--###-----------------------#t-########--#---F
###M------------------------tt----------####---######-gg------------------------------------ggg----------k-----#---------g------------####--####----#####--####-------------g-------##t#########--#---#
XXXXXXXXXXXXXXXXXXXXXXXXXXXXXXXXXXXXXXXXXXXXXXXXXXXXXXXXXXXXXXXXXXXXX---XXXXXXXXXXXXXXX---XXXXXXXXXXXXXXXXXXXXXXXXXXXXXXXXXXXXXXXXXXXXXXXXXXXXXXXXXXXXXXX--XXXXXXXXXXXXXXXXXXXXXXXXXXXXXXXXXXXXXXXXXXXX
XXXXXXXXXXXXXXXXXXXXXXXXXXXXXXXXXXXXXXXXXXXXXXXXXXXXXXXXXXXXXXXXXXXXX---XXXXXXXXXXXXXXX---XXXXXXXXXXXXXXXXXXXXXXXXXXXXXXXXXXXXXXXXXXXXXXXXXXXXXXXXXXXXXXX--XXXXXXXXXXXXXXXXXXXXXXXXXXXXXXXXXXXXXXXXXXXX
