-------------------------------------------------------------------------------------------------------------------------------------------------------------------------------------------------------
-------------------------------------------------------------------------------------------------------------------------------------------------------------------------------------------------------
-------------------------------------------------------------------------------------------------------------------------------------------------------------------------------------------------------
-------------------------------------------------------------------------------------------------------------------------------------------------------------------------------------------------------
-------------------------------------------------------------------------------------------------------------------------------------------------------------------------------------------------------
-------------------------------------------------------------------------------------------------------------------------------------------------------------------------------------------------------
--##------------SSSSSS-SSSSSSSSS----S-----------------------------SSSS-----------SSSSSS-S---SSS!----SS----S!!S--SSSSS-SSS----S!!SS!!S----------------------------SSSSSSSSSSSS----------------####------
-###----------------------------------------------------------------------------------------------------------------------------------------------------------------------------------------#####------
####------------------------------------------------#--------------------------------------------------------------------------------------------------------------------------------------######------
####------------------------------------------------#-----------------------g-------------------------------------------------------------------------------------------------------------#######------
####------------------S----------------#----------###-----#----S@S------------S@S--------------C-----------SS-----------------SS--SS-----#--#-----------##--#----------------------------########------
####-----------------------------------##--------####t----##----------------------------------------------------------------------------##--##--------####--##--------------------------#########------
####-----------------------------------###------#####t----###--------------------------------------------------------------------------###--###------#####--###---------------------tt-##########-----F
###M-----------------------------------####----######tgg--####------------------------------ggg----------k---------------g------------####--####----######--####------------g-------tt###########-----#
XXXXXXXXXXXXXXXXXXXXXXXXXXXXXXXXXXXXXXXXXXXXXXXXXXXXXXXXXXXXXXXXXXXXXX--XXXXXXXXXXXXXX----XXXXXXXXXXXXXXXXXXXXXXXXXXXXXXXXXXXXXXXXXXXXXXXXXXXXXXXXXXXXXXXX--XXXXXXXXXXXXXXXXXXXXXXXXXXXXXXXXXXXXXXXXXXX
XXXXXXXXXXXXXXXXXXXXXXXXXXXXXXXXXXXXXXXXXXXXXXXXXXXXXXXXXXXXXXXXXXXXXX--XXXXXXXXXXXXXX----XXXXXXXXXXXXXXXXXXXXXXXXXXXXXXXXXXXXXXXXXXXXXXXXXXXXXXXXXXXXXXXX--XXXXXXXXXXXXXXXXXXXXXXXXXXXXXXXXXXXXXXXXXXX
