-------------------------------------------------------------------------------------------------------------------------------------------------------------------------------------------------------
-------------------------------------------------------------------------------------------------------------------------------------------------------------------------------------------------------
-------------------------------------------------------------------------------------------------------------------------------------------------------------------------------------------------------
-------------------------------------------------------------------------------------------------------------------------------------------------------------------------------------------------------
-------------------------------------------------------------------------------------------------------------------------------------------------------------------------------------------------------
-------------------------------------------------------------------------------------------------------------------------------------------------------------------------------------------------------
--##-SSSSSS--SSS----S!!S-----SSS----SS--------------##-----------SSSSS----SSS!---SSSSSS----SSSSSSSSSSS--SSS----S!!S-----SSSSSS--S!!S------------------------------------SSSSSS----------------##-------
-###-----------------------------------------------###---------------------------------------------------------------------------------------------------------------------------------------###-------
####----------------------------------------------####--------------------------------------------------------------------------------------------------------------------------------------####-------
####---------------------------------------------#####----------------------g--------------------------------------------------------------------------------------------------------------#####-------
####-----------------SS--------------------#----######-----tt----------------C----------------------------------SS---S@S---------SS------#--#----------###--#----------S------------------######-tt----
####--------------------------------------##---#######-----tt---------------------------------------------------------------------------##--##--------####--##--------------------------########-tt----
####-------------------------------------###--########-----tt--------------------------------------------------------------------------###--###------#####--###-----tt--------------tt-#########-tt---F
###M----------------------#-------------####--########gg---tt-------------------------------ggg----------k---------------g------------####--####----######--####----tt------g-------tt##########-tt---#
XXXXXXXXXXXXXXXXXXXXXXXXXXXXXXXXXXXXXXXXXXXXXXXXXXXXXXXXXXXXXXXXXXXXX---XXXXXXXXXXXXXX---XXXXXXXXXXXXXXXXXXXXXXXXXXXXXXXXXXXXXXXXXXXXXXXXXXXXXXXXXXXXXXXXX--XXXXXXXXXXXXXXXXXXXXXXXXXXXXXXXXXXXXXXXXXXX
XXXXXXXXXXXXXXXXXXXXXXXXXXXXXXXXXXXXXXXXXXXXXXXXXXXXXXXXXXXXXXXXXXXXX---XXXXXXXXXXXXXX---XXXXXXXXXXXXXXXXXXXXXXXXXXXXXXXXXXXXXXXXXXXXXXXXXXXXXXXXXXXXXXXXX--XXXXXXXXXXXXXXXXXXXXXXXXXXXXXXXXXXXXXXXXXXX
