-------------------------------------------------------------------------------------------------------------------------------------------------------------------------------------------------------
-------------------------------------------------------------------------------------------------------------------------------------------------------------------------------------------------------
-------------------------------------------------------------------------------------------------------------------------------------------------------------------------------------------------------
-------------------------------------------------------------------------------------------------------------------------------------------------------------------------------------------------------
-------------------------------------------------------------------------------------------------------------------------------------------------------------------------------------------------------
-------------------------------------------------------------------------------------------------------------------------------------------------------------------------------------------------------
-##SSS--SSS----S!!S--SSS----S!!S-----------------------------------SSS-------S!!S--SSSS-S----SSSSSSSSS----S!!S----------SSSSSSSSSS!!S-------------------------------S----S!!S----------------####------
###-----------------------------------------------------------------------------------------------------------------------------------------------------------------------------------------#####------
###-----------------------------------------------#----------------------------------------------------------------------------------------------------------------------------------------######------
###----------------------------------------------##-------------------------g-------------------------------------------------------------------------------------------------------------#######------
###-------------SS-----------SS--!--------------###--------tt-----------------SS------------S--------------SS--------S@S----------SS-----#--#----------###--#-------------SS-------------########------
###---------------------------------------tt---####tt------tt---------------------------------------------------------------------------##--##--------####--##--------------------------#########------
###---------------------------------------tt---####tt------tt-------------------------------------------------------------------------t###--###------#####--###-----------------#---tt-##########-----F
###M--------------------------------------tt---####tt-gg---tt-------------------------------ggg----------k------#--------g------------t###--####----######--####------------g--##---tt###########-----#
XXXXXXXXXXXXXXXXXXXXXXXXXXXXXXXXXXXXXXXXXXXXXXXXXXXXXXXXXXXXXXXXXXXXX---XXXXXXXXXXXXXXX---XXXXXXXXXXXXXXXXXXXXXXXXXXXXXXXXXXXXXXXXXXXXXXXXXXXXXXXXXXXXXXXX--XXXXXXXXXXXXXXXXXXXXXXXXXXXXXXXXXXXXXXXXXXX
XXXXXXXXXXXXXXXXXXXXXXXXXXXXXXXXXXXXXXXXXXXXXXXXXXXXXXXXXXXXXXXXXXXXX---XXXXXXXXXXXXXXX---XXXXXXXXXXXXXXXXXXXXXXXXXXXXXXXXXXXXXXXXXXXXXXXXXXXXXXXXXXXXXXXX--XXXXXXXXXXXXXXXXXXXXXXXXXXXXXXXXXXXXXXXXXXX
