-------------------------------------------------------------------------------------------------------------------------------------------------------------------------------------------------------
-------------------------------------------------------------------------------------------------------------------------------------------------------------------------------------------------------
-------------------------------------------------------------------------------------------------------------------------------------------------------------------------------------------------------
-------------------------------------------------------------------------------------------------------------------------------------------------------------------------------------------------------
-------------------------------------------------------------------------------------------------------------------------------------------------------------------------------------------------------
-------------------------------------------------------------------------------------------------------------------------------------------------------------------------------------------------------
-##-SSS----S!!S---------SSSSSSS--------------------##----------SSSSSSS----SS--S!!S--SSS---SSS----S!!S--SSSSSS-SSS----S!---SSS----S!!--------------------------------------SSS----S!-----------##-------
###-----------------------------------------------###----------------------------------------------------------------------------------------------------------------------------------------###-------
###----------------------------------------------####---------------------------------------------------------------------------------------------------------------------------------------####-------
###---------------------------------------------#####-----------------------g--------------------------------------------------------------------------------------------------------------#####-------
###---------SS-------S@S-----------------------######-----ttS@S----------------SS-----------------SS------------------SS----------SS-----#--#----------###--#---------------------S-------######-------
###------------------------------------tt-----#######-----tt----------------------------------------------------------------------------##--##--------####--##---------------------------#######-------
###------------------------------------tt-tt-########-----tt---------------------------------------------------------------------------###--###------#####--###-----tt---------------tt-########------F
###M-----------------------------------tt-tt#########-gg--tt--------------------------------ggg----------k---------------g------------####--####----######--####----tt------g--------tt#########------#
XXXXXXXXXXXXXXXXXXXXXXXXXXXXXX-XXXXXXXXXXXXXXXXXXXXXXXXXXXXXXXXXXXXXX---XXXXXXXXXXXXXX--XXXXXXXXXXXXXXXXXXXXXXXXXXXXXXXXXXXXXXXXXXXXXXXXXXXXXXXXXXXXXXXXXX--XXXXXXXXXXXXXXXXXXXXXXXXXXXXXXXXXXXXXXXXXXX
XXXXXXXXXXXXXXXXXXXXXXXXXXXXXX-XXXXXXXXXXXXXXXXXXXXXXXXXXXXXXXXXXXXXX---XXXXXXXXXXXXXX--XXXXXXXXXXXXXXXXXXXXXXXXXXXXXXXXXXXXXXXXXXXXXXXXXXXXXXXXXXXXXXXXXX--XXXXXXXXXXXXXXXXXXXXXXXXXXXXXXXXXXXXXXXXXXX
