-------------------------------------------------------------------------------------------------------------------------------------------------------------------------------------------------------
-------------------------------------------------------------------------------------------------------------------------------------------------------------------------------------------------------
-------------------------------------------------------------------------------------------------------------------------------------------------------------------------------------------------------
-------------------------------------------------------------------------------------------------------------------------------------------------------------------------------------------------------
-------------------------------------------------------------------------------------------------------------------------------------------------------------------------------------------------------
-------------------------------------------------------------------------------------------------------------------------------------------------------------------------------------------------------
-##------------SSSSSS-SSSSSSS----------------------##-------------SSSS--SSS------SSSSSS-S-!!SS----S!!S--SSS!--SSS----S!!SSSSS----S!!S---------------------------SSSSSSSSSSS---S!!S------------##----@--
###-----------------------------------------------###----------------------------------------------------------------------------------------------------------------------------------------###-------
###-----------------------------------------------###----------------------------------------------------------------------------------------#----------------------------------------------####-------
###-----------------------------------------------###-----------------------g---------------------------------------------------------------##---------------------------------------------#####-------
###------------------S-------------------------tt####-----------@S------------S@S---------SS-------SS------C----------SS----------SS-------###----------##--#--S---------------SS---------######----!--
###------------------------------------tt------tt####-------------------------------------------------------------------------------------####---------###--##------------------------#--#######-#-----
###--------------------------#---------tt------tt####-----------------------------------------------------------------------------------#######-------####--###----------------------##-########-##---F
###M-------------------------##--------tt------tt####-gg------------------------------------ggg----------k---------------g-------------#########-----#####--###-------------g-------############-##---#
XXXXXXXXXXXXXXXXXXXXXXXXXXXXXXXXXXXXXXXXXXXXXXXXXXXXXXXXXXXXXXXXXXXXXX--XXXXXXXXXXXXXXX---XXXXXXXXXXXXXXXXXXXXXXXXXXXXXXXXXXXXXXXXXXXXXXXXXXXXXXXXXXXXXXXX--XXXXXXXXXXXXXXXXXXXXXXXXXXXXXXXXXXXXXXXXXXX
XXXXXXXXXXXXXXXXXXXXXXXXXXXXXXXXXXXXXXXXXXXXXXXXXXXXXXXXXXXXXXXXXXXXXX--XXXXXXXXXXXXXXX---XXXXXXXXXXXXXXXXXXXXXXXXXXXXXXXXXXXXXXXXXXXXXXXXXXXXXXXXXXXXXXXX--XXXXXXXXXXXXXXXXXXXXXXXXXXXXXXXXXXXXXXXXXXX
