-------------------------------------------------------------------------------------------------------------------------------------------------------------------------------------------------------
-------------------------------------------------------------------------------------------------------------------------------------------------------------------------------------------------------
-------------------------------------------------------------------------------------------------------------------------------------------------------------------------------------------------------
-------------------------------------------------------------------------------------------------------------------------------------------------------------------------------------------------------
-------------------------------------------------------------------------------------------------------------------------------------------------------------------------------------------------------
-------------------------------------------------------------------------------------------------------------------------------------------------------------------------------------------------------
-##SSSSSSSS---SSS!-----SSSSSS-----------------------##----------SSSSSS-----SSS!-SSSSSSS-S-SSSSSSSSSSSS----S!!S----------SSSSSS-------------------SSS-----------------SSSSSSS-----------------####------
###------------------------------------------------###--------------------------------------------------------------------------------------------------------------------------------------#####------
###-----------------------------------------------####-------------------------------------------------------------------------------------------------------------------------------------######------
###----------------------------------------------#####----------------------g---------------------------------------------------------------#---------------------------------------------#######------
###--------------C--S@S-------------------##----######--------@S--------------CS---------------------------SS--------S@S------S------------##----------##--#----------------S------------########------
###--------------------------------------###---#######------------------------------------------------------------------------------------####--------###--##---------------------------#########------
###--------------------------#---#------####--########--------------------------------------------------------------------------------tt-######------####--###-----tt---------------tt-##########-----F
###M-------------------------##--##----#####-#########gg------------------------------------ggg----------k------#--------g------------tt########----#####--####----tt-------g-------tt###########-----#
XXXXXXXXX---XXXXXXXXXXXXXXXXXXXXXXXXXXXXXXXX-XXXXXXXXXXXXXXXXXXXXXXXXX---XXXXXXXXXXXXX----XXXXXXXXXXXXXXXXXXXXXXXXXXXXXXXXXXXXXXXXXXXXXXXXXXXXXXXXXXXXXXX--XXXXXXXXXXXXXXXXXXXXXXXXXXXXXXXXXXXXXXXXXXXX
XXXXXXXXX---XXXXXXXXXXXXXXXXXXXXXXXXXXXXXXXX-XXXXXXXXXXXXXXXXXXXXXXXXX---XXXXXXXXXXXXX----XXXXXXXXXXXXXXXXXXXXXXXXXXXXXXXXXXXXXXXXXXXXXXXXXXXXXXXXXXXXXXX--XXXXXXXXXXXXXXXXXXXXXXXXXXXXXXXXXXXXXXXXXXXX
