-------------------------------------------------------------------------------------------------------------------------------------------------------------------------------------------------------
-------------------------------------------------------------------------------------------------------------------------------------------------------------------------------------------------------
-------------------------------------------------------------------------------------------------------------------------------------------------------------------------------------------------------
-------------------------------------------------------------------------------------------------------------------------------------------------------------------------------------------------------
-------------------------------------------------------------------------------------------------------------------------------------------------------------------------------------------------------
-------------------------------------------------------------------------------------------------------------------------------------------------------------------------------------------------------
##-SSSSSSSS---SSS!--SSS----S!!S-----SS--------------##------------SSSS--SS----S!!SSSSSS-S---SS-----SSS----S!!S-SS----S!SSSSSS----S!!------------SSS!------------SSS----S!!SSSS---------------###-------
##-------------------------------------------------###--------------------------------------------------------------------------------------------------------------------------------------####-------
##------------------------------------------------####-------------------------------------------------------------------------------------------------------------------------------------#####-------
##----------------------------------------#------#####----------------------g-------------------------------------------------------------------------------------------------------------######-------
##S--------------C----------SS---S-------##-----######-----#---S@S-------------SS---------------S----------SS---------S-----------SS------###------C---##--#------------SS---------------########------
##--------------------------------------###----#######-----##----------------------------------------------------------------------------#####--------###--##---------------------------##########-----
##-------------------------------------####tt-########-----###--------------------------------------------------------------------------#######------####--###----------------------tt-############---F
##-M----------------------------------#####tt#########gg---####-----------------------------ggg----------k---------------g-------------########-----#####--###--------------g-------tt##############--#
XXXXXXXXX---XXXXXXXXXXXXXXXXXXXXXXXXXXXXXXXXXXXXXXXXXXXXXXXXXXXXXXXXXX--XXXXXXXXXXXXXX----XXXXXXXXXXXXXXXXXXXXXXXXXXXXXXXXXXXXXXXXXXXXXXXXXXXXXXXXXXXXXXX--XXXXXXXXXXXXXXXXXXXXXXXXXXXXXXXXXXXXXXXXXXXX
XXXXXXXXX---XXXXXXXXXXXXXXXXXXXXXXXXXXXXXXXXXXXXXXXXXXXXXXXXXXXXXXXXXX--XXXXXXXXXXXXXX----XXXXXXXXXXXXXXXXXXXXXXXXXXXXXXXXXXXXXXXXXXXXXXXXXXXXXXXXXXXXXXX--XXXXXXXXXXXXXXXXXXXXXXXXXXXXXXXXXXXXXXXXXXXX
