-------------------------------------------------------------------------------------------------------------------------------------------------------------------------------------------------------
-------------------------------------------------------------------------------------------------------------------------------------------------------------------------------------------------------
-------------------------------------------------------------------------------------------------------------------------------------------------------------------------------------------------------
-------------------------------------------------------------------------------------------------------------------------------------------------------------------------------------------------------
-------------------------------------------------------------------------------------------------------------------------------------------------------------------------------------------------------
-------------------------------------------------------------------------------------------------------------------------------------------------------------------------------------------------------
--##-----SSS----S!--S!!S---SSSSSS-S!!S-----------------------------SSS----SSS!--SSSSSSS--SS-SSSSSSSS---SSS!SSSSSSSSSSSS--SSSSSS--S!!S------------------------------------SSS----S!!S----------##-------
-###-----------------------------------------------------------------------------------------------------------------------------------------------------------------------------------------###-------
####----------------------------------------------#-----------------------------------------------------------------------------------------------------------------------------------------####-------
####---------------------------------------------##-------------------------g--------------------------------------------------------------------------------------------------------------#####-------
####-------------S---SS------------SS------#----###--------tt----------------C@S-----------S--------------C------------@S---------SS------#-#-----------##--#--------------------SS------#######-------
####--------------------------------------##---####tt------tt----------------------------------------------------------------------------##-##---------###--##------#-------------------########-------
####-------------------------------------###--#####tt------tt---------------------------------------------------------------------------###-###------#####--###-----##-----------------#########------F
###M----------------------#-------------####--#####tt-gg---tt-------------------------------ggg----------k---------------g-------------####-####----######--####----###-----g---------##########------#
XXXXXXXXXXXXXXXXXXXXXXXXXXXXXXXXXXXXXXXXXXXXXXXXXXXXXXXXXXXXXXXXXXXXX---XXXXXXXXXXXXXX---XXXXXXXXX---XXXXXXXXXXXXXXXXX-XXXXXXXXXXXXXXXXXXXXXXXXXXXXXXXXXXX--XXXXXXXXXXXXXXXXXXXXXXXXXXXXXXXXXXXXXXXXXXX
XXXXXXXXXXXXXXXXXXXXXXXXXXXXXXXXXXXXXXXXXXXXXXXXXXXXXXXXXXXXXXXXXXXXX---XXXXXXXXXXXXXX---XXXXXXXXX---XXXXXXXXXXXXXXXXX-XXXXXXXXXXXXXXXXXXXXXXXXXXXXXXXXXXX--XXXXXXXXXXXXXXXXXXXXXXXXXXXXXXXXXXXXXXXXXXX
