-------------------------------------------------------------------------------------------------------------------------------------------------------------------------------------------------------
-------------------------------------------------------------------------------------------------------------------------------------------------------------------------------------------------------
-------------------------------------------------------------------------------------------------------------------------------------------------------------------------------------------------------
-------------------------------------------------------------------------------------------------------------------------------------------------------------------------------------------------------
-------------------------------------------------------------------------------------------------------------------------------------------------------------------------------------------------------
-------------------------------------------------------------------------------------------------------------------------------------------------------------------------------------------------------
-##----------SSSSSS-----SSSSSSS-----SSS-------------##-------------SSS----SSS!-----SSSS-S---SSS!SSSSSS--SSS!---------S!!S-SSSSS--S!!S-----------------------------SSS----S!!S-----------------##-------
###------------------------------------------------###---------------------------------------------------------------------------------------------------------------------------------------###-------
###-----------------------------------------------####--------------------------------------------------------------------------------------------------------------------------------------####-------
###----------------------------------------------#####----------------------g-------------------------1------------------------------------------------------------------------------------#####-------
###------------------S@S---------S---------#----######-----#-----------------C-----------------C-----------C----------SS----------SS------#-#-----------##--#-------------SS--------------######-------
###---------------------------------------##---#######-----##----------------------------------------------------------------------------##-##---------###--##--------------------------########-------
###--------------------------------------###--########-----###--------------------------------------------------------------------------###-###-------####--###-----------------#---tt-#########------F
###M------------------------------------####--########gg---####-----------------------------ggg----------k---------------g-------------####-####-----#####--####------------g--##---tt##########------#
XXXXXXXXXXXXXXXXXXXXXXXXXXXXXX-XXXXXXXXXXXXXXXXXXXXXXXXXXXXXXXXXXXXXX---XXXXXXXXXXXXXXX---XXXXXXXXXXXXXXXXXXXXXXXXXXXXXXXXXXXXXXXXXXXXXXXXXXXXXXXXXXXXXXXX--XXXXXXXXXXXXXXXXXXXXXXXXXXXXXXXXXXXXXXXXXXX
XXXXXXXXXXXXXXXXXXXXXXXXXXXXXX-XXXXXXXXXXXXXXXXXXXXXXXXXXXXXXXXXXXXXX---XXXXXXXXXXXXXXX---XXXXXXXXXXXXXXXXXXXXXXXXXXXXXXXXXXXXXXXXXXXXXXXXXXXXXXXXXXXXXXXX--XXXXXXXXXXXXXXXXXXXXXXXXXXXXXXXXXXXXXXXXXXX
