-------------------------------------------------------------------------------------------------------------------------------------------------------------------------------------------------------
-------------------------------------------------------------------------------------------------------------------------------------------------------------------------------------------------------
-------------------------------------------------------------------------------------------------------------------------------------------------------------------------------------------------------
-------------------------------------------------------------------------------------------------------------------------------------------------------------------------------------------------------
-------------------------------------------------------------------------------------------------------------------------------------------------------------------------------------------------------
-------------------------------------------------------------------------------------------------------------------------------------------------------------------------------------------------------
--##---------SSS----S!---SSSSSSS------------------------------------SS----SSS!----SSSSS----S-SSSSSSSS---SSS!--SSS----S!!-SSSSSSS-S!!SSSS-----------------------SSSSSS---SSSSSS---------------#-##------
-###-----------------------------------------------#----------------------------------------------------------------------------------------------------------------------------------------#####------
####----------------------------------------------##---------------------------------------------------------------------------------------------------------------------------------------######------
####--------------------------------------#------###------------------------g-------------------------------------------------------------------------------------------------------------#######------
####-----------------SS@S----------------##-----####--------tt---------------C--------------S--------------C----------SSS---------SS------#--#----------##-#---------S@S-----------------########------
####------------------------------------###----#####tt------tt---------------------------------------------------------------------------##--##--------###-##---------------------------#########------
####--------------------------------tt-####tt-######tt------tt--------------------------------------------------------------------------###--###------####-###----------------------tt-##########-----F
###M--------------------------------tt#####tt#######ttgg----tt------------------------------ggg----------k---------------g--------------###--####----#####-####-------------g-------tt###########-----#
XXXXXXXXXXXXXXXXXXXXXXXXXXXXXXX-XXXXXXXXXXXXXXXXXXXXXXXXXXXXXXXXXXXXX---XXXXXXXXXXXXXX---XXXXXXXXXX---XXXXXXXXXXXXXXXXXXXXXXXXX-XXXXXXXXXXXXXXXXXXXXXXXXXX-XXXXXXXXXXXXXXXXXXXXXXXXXXXXXXXXXXXXXXXXXXXX
XXXXXXXXXXXXXXXXXXXXXXXXXXXXXXX-XXXXXXXXXXXXXXXXXXXXXXXXXXXXXXXXXXXXX---XXXXXXXXXXXXXX---XXXXXXXXXX---XXXXXXXXXXXXXXXXXXXXXXXXX-XXXXXXXXXXXXXXXXXXXXXXXXXX-XXXXXXXXXXXXXXXXXXXXXXXXXXXXXXXXXXXXXXXXXXXX
