-------------------------------------------------------------------------------------------------------------------------------------------------------------------------------------------------------
-------------------------------------------------------------------------------------------------------------------------------------------------------------------------------------------------------
-------------------------------------------------------------------------------------------------------------------------------------------------------------------------------------------------------
-------------------------------------------------------------------------------------------------------------------------------------------------------------------------------------------------------
-------------------------------------------------------------------------------------------------------------------------------------------------------------------------------------------------------
-------------------------------------------------------------------------------------------------------------------------------------------------------------------------------------------------------
#-##-SSSSSS--SSS----S!!S-----SSS----S------------------------------SSS----SSSS---SSSSSS-S---SSS!--SSSSSSSSS!---------S!!S-SSS----S!!S-----------------------------------SSS----S!!S-----------##----@--
####-----------------------------------------------------------------------------------------------------------------------------------------------------------------------------------------###-------
####----------------------------------------------------------------------------------------------------------------------------------------------------------------------------------------####-------
####------------------------------------------------------------------------g--------------------------------------------------------------------------------------------------------------#####-------
####S----------------SS------------------------tt-#------------SS!S-----------S@S--------------C-----------C-----S----SS----------SS------###----------##--##-------------------SS--------######----!--
####-----------------------------------tt------tt-##-------------------------------------------------------------------------------------#####--------###--###---------------------------#######-------
####-----------------------#-----------tt------tt-###-----tt----------------------------------------------------------------------------#######------####--####-----tt---------------tt-########------F
###M----------------------##-----------tt------tt-####gg--tt--------------------------------ggg----------k---------------g-------------#########----#####--#####----tt------g--------tt#########------#
XXXXXXXXXXXXXXXXXXXXXXXXXXXXXXXXXXXXXXXXXXXXXXXXXXXXXXXXXXXXXXXXXXXXX---XXXXXXXXXXXXXXX---XXXXXXXXXXXXXXXXXXXXXXXXXXXXXXXXXXXXXXXXXXXXXXXXXXXXXXXXXXXXXXX--XXXXXXXXXXXXXXXXXXXXXXXXXXXXXXXXXXXXXXXXXXXX
XXXXXXXXXXXXXXXXXXXXXXXXXXXXXXXXXXXXXXXXXXXXXXXXXXXXXXXXXXXXXXXXXXXXX---XXXXXXXXXXXXXXX---XXXXXXXXXXXXXXXXXXXXXXXXXXXXXXXXXXXXXXXXXXXXXXXXXXXXXXXXXXXXXXX--XXXXXXXXXXXXXXXXXXXXXXXXXXXXXXXXXXXXXXXXXXXX
