-------------------------------------------------------------------------------------------------------------------------------------------------------------------------------------------------------
-------------------------------------------------------------------------------------------------------------------------------------------------------------------------------------------------------
-------------------------------------------------------------------------------------------------------------------------------------------------------------------------------------------------------
-------------------------------------------------------------------------------------------------------------------------------------------------------------------------------------------------------
-------------------------------------------------------------------------------------------------------------------------------------------------------------------------------------------------------
-------------------------------------------------------------------------------------------------------------------------------------------------------------------------------------------------------
---##------------!S-----SSSSSSSS----S!------------------------------SS----SSS!-----SSSS-S----SSSSSSSS---SSS!SSSSS!---S!!S--SS----S!!S----------------------------SSSSS-SSS----S!!S------------##-------
--###----------------------------------------------------------------------------------------------------------------------------------------------------------------------------------------###-------
-####---------------------------------------------------------------------------------------------------------------------------------------------------------------------------------------####-------
#####-----------------------------------------------------------------------g--------------------------------------------------------------------------------------------------------------#####-------
#####------------S---S@S-------------S-#----------##--------tt---------------C--------------S--------------C-----C----SS----------SS-----#--#----------##--#-------------------SS---------######-------
#####----------------------------------##--------###tt------tt--------------------------------------------------------------------------##--##--------###--##----------------------------#######-------
#####----------------------------------###------####tt------tt--------------------------------------------------------------------------##--###------####--###-----------------------#t-########------F
###M#----------------------------------####----#####ttgg----tt------------------------------ggg----------k---------------g-------------###--####----#####--####-------------g-------##t#########------#
XXXXXXXXXXXXXXXXXXXXXXXXXXXXXXXXXXXXXXXXXXXXXXXXXXXXXXXXXXXXXXXXXXXXX---XXXXXXXXXXXXXXX---XXXXXXXXX---XXXXXXXXXXXXXXXXXXXXXXXXXXXXXXXXXXXXXXXXXXXXXXXXXXX--XXXXXXXXXXXXXXXXXXXXXXXXXXXXXXXXXXXXXXXXXXXX
XXXXXXXXXXXXXXXXXXXXXXXXXXXXXXXXXXXXXXXXXXXXXXXXXXXXXXXXXXXXXXXXXXXXX---XXXXXXXXXXXXXXX---XXXXXXXXX---XXXXXXXXXXXXXXXXXXXXXXXXXXXXXXXXXXXXXXXXXXXXXXXXXXX--XXXXXXXXXXXXXXXXXXXXXXXXXXXXXXXXXXXXXXXXXXXX
