-------------------------------------------------------------------------------------------------------------------------------------------------------------------------------------------------------
-------------------------------------------------------------------------------------------------------------------------------------------------------------------------------------------------------
-------------------------------------------------------------------------------------------------------------------------------------------------------------------------------------------------------
-------------------------------------------------------------------------------------------------------------------------------------------------------------------------------------------------------
-------------------------------------------------------------------------------------------------------------------------------------------------------------------------------------------------------
-------------------------------------------------------------------------------------------------------------------------------------------------------------------------------------------------------
--##--------SSSSSSSSS!!S---SSS!---------------------##-S-------SSSSSSS---SSS----SSSSSSS-S---SSS----SSS----S!!S-SSS----S!!S---SSSSS!!S---------------------------SSS----S!!S-SSSSSSS----------#-##------
-###-----------------------------------------------###--------------------------------------------------------------------------------------------------------------------------------------#####------
####----------------------------------------------####-------------------------------------------------------------------------------------------------------------------------------------######------
####---------------------------------------------#####----------------------g-------------------------------------------------------------------------------------------------------------#######------
####-----------------SS-------C----------##-----######-------#---------------S@S----------------S----------SS----------SS---------SS-----#--#-----------##--#-----------SS-S-------------########------
####------------------------------------###----#######------##--------------------------------------------------------------------------##--##---------###--##--------------------------#########------
####-----------------------------------####tt-########-----###-------------------------------------------------------------------------###--###-------####--##----------------------tt-##########-----F
###M----------------------------------#####tt#########gg--####------------------------------ggg----------k---------------g--#---------####--####-----#####--##--------------g-------tt###########-----#
XXXXXXXXXXXXXXXXXXXXXXXXXXXXXXXXXXXXXXXXXXXXXXXXXXXXXXXXXXXXXXXXXXXXX---XXXXXXXXXXXXXX----XXXXXXXXXXXXXXXXXXXXXXXXXXXXXXXXXXXXXXXXXXXXXXXXXXXXXXXXXXXXXXXX--XXXXXXXXXXXXXXXXXXXXXX-XXXXXXXXXXXXXXXXXXXX
XXXXXXXXXXXXXXXXXXXXXXXXXXXXXXXXXXXXXXXXXXXXXXXXXXXXXXXXXXXXXXXXXXXXX---XXXXXXXXXXXXXX----XXXXXXXXXXXXXXXXXXXXXXXXXXXXXXXXXXXXXXXXXXXXXXXXXXXXXXXXXXXXXXXX--XXXXXXXXXXXXXXXXXXXXXX-XXXXXXXXXXXXXXXXXXXX
