-------------------------------------------------------------------------------------------------------------------------------------------------------------------------------------------------------
-------------------------------------------------------------------------------------------------------------------------------------------------------------------------------------------------------
-------------------------------------------------------------------------------------------------------------------------------------------------------------------------------------------------------
-------------------------------------------------------------------------------------------------------------------------------------------------------------------------------------------------------
-------------------------------------------------------------------------------------------------------------------------------------------------------------------------------------------------------
-------------------------------------------------------------------------------------------------------------------------------------------------------------------------------------------------------
-##------------SSS----S!!S----------SSS-------------------------SSSSSS-----SSS!-!SSSSSS-S---SSSSSSSSS---SSS!--SSS----S!!SSS----S!SSSSSS---------------------------------SSSS----S!------------##-------
###------------------------------------------------------------------------------------------------------------------------------------------------------------------------------------------###-------
###-----------------------------------------------------------------------------------------------------------------------------------------------------------------------------------------####-------
###-------------------------------------------------------------------------g--------------------------------------------------------------------------------------------------------------#####-------
###--------------------SS--------S-------------tt#----------##-S--------------C-S--------------------------C----------SS--------S--------#--#----------##--#---------------------S--------########-----
###---------------------------#---------t------tt##--------###--------------------------------------------------------------------------##--##--------###--##-------tt-------------------#########-----
###--------------------------##---------t------tt###------####-------------------------------------------------------------------------###--###------####--####-----tt---------------tt-##########t---F
###M------------------------###---------t------tt####-gg-######-----------------------------ggg----------k---------------g-------------###--####----#####--####-----tt------g--------tt###########t---#
XXXXXXXXXXXXXXXXXXXXXXXXXXXXXXXXXXXXXXXXXXXXXXXXXXXXXXXXXXXXXXXXXXXXXX---XXXXXXXXXXXXXX---XXXXXXXXX---XXXXXXXXXXXXXXXXXXXXXXXXXXXXXXXXXXXXXXXXXXXXXXXXXXX--XXXXXXXXXXXXXXXXXXXXXXXXXXXXXXXXXXXXXXXXXXXX
XXXXXXXXXXXXXXXXXXXXXXXXXXXXXXXXXXXXXXXXXXXXXXXXXXXXXXXXXXXXXXXXXXXXXX---XXXXXXXXXXXXXX---XXXXXXXXX---XXXXXXXXXXXXXXXXXXXXXXXXXXXXXXXXXXXXXXXXXXXXXXXXXXX--XXXXXXXXXXXXXXXXXXXXXXXXXXXXXXXXXXXXXXXXXXXX
