-------------------------------------------------------------------------------------------------------------------------------------------------------------------------------------------------------
-------------------------------------------------------------------------------------------------------------------------------------------------------------------------------------------------------
-------------------------------------------------------------------------------------------------------------------------------------------------------------------------------------------------------
-------------------------------------------------------------------------------------------------------------------------------------------------------------------------------------------------------
-------------------------------------------------------------------------------------------------------------------------------------------------------------------------------------------------------
-------------------------------------------------------------------------------------------------------------------------------------------------------------------------------------------------------
####----SSS----S!!SSSSSSSS---SSS----SSS-----------------------------SS----SSS!---SSSSSS----SSS----S!!S--------SSS----S!---SSS----S!!S-----------------------------SSS----S!!S-----------------##-------
####-----------------------------------------------------------------------------------------------------------------------------------------------------------------------------------------###-------
####----------------------------------------------------------------------------------------------------------------------------------------------------------------------------------------####-------
####---------------------------------------------------------------1--------g---------------------------------------------------------------#----------------------------------------------#####-------
####------------SS---------------S-----#----------#-------tttt---------------C---------------------SS------S----------SS----------SS-------##----------###--#-------------SS--------------######-------
####-----------------------------------##--------##t------tttt----------------------------------------------------------------------------####--------####--##--------------------------########-------
####-----------------------------------###------###t------tttt------------------------------------------------------------------------tt-######------#####--###---------------------tt-#########------F
###M-----------------------------------####----####t--gg--tttt------------------------------ggg----------k---------------g------------tt########----######--####------------g-------tt##########------#
XXXXXXXXXXXXXXXXXXXXXXXX---XXXXXXXXXXXXXXXXXXXXXXXXXXXXXXXXXXXXXXXXXX---XXXXXXXXXXXXXX---XXXXXXXXXXXXXXXXXXXXXXXXXXXXXXXXXXXXXXXXXXXXXXXXXXXXXXXXXXXXXXXXX--XXXXXXXXXXXXXXXXXXXXXXXXXXXXXXXXXXXXXXXXXXX
XXXXXXXXXXXXXXXXXXXXXXXX---XXXXXXXXXXXXXXXXXXXXXXXXXXXXXXXXXXXXXXXXXX---XXXXXXXXXXXXXX---XXXXXXXXXXXXXXXXXXXXXXXXXXXXXXXXXXXXXXXXXXXXXXXXXXXXXXXXXXXXXXXXX--XXXXXXXXXXXXXXXXXXXXXXXXXXXXXXXXXXXXXXXXXXX
