-------------------------------------------------------------------------------------------------------------------------------------------------------------------------------------------------------
-------------------------------------------------------------------------------------------------------------------------------------------------------------------------------------------------------
-------------------------------------------------------------------------------------------------------------------------------------------------------------------------------------------------------
-------------------------------------------------------------------------------------------------------------------------------------------------------------------------------------------------------
-------------------------------------------------------------------------------------------------------------------------------------------------------------------------------------------------------
-------------------------------------------------------------------------------------------------------------------------------------------------------------------------------------------------------
-##--------SSSSSS-SSSS-------SSS----S!-------------##----------SSSSSSS----S---S!!S-SSSS-S---SSSSSSSSS---SSS!SSSSS----S!!S-SSS----S!--------------------------------------SSS---S!!S----------#-##------
###------------------------------------------------##---------------------------------------------------------------------------------------------------------------------------------------#####------
###------------------------------------------------##--------------------------------------------------------------------------------------------------------------------------------------######------
###------------------------------------------------##-----------------------g---------------------------------------------------------------#---------------------------------------------#######------
###------@S------S--------S----------S-#----------###-------##S----------------SS--------------------------C----------SS----------S--------###---------###--#-------------------SS------#########------
###------------------------------------##--------####------###----------------------------------------------------------------------------####--------####--##-------------------------##########------
###------------------------------------###------#####-----####------------------------------------------------------------------------tt-######------#####--###-----tt----------------###########-----F
###M-----------------------------------####----######-gg-#####------------------------------ggg----------k---------------g------------tt########----######--####----tt------g--------############-----#
XXXXXXXXXXXXXXXXXXXXXXXXXXXXXXXXXXXXXXXXXXXXXXXXXXXXXXXXXXXXXXXXXXXXX---XXXXXXXXXXXXXX----XXXXXXXXX---XXXXXXXXXXXXXXXXXXXXXXXXXXXXXXXXXXXXXXXXXXXXXXXXXXXX--XXXXXXXXXXXXXXXXXXXXXXXXXXXXXXXXXXXXXXXXXXX
XXXXXXXXXXXXXXXXXXXXXXXXXXXXXXXXXXXXXXXXXXXXXXXXXXXXXXXXXXXXXXXXXXXXX---XXXXXXXXXXXXXX----XXXXXXXXX---XXXXXXXXXXXXXXXXXXXXXXXXXXXXXXXXXXXXXXXXXXXXXXXXXXXX--XXXXXXXXXXXXXXXXXXXXXXXXXXXXXXXXXXXXXXXXXXX
