-------------------------------------------------------------------------------------------------------------------------------------------------------------------------------------------------------
-------------------------------------------------------------------------------------------------------------------------------------------------------------------------------------------------------
-------------------------------------------------------------------------------------------------------------------------------------------------------------------------------------------------------
-------------------------------------------------------------------------------------------------------------------------------------------------------------------------------------------------------
-------------------------------------------------------------------------------------------------------------------------------------------------------------------------------------------------------
-------------------------------------------------------------------------------------------------------------------------------------------------------------------------------------------------------
-##-----SSS----S!!S----SSSSSSSS---------------------##------------SSSS----SSSS!!-SSSSSS-S---SSS!SSS-SSSSSSS----S!!SSSS----S!!S---S!!S---------------------------SSS------SSSSSSS!!S----------#-##------
###------------------------------------------------###--------------------------------------------------------------------------------------------------------------------------------------#####------
###-----------------------------------------------####-------------------------------------------------------------------------------------------------------------------------------------######------
###----------------------------------------------#####----------------------g-------------------------------------------------------------------------------------------------------------#######------
###-------------SS---@S-------------------------######---------SUS------------SSS--------------C---S------------SS---------SS-----SS------#-#-----------##--#---------S@S-------SS-------########------
###------------------------------------tt------#######-----------------------------------------------------------------------------------##-##---------###--##-------------------------##########------
###------------------------------------tt-----########----------------------------------------------------------------------------------###-###-------####--###-----------------------###########-----F
###M-----------------------------------tt----#########gg------------------------------------ggg----------k---------------g------#------####-####-----#####--###-------------g--------############-----#
XXXXXXXXXXXXXXXXXXXXXXXXXXXXX--XXXXXXXXXXXXXXXXXXXXXXXXXXXXXXXXXXXXXX---XXXXXXXXXXXXXXX---XXXXXXXXXXXXXXXXXXXXXXXXXXXXXXXXXXXXXXXXXXXXXXXXXXXXXXXXXXXXXXXX--XXXXXXXXXXXXXXXXXXXXXXXXXXXXXXXXXXXXXXXXXXX
XXXXXXXXXXXXXXXXXXXXXXXXXXXXX--XXXXXXXXXXXXXXXXXXXXXXXXXXXXXXXXXXXXXX---XXXXXXXXXXXXXXX---XXXXXXXXXXXXXXXXXXXXXXXXXXXXXXXXXXXXXXXXXXXXXXXXXXXXXXXXXXXXXXXX--XXXXXXXXXXXXXXXXXXXXXXXXXXXXXXXXXXXXXXXXXXX
