-------------------------------------------------------------------------------------------------------------------------------------------------------------------------------------------------------
-------------------------------------------------------------------------------------------------------------------------------------------------------------------------------------------------------
-------------------------------------------------------------------------------------------------------------------------------------------------------------------------------------------------------
-------------------------------------------------------------------------------------------------------------------------------------------------------------------------------------------------------
-------------------------------------------------------------------------------------------------------------------------------------------------------------------------------------------------------
-------------------------------------------------------------------------------------------------------------------------------------------------------------------------------------------------------
--##-----------SSSSSS!!SSSS!-----------------------##-------------SSSS----------SSSSSSS-S---SSS!-----SSSSS--SSSSS---SSS----S!!S--S!!S-----------------------------SSS----S!!S----S------------##-------
-###-----------------------------------------------##----------------------------------------------------------------------------------------------------------------------------------------###-------
####-----------------------------------------------##---------------------------------------------------------------------------------------------------------------------------------------####-------
####-----------------------------------------------##-----------------------g--------------------------------------------------------------------------------------------------------------#####-------
####-----------------SS----C-----SU----#----------###------tt--S@S-----------S@S---------------C----------@S-----S----------SS----SS--------#----------###--#-------------SS--------------######-------
####-----------------------------------##--------####------tt----------------------------------------------------------------------------#--##--------####--##---------------------------#######-------
####-----------------------------------###------#####------tt---------------------------------------------------------------------------##--###------#####--###-----------------#---tt--########------F
###M-----------------------------------####----######-gg---tt-------------------------------ggg----------k---------------g-------------###--####----######--####------------g--##---tt##########------#
XXXXXXXXXXXXXXXXXXXXXXXXXXXXXXXXXXXXXXXXXXXXXXXXXXXXXXXXXXXXXXXXXXXXX---XXXXXXXXXXXXXX----XXXXXXXXXXXXXXXXXXXXXXXXXXXXXXXXXXXXXXXXXXXXXXXXXXXXXXXXXXXXXXXXXXXXXXXXXXXXXXXXXXXXXXXXXXXXXXXXXXXXXXXXXXXXX
XXXXXXXXXXXXXXXXXXXXXXXXXXXXXXXXXXXXXXXXXXXXXXXXXXXXXXXXXXXXXXXXXXXXX---XXXXXXXXXXXXXX----XXXXXXXXXXXXXXXXXXXXXXXXXXXXXXXXXXXXXXXXXXXXXXXXXXXXXXXXXXXXXXXXXXXXXXXXXXXXXXXXXXXXXXXXXXXXXXXXXXXXXXXXXXXXX
