-------------------------------------------------------------------------------------------------------------------------------------------------------------------------------------------------------
-------------------------------------------------------------------------------------------------------------------------------------------------------------------------------------------------------
-------------------------------------------------------------------------------------------------------------------------------------------------------------------------------------------------------
-------------------------------------------------------------------------------------------------------------------------------------------------------------------------------------------------------
-------------------------------------------------------------------------------------------------------------------------------------------------------------------------------------------------------
-------------------------------------------------------------------------------------------------------------------------------------------------------------------------------------------------------
-##----------SSS----S!!-@-----------SSS-------------##-------------SSS----SSS!---SSSSSS-S---SSS!----SSSSSSS----S!!S--S!!S-SSS----S!!S---------------------------SSS----S!!SSSSSSSSSSS----------##------
###------------------------------------------------###----------------------------------------------------------------------------------------------------------------------------------------###------
###-----------------------------------------------####-------------------------------------------------------------------------------------------------------------------------------------#-####------
###----------------------------------------------#####----------------------g-------------------------------------------------------------------------------------------------------------#######------
###-------S----------SS-!--!-----S--------------######----tt-----------------C-----------------C----------------SS----SS----------SS-----#--#-----------##--#-----------SS---------------########------
###--------------------------------------------#######----tt----------------------------------------------------------------------------##--##---------###--##--------------------------#########------
###----------------------------------------tt-########----tt---------------------------------------------------------------------------###--###------#####--##-----------------------t-##########-----F
###M---------------------------------------tt#########gg--tt--------------------------------ggg----------k---------------g------------####--####----######--##--------------g--------t###########-----#
XXXXXXXXXXXXXXXXXXXXXXXXXXXXXXXXXXXXXXXXXXXXXXXXXXXXXXXXXXXXXXXXXXXXX---XXXXXXXXXXXXXXX---XXXXXXXXXXXXXXXXXXXXXXXXXXXXXXXXXXXXXXXXXXXXXXXXXXXXXXXXXXXXXXXX--XXXXXXXXXXXXXXXXXXXXXXXXXXXXXXXXXXXXXXXXXXX
XXXXXXXXXXXXXXXXXXXXXXXXXXXXXXXXXXXXXXXXXXXXXXXXXXXXXXXXXXXXXXXXXXXXX---XXXXXXXXXXXXXXX---XXXXXXXXXXXXXXXXXXXXXXXXXXXXXXXXXXXXXXXXXXXXXXXXXXXXXXXXXXXXXXXX--XXXXXXXXXXXXXXXXXXXXXXXXXXXXXXXXXXXXXXXXXXX
