-------------------------------------------------------------------------------------------------------------------------------------------------------------------------------------------------------
-------------------------------------------------------------------------------------------------------------------------------------------------------------------------------------------------------
-------------------------------------------------------------------------------------------------------------------------------------------------------------------------------------------------------
-------------------------------------------------------------------------------------------------------------------------------------------------------------------------------------------------------
-------------------------------------------------------------------------------------------------------------------------------------------------------------------------------------------------------
-------------------------------------------------------------------------------------------------------------------------------------------------------------------------------------------------------
--##---------SSS----S!!S-----SSS----S!-------------##--S-----------SSS----SSS!##!SSSSSS-S---SSSS-SSSSSS-SSS----S!!S------SSSSSS--S!!S-----------SSSSSSS---------------SSS----S!!S------------####------
-###----------------------------------------------###-------------------------##------------------------------------------------------------------------------------------------------------#####------
####---------------------------------------------####-------------------------##-----------------------------------------------------------------------------------------------------------######------
####--------------------------------------------#####-----------------------g-##----------------------------------------------------------------------------------------------------------#######------
####-----------------SS---S----------S---------######-----#------------------C##S---------------S---------------SS----S@S---------SS------#--#----------##-#------------------SS---------########------
####-----------------------------------t------#######-----##------------------##---------------------------------------------------------##--##--------###-##---------------------------#########------
####-----------------------------------t--tt-########-----###-----------------##--------------------------------------------------------###--##--------###-###-----tt---------------tt-##########-----F
###M-----------------------------------t--tt#########-gg--####----#-----------##------------ggg----------k---------------g-------------####--##--------###-####----tt-------g-------tt###########-----#
XXXXXXXXXXXXXXXXXXXXXXXXXXXXXXXXXXXXXXXXXXXXXXXXXXXXXXXXXXXXXXXXXXXXX---XXXXXXXXXXXXXXX---XXXXXXXXXXXXXXXXXXXXXXXXXXXXXXXXXXXXXXXXXXXXXXXXXXXXXXXXXXXXXXXX-XXXXXXXXXXXXXXXXXXXXXXXXXXXXXXXXXXXXXXXXXXXX
XXXXXXXXXXXXXXXXXXXXXXXXXXXXXXXXXXXXXXXXXXXXXXXXXXXXXXXXXXXXXXXXXXXXX---XXXXXXXXXXXXXXX---XXXXXXXXXXXXXXXXXXXXXXXXXXXXXXXXXXXXXXXXXXXXXXXXXXXXXXXXXXXXXXXX-XXXXXXXXXXXXXXXXXXXXXXXXXXXXXXXXXXXXXXXXXXXX
