-------------------------------------------------------------------------------------------------------------------------------------------------------------------------------------------------------
-------------------------------------------------------------------------------------------------------------------------------------------------------------------------------------------------------
-------------------------------------------------------------------------------------------------------------------------------------------------------------------------------------------------------
-------------------------------------------------------------------------------------------------------------------------------------------------------------------------------------------------------
-------------------------------------------------------------------------------------------------------------------------------------------------------------------------------------------------------
-------------------------------------------------------------------------------------------------------------------------------------------------------------------------------------------------------
-##-----------S--------SSSSSSSS----S!!S-------------##------------SSSS--SSSSSSS!!SSSSSS-----SSS!---!SS----S!!S-SS----S!!--SSS----S!!SS-----------------------------------SSS----S!!S---------##-----!S-
###------------------------------------------------###--------------------------------------------------------------------------------------------------------------------------------------###--------
###-----------------------------------------------####-------------------------------------------------------------------------------------------------------------------------------------####--------
###----------------------------------------------#####----------------------g-------------------------------------------------------------------------------------------------------------#####--------
###-----------------S@S-------------SS----------######----#----S@S-------------SS--------------C---C-------SS---------SS----------SS-----#--#----------##--##--------------------SS------######-----S--
###----------------------------------------#---#######----##----------------------------------------------------------------------------##--##--------###--###--------------------------#######--------
###---------------------------------------##t-########----###--------------------------------------------------------------------------###--###------####--####-----tt--------------tt-########-------F
###M-------------------------------------###t#########gg--####------------------------------ggg----------k---------------g------------####--####----#####--#####----tt------g-------tt#########-------#
XXXXXXXXXXXXXXXXXXXXXXXXXXXXXXXXXXXXXXXXXXXXXXXXXXXXXXXXXXXXXXXXXXXXXX--XXXXX-XXXXXXXX----XXXXXXXXXXXXXXXXXXXXXXXXXXXXXXXXXXXXXXXXXXXXXXXXXXXXXXXXXXXXXXX--XXXXXXXXXXXXXXXXXXXXXXXXXXXXXXXXXXXXXXXXXXXX
XXXXXXXXXXXXXXXXXXXXXXXXXXXXXXXXXXXXXXXXXXXXXXXXXXXXXXXXXXXXXXXXXXXXXX--XXXXX-XXXXXXXX----XXXXXXXXXXXXXXXXXXXXXXXXXXXXXXXXXXXXXXXXXXXXXXXXXXXXXXXXXXXXXXX--XXXXXXXXXXXXXXXXXXXXXXXXXXXXXXXXXXXXXXXXXXXX
