-------------------------------------------------------------------------------------------------------------------------------------------------------------------------------------------------------
-------------------------------------------------------------------------------------------------------------------------------------------------------------------------------------------------------
-------------------------------------------------------------------------------------------------------------------------------------------------------------------------------------------------------
-------------------------------------------------------------------------------------------------------------------------------------------------------------------------------------------------------
-------------------------------------------------------------------------------------------------------------------------------------------------------------------------------------------------------
-------------------------------------------------------------------------------------------------------------------------------------------------------------------------------------------------------
--##-------------------SSSSSSS----S!!S--------------##--S-------SSSSSS--SSS----S!!S--SS----SSSSSSSS!-----SSS----S!!S--!!S-#SS----S!!S----------------------------------------------------------##------
-###-----------------------------------------------###--------------------------------------------------------------------#-----------------------------------------------------------------#-###------
####----------------------------------------------####--------------------------------------------------------------------#----------------------------------------------------------------######------
####---------------------------------------------#####----------------------g---------------------------------------------#-----------------------------------------------1---------------#######------
####----------------S@S------------SS------#----######-----#--------------------SS-----------------C-------------SS---SS--#-------SS------#------------###--#--------------!S------------########------
####--------------------------------------##---#######-----##-------------------------------------------------------------#--------------##--#--------####--##------#-------------------#########------
####-------------------------------------###--########-----###------------------------------------------------------------#-------------###--##------#####--###-----##--------------tt-##########-----F
###M------------------------------------####-#########gg---####-----------------------------ggg----------k---------------g#------------####--###----######--####----###-----g-------tt###########-----#
XXXXXXXXXXXXXXXXXXXXXXXXXXXXXXXXXXXXXXXXXXXXXXXXXXXXXXXXXXXXXXXXXXXXX---XXXXXXXXXXXXXX---XXXXXXXXXXXXXXXXXXXXXXXXXXXXXXXXXXXXXXXXXXXXXXXXXXXXXXXXXXXXXXXXX--XXXXXXXXXXXXXXXXXXXXXXXXXXXXXXXXXXXXXXXXXXX
XXXXXXXXXXXXXXXXXXXXXXXXXXXXXXXXXXXXXXXXXXXXXXXXXXXXXXXXXXXXXXXXXXXXX---XXXXXXXXXXXXXX---XXXXXXXXXXXXXXXXXXXXXXXXXXXXXXXXXXXXXXXXXXXXXXXXXXXXXXXXXXXXXXXXX--XXXXXXXXXXXXXXXXXXXXXXXXXXXXXXXXXXXXXXXXXXX
