-------------------------------------------------------------------------------------------------------------------------------------------------------------------------------------------------------
-------------------------------------------------------------------------------------------------------------------------------------------------------------------------------------------------------
-------------------------------------------------------------------------------------------------------------------------------------------------------------------------------------------------------
-------------------------------------------------------------------------------------------------------------------------------------------------------------------------------------------------------
-------------------------------------------------------------------------------------------------------------------------------------------------------------------------------------------------------
-------------------------------------------------------------------------------------------------------------------------------------------------------------------------------------------------------
--##------SS----S!!S----SSSSSSSS---SS--------------##----------SSSSSSS----S------SSSSSS-S---SSS!----SSS----S!!S--#SSSS----SSS----S!!S-----------SSSSS------------S----S!!SS----S!!S----------##--------
-###-----------------------------------------------##------------------------------------------------------------#--------------------------------------------------------------------------###--------
####-----------------------------------------------##------------------------------------------------------------#-------------------------------------------------------------------------####--------
####-----------------------------------------------##-----------------------g------------------------------------#------------------------------------------------------------------------#####--------
####-------------SS--S@S-------------------------tt##-------S@S---------------S@S--------------C------------SS---#-----S----------SS-----#--#-----------##--#----------SS-------SS-------######--------
####-----------------------------------tttt------tt##------------------------------------------------------------#----------------------##--##---------###--##--------------------------#######--------
####-----------------------------------tttt------tt##------------------------------------------------------------#---------------------###--###-------####--###---------------------tt-########---t---F
###M-----------------------------------tttt------tt##-gg------------------------------------ggg----------k-------#-------g------------####--####-----#####--####------------g-------tt#########---t---#
XXXXXXXXXXXXXXXXXXXXXXXXXXXXXX---XXXXXXXXXXXXXXXXXXXXXXXXXXXXXXXXXXXX---XXXXXXXXXXXXXX----XXXXXXXXXXXXXXXXXXXXXXXXXXXXXXXXXXXXXXXXXXXXXXXXXXXXXXXXXXXXXXXX--XXXXXXXXXXXXXXXXXXXXXXXXXXXXXXXXXXXXXXXXXXX
XXXXXXXXXXXXXXXXXXXXXXXXXXXXXX---XXXXXXXXXXXXXXXXXXXXXXXXXXXXXXXXXXXX---XXXXXXXXXXXXXX----XXXXXXXXXXXXXXXXXXXXXXXXXXXXXXXXXXXXXXXXXXXXXXXXXXXXXXXXXXXXXXXX--XXXXXXXXXXXXXXXXXXXXXXXXXXXXXXXXXXXXXXXXXXX
