-------------------------------------------------------------------------------------------------------------------------------------------------------------------------------------------------------
-------------------------------------------------------------------------------------------------------------------------------------------------------------------------------------------------------
-------------------------------------------------------------------------------------------------------------------------------------------------------------------------------------------------------
-------------------------------------------------------------------------------------------------------------------------------------------------------------------------------------------------------
-------------------------------------------------------------------------------------------------------------------------------------------------------------------------------------------------------
-------------------------------------------------------------------------------------------------------------------------------------------------------------------------------------------------------
--##-------S----S!!S----SSS----S------------------------------------SS----SSS!---SSSSSS-S---SS----S!!S---SS----S!!S-----SSSSSSS--S!!S-----------------------------------SSSSSSSSSSSSS---------##-------
-###-----------------------------------------------------------------------------------------------------------------------------------------------------------------------------------------###-------
####----------------------------------------------#-----------------------------------------------------------------------------------------------------------------------------------------####-------
####---------------------------------------------##-------------------------g--------------------------------------------------------------------------------------------------------------#####-------
####-------------SS--S--------------------------###--------tt----------------C---------------------SS-----------SS---S@S----------SS------#-#----------##--#------------------------------######-------
####-------------------------------------------####tt------tt----------------------------------------------------------------------------##-##--------###--##----------------------------#######-------
####-----------------------------------tt-#tt-#####tt------tt---------------------------------------------------------------------------###-###------####--###-----tt----------------tt-########------F
###M-----------------------------------tt##tt######tt-gg---tt-------------------------------ggg---------#k---------------g-------------####-####----#####--####----tt-------g--------tt#########------#
XXXXXXXXXXXXXXXXXXXXXXXXXXXXXXXXXXXXXXXXXXXXXXXXXXXXXXXXXXXXXXXXXXXXX---XXXXXXXXXXXXXXX---XXXXXXXXXXXXXXXXXXXXXXXXXXXXXXXXXXXXXXXXXXXXXXXXXXXXXXXXXXXXXXX--XXXXXXXXXXXXXXXXXXXXXXXXXXXXXXXXXXXXXXXXXXXX
XXXXXXXXXXXXXXXXXXXXXXXXXXXXXXXXXXXXXXXXXXXXXXXXXXXXXXXXXXXXXXXXXXXXX---XXXXXXXXXXXXXXX---XXXXXXXXXXXXXXXXXXXXXXXXXXXXXXXXXXXXXXXXXXXXXXXXXXXXXXXXXXXXXXX--XXXXXXXXXXXXXXXXXXXXXXXXXXXXXXXXXXXXXXXXXXXX
