-------------------------------------------------------------------------------------------------------------------------------------------------------------------------------------------------------
-------------------------------------------------------------------------------------------------------------------------------------------------------------------------------------------------------
-------------------------------------------------------------------------------------------------------------------------------------------------------------------------------------------------------
-------------------------------------------------------------------------------------------------------------------------------------------------------------------------------------------------------
-------------------------------------------------------------------------------------------------------------------------------------------------------------------------------------------------------
-------------------------------------------------------------------------------------------------------------------------------------------------------------------------------------------------------
--##--------SSSS----S!!SSSS!--------------------------------------SSSS-----------SSSSSS-S---SS-------SSSSSS-SSSSSSSSSS!!S--SSSSSS----------------------------------------SS----S!!S-----------##-------
-###-----------------------------------------------------------------------------------------------------------------------------------------------------------------------------------------###-------
####-----------------------------------------------------------------------------------------------------------------------------------------#----------------------------------------------####-------
####------------------------------------------------------------------------g---------------------------------------------------------------##---------------------------------------------#####-------
####-----------------SS----C-----S-------------tt-#------------S@S------------S@S-----------------S@S------S----------SS-------------------###----------##--#-------------------SS------#-######-------
####-----------------------------------tt------tt-##--------#-----------------------------------------------------------------------------####---------###--##-------------------------#########-------
####-----------------------------------tt------tt-###------##-------------------------------------------------------------------------tt-######------#####--###-----tt----------------##########------F
###M-----------------------------------tt------tt-####gg--###-------------------------------ggg----------k---------------g------------tt########----######--####----tt------g--------###########------#
XXXXXXXXXXXXXXXXXXXXXXXXXXXXXXXXXXXXXXXXXXXXXXXXXXXXXXXXXXXXXXXXXXXXXX--XXXXXXXXXXXXXXX---XXXXXXXXXXXXXXXXXXXXXXXXXXXXXXXXXXXXXXXXXXXXXXXXXXXXXXXXXXXXXXXX--XXXXXXXXXXXXXXXXXXXXXXXXXXXXXXXXXXXXXXXXXXX
XXXXXXXXXXXXXXXXXXXXXXXXXXXXXXXXXXXXXXXXXXXXXXXXXXXXXXXXXXXXXXXXXXXXXX--XXXXXXXXXXXXXXX---XXXXXXXXXXXXXXXXXXXXXXXXXXXXXXXXXXXXXXXXXXXXXXXXXXXXXXXXXXXXXXXX--XXXXXXXXXXXXXXXXXXXXXXXXXXXXXXXXXXXXXXXXXXX
