-------------------------------------------------------------------------------------------------------------------------------------------------------------------------------------------------------
-------------------------------------------------------------------------------------------------------------------------------------------------------------------------------------------------------
-------------------------------------------------------------------------------------------------------------------------------------------------------------------------------------------------------
-------------------------------------------------------------------------------------------------------------------------------------------------------------------------------------------------------
-------------------------------------------------------------------------------------------------------------------------------------------------------------------------------------------------------
-------------------------------------------------------------------------------------------------------------------------------------------------------------------------------------------------------
--##----------------S!!S---------------------------##--------------------SSSSSSSSSSSSSS-S---SS----S!!S--SSSSSSSS---SSS!---SSS----S!!S-----------SSSSSS------------------SSSSSSSS-!S-----------##-------
-###----------------------------------------------###----------------------------------------------------------------------------------------------------------------------------------------###-------
####---------------------------------------------####---------------------------------------------------------------------------------------------------------------------------------------####-------
####--------------------------------------------#####------------1----------g--------------------------------------------------------------------------------------------------------------#####-------
####-----------------SS------------------------######-----tt------------S--------------------------SS-----------------CS----------SS------#--#-S--------##--#--------------------S--------######-------
####-----------------------------------t------#######-----tt-----------------------------------------------------------------------------##--##--------###--##------#------------------#-#######-------
####-------------------------tt--------t--tt-########-----tt----------------------------------------------------------------------------###--##-------####--###-----##----------t-----##########------F
###M----------------------#--tt--------t--tt#########-gg--tt--------------------------------ggg----------k---------------g-------------####--##-------####--####----###-----g---t----###########------#
XXXXXXXXXXXXXXXXXXXXXXXXXXXXXXXXXXXXXXXXXXXXXXXXXXXXXXXXXXXXXXXXXXXXXX--XXXXXXXXXXXXXXX---XXXXXXXXXXXXXXXXXXXX---XXXXXXXXXXXXXXXXXXXXXXXXXXXXXXXXXXXXXXXXX--XXXXXXXXXXXXXXXXXXXXXXXXXXXXXXXXXXXXXXXXXXX
XXXXXXXXXXXXXXXXXXXXXXXXXXXXXXXXXXXXXXXXXXXXXXXXXXXXXXXXXXXXXXXXXXXXXX--XXXXXXXXXXXXXXX---XXXXXXXXXXXXXXXXXXXX---XXXXXXXXXXXXXXXXXXXXXXXXXXXXXXXXXXXXXXXXX--XXXXXXXXXXXXXXXXXXXXXXXXXXXXXXXXXXXXXXXXXXX
