-------------------------------------------------------------------------------------------------------------------------------------------------------------------------------------------------------
-------------------------------------------------------------------------------------------------------------------------------------------------------------------------------------------------------
-------------------------------------------------------------------------------------------------------------------------------------------------------------------------------------------------------
-------------------------------------------------------------------------------------------------------------------------------------------------------------------------------------------------------
-------------------------------------------------------------------------------------------------------------------------------------------------------------------------------------------------------
-------------------------------------------------------------------------------------------------------------------------------------------------------------------------------------------------------
--##---SSS!---------SSS----S!!S--------------------##-----------SSSSSS----S-----SSSSSSS-S---SS----S!!S----SSSSS---------SSSSSS--S!!S--------------------------------SSS----S!!S--------------#-##------
-###----------------------------------------------###---------------------------------------------------------------------------------------------------------------------------------------#####------
####---------------------------------------------####--------------------------------------------------------------------------------------------------------------------------------------######------
####--------------------------------------------#####-----------------------g-------------------------------------------------------------------------------------------------------------#######------
####------C------S----------SS-----------------t#####------------------------S@S-------------------SS----------------S@S---------SS------#--#----------##--#----------------SS-----------########------
####-----------------------------------tt------t#####-----------------------------------------------------------------------------------##--##--------###--##---------------------------#########------
####-----------------------------------tt------t#####----------------------------------------------------#-----------------------------###--###------####--###----------------------tt-##########-----F
###M-----------------------------------tt------t#####-gg------------------------------------ggg---------#k---------------g------------####--####----#####--####-------------g-------tt###########-----#
XXXXXXXXXXXXXXXXXXXXXXXXXXXXXXXXXXXXXXXXXXXXXXXXXXXXXXXXXXXXXXXXXXXXX---XXXXXXXXXXXXXX----XXXXXXXXXXXXXXXXXXXXXXXXXXXXXXXXXXXXXXXXXXXXXXXXXXXXXXXXXXXXXXX--XXXXXXXXXXXXXXXXXXXXXXXXXXXXXXXXXXXXXXXXXXXX
XXXXXXXXXXXXXXXXXXXXXXXXXXXXXXXXXXXXXXXXXXXXXXXXXXXXXXXXXXXXXXXXXXXXX---XXXXXXXXXXXXXX----XXXXXXXXXXXXXXXXXXXXXXXXXXXXXXXXXXXXXXXXXXXXXXXXXXXXXXXXXXXXXXX--XXXXXXXXXXXXXXXXXXXXXXXXXXXXXXXXXXXXXXXXXXXX
