-------------------------------------------------------------------------------------------------------------------------------------------------------------------------------------------------------
-------------------------------------------------------------------------------------------------------------------------------------------------------------------------------------------------------
-------------------------------------------------------------------------------------------------------------------------------------------------------------------------------------------------------
-------------------------------------------------------------------------------------------------------------------------------------------------------------------------------------------------------
-------------------------------------------------------------------------------------------------------------------------------------------------------------------------------------------------------
-------------------------------------------------------------------------------------------------------------------------------------------------------------------------------------------------------
--##SSSSSSS---SSS!----SSSSSS------------------------##--------------SS----SSS---SSSSSSS-S---SSS!---SSS----S!!SSSS----S!!S-SSSS---S!!S----------------------------SSSSS-SSS----S!!S------------##-------
-###-----------------------------------------------###---------------------------------------------------------------------------------------------------------------------------------------###-------
####----------------------------------------------####--------------------------------------------------------------------------------------------------------------------------------------####-------
####---------------------------------------------#####-------------1--------g--------------------------------------------------------------------------------------------------------------#####-------
####-------------C--@S--------------------------######------tt---------------S@S---------------C-----------SS---------SS----------SS------#--#---------###--#------------------SS---------######-------
####-----------------------------------tt------#######------tt---------------------------------------------------------------------------##--#--------####--##---------------------------#######-------
####-------------------------tt--------tt--tt-########------tt--------------------------------------------------------------------------###--#t------#####--###----------------------tt-########------F
###M-------------------------tt--------tt--tt#########gg----tt------------------------------ggg----------k---------------g-------------####--#t#----######--####------------g-------#tt#########------#
XXXXXXXXX---XXXXXXXXXXXXXXXXXXXXXXXXXXXXXXXXXXXXXXXXXXXXXXXXXXXXXXXXX---XXXXXXXXXXXXXX----XXXXXXXXXXXXXXXXXXXXXXXXXXXXXXXXXXXXXXXXXXXXXXXXXXXXXXXXXXXXXXXXXXXXXXXXXXXXXXXXXXXXXXXXXXXXXXXXXXXXXXXXXXXXX
XXXXXXXXX---XXXXXXXXXXXXXXXXXXXXXXXXXXXXXXXXXXXXXXXXXXXXXXXXXXXXXXXXX---XXXXXXXXXXXXXX----XXXXXXXXXXXXXXXXXXXXXXXXXXXXXXXXXXXXXXXXXXXXXXXXXXXXXXXXXXXXXXXXXXXXXXXXXXXXXXXXXXXXXXXXXXXXXXXXXXXXXXXXXXXXX
