-------------------------------------------------------------------------------------------------------------------------------------------------------------------------------------------------------
-------------------------------------------------------------------------------------------------------------------------------------------------------------------------------------------------------
-------------------------------------------------------------------------------------------------------------------------------------------------------------------------------------------------------
-------------------------------------------------------------------------------------------------------------------------------------------------------------------------------------------------------
-------------------------------------------------------------------------------------------------------------------------------------------------------------------------------------------------------
-------------------------------------------------------------------------------------------------------------------------------------------------------------------------------------------------------
--##--------------------SSSSSSS--S!!S---------------##------------SSSS----SSS!---SSSSSS-S-SSS----S!!SSSSSS----SSS----S!!SSSSSSS--S!!S-------------------------------------SSS----S!-----------##-------
-###-----------------------------------------------###---------------------------------------------------------------------------------------------------------------------------------------###-------
####----------------------------------------------####--------------------------------------------------------------------------------------------------------------------------------------####-------
####---------------------------------------------#####----------------------g--------------------------------------------------------------------------------------------------------------#####-------
####-----------------S@S----------SS------#-----######-----tt--S@S-----------C--S-----------------SS-------S----------SS----------SS--------#-----------##--#----------S----------S-------######-------
####-------------------------------------##----#######-----tt----------------------------------------------------------------------------#--##---------###--##---------------------------#######-------
####------------------------------------###---########-----tt---------------------------------------------------------------------------##--###------#####--###----------------------tt-########------F
###M-----------------------------------####--#########gg---tt-------------------------------ggg----------k---------------g-------------###--####----######--####------------g--------tt#########------#
XXXXXXXXXXXXXXXXXXXXXXXXXXXXXX-XXXXXXXXXXXXXXXXXXXXXXXXXXXXXXXXXXXXXX---XXXXXXXXXXXXXXX---XXXXXXXXXXXXXXXXXXXXXXXXXXXXXXXXXXXX-XXXXXXXXXXXXXXXXXXXXXXXXXXX--XXXXXXXXXXXXXXXXXXXXXXXXXXXXXXXXXXXXXXXXXXX
XXXXXXXXXXXXXXXXXXXXXXXXXXXXXX-XXXXXXXXXXXXXXXXXXXXXXXXXXXXXXXXXXXXXX---XXXXXXXXXXXXXXX---XXXXXXXXXXXXXXXXXXXXXXXXXXXXXXXXXXXX-XXXXXXXXXXXXXXXXXXXXXXXXXXX--XXXXXXXXXXXXXXXXXXXXXXXXXXXXXXXXXXXXXXXXXXX
