-------------------------------------------------------------------------------------------------------------------------------------------------------------------------------------------------------
-------------------------------------------------------------------------------------------------------------------------------------------------------------------------------------------------------
-------------------------------------------------------------------------------------------------------------------------------------------------------------------------------------------------------
-------------------------------------------------------------------------------------------------------------------------------------------------------------------------------------------------------
-------------------------------------------------------------------------------------------------------------------------------------------------------------------------------------------------------
-------------------------------------------------------------------------------------------------------------------------------------------------------------------------------------------------------
--##-----SSS-SSS----S!!S---SSSSS--------------------#-------------SSSS----------SSSSSSS-S---SS-----SSS----S!!SSSS----S!SSSSSS----S!!S-----------SS------------------------SSS----S!!S---------##-------
-###-----------------------------------------------##----------------------------------------------------------------------------------------------------------------------------------------###-------
####----------------------------------------------###---------------------------------------------------------------------------------------------------------------------------------------####-------
####---------------------------------------------####-----------------------g---------------------------------------------------------------#----------------------------------------------#####-------
####-----------------SS------------------------t#####-------tt---------------S@S----------------S----------SS---------S-----------SS------####----------##-#-----------S----------SS------######-------
####-----------------------------------tt------t#####t------tt---------------------------------------------------------------------------#####---------###-##----------------------------#######-------
####-----------------------------------tt------t#####t------tt--------------------------------------------------------------------------######t-------####-###------#----------------tt-########------F
###M----------------------#------------tt------t#####tgg----tt------------------------------ggg----------k---------------g-------------#######t#-----#####-####----##-------g--------tt#########------#
XXXXXXXXXXXXXXXXXXXXXXXXXXXXXXXXXXXXXXXXXXXXXXXXXXXXXXXXXXXXXXXXXXXXX---XXXXXXXXXXXXXX----XXXXXXXXXXXXXXXXXXXXXXXXXXXXXXXXXXXXXXXXXXXXXXXXXXXXXXXXXXXXXXXX-XXXXXXXXXXXXXXXXXXXXXXXXXXXXXXXXXXXXXXXXXXXX
XXXXXXXXXXXXXXXXXXXXXXXXXXXXXXXXXXXXXXXXXXXXXXXXXXXXXXXXXXXXXXXXXXXXX---XXXXXXXXXXXXXX----XXXXXXXXXXXXXXXXXXXXXXXXXXXXXXXXXXXXXXXXXXXXXXXXXXXXXXXXXXXXXXXX-XXXXXXXXXXXXXXXXXXXXXXXXXXXXXXXXXXXXXXXXXXXX
