-------------------------------------------------------------------------------------------------------------------------------------------------------------------------------------------------------
-------------------------------------------------------------------------------------------------------------------------------------------------------------------------------------------------------
-------------------------------------------------------------------------------------------------------------------------------------------------------------------------------------------------------
-------------------------------------------------------------------------------------------------------------------------------------------------------------------------------------------------------
-------------------------------------------------------------------------------------------------------------------------------------------------------------------------------------------------------
-------------------------------------------------------------------------------------------------------------------------------------------------------------------------------------------------------
--##-------S----S!!S---SSS!------------------------##-------------------SS----S!!S--SSS-S---SSS!---SSS----S!--SSS----S!!S--------S!!S---------------------------------------SSS---------------##-------
-###-----------------------------------------------##----------------------------------------------------------------------------------------------------------------------------------------###-------
####-----------------------------------------------##---------------------------------------------------------------------------------------------------------------------------------------####-------
####-----------------------------------------------##------------1----------g--------------------------------------------------------------------------------------------------------------#####-------
####-------------SS-------C-----SU----#----------####-----tt-------------------SS--------------C-----------S----------SS----------SS-----#--#-----------##-#------------SS!S-------------#######-------
####----------------------------------##--------#####-----tt----------------------------------------------------------------------------##--##--------####-##---------------------------########-------
####----------------------------------###------######-----tt----------------------------------------------------------------#----------###--###------#####-###-----tt---------------tt-#########------F
###M----------------------------------####----#######-gg--tt--------------------------------ggg----------k---------------g-###--------####--####----######-####----tt-------g-------tt##########------#
XXXXXXXXXXXXXXXXXXXXXXXXXXXXXXXXXXXXXXXXXXXXXXXXXXXXXXXXXXXXXXXXXXXXXX--XXXXXXXXXXXXXXX---XXXXXXXXXXXXXXXXXXXXXXXXXXXXXXXXXXXXXXXXXXXXXXXXXXXXXXXXXXXXXXXX-XXXXXXXXXXXXXXXXXXXXXXXXXXXXXXXXXXXXXXXXXXXX
XXXXXXXXXXXXXXXXXXXXXXXXXXXXXXXXXXXXXXXXXXXXXXXXXXXXXXXXXXXXXXXXXXXXXX--XXXXXXXXXXXXXXX---XXXXXXXXXXXXXXXXXXXXXXXXXXXXXXXXXXXXXXXXXXXXXXXXXXXXXXXXXXXXXXXX-XXXXXXXXXXXXXXXXXXXXXXXXXXXXXXXXXXXXXXXXXXXX
