-------------------------------------------------------------------------------------------------------------------------------------------------------------------------------------------------------
-------------------------------------------------------------------------------------------------------------------------------------------------------------------------------------------------------
-------------------------------------------------------------------------------------------------------------------------------------------------------------------------------------------------------
-------------------------------------------------------------------------------------------------------------------------------------------------------------------------------------------------------
-------------------------------------------------------------------------------------------------------------------------------------------------------------------------------------------------------
-------------------------------------------------------------------------------------------------------------------------------------------------------------------------------------------------------
#--SSSSSSSS---SSS!--S!!S---SSS!-----SSS------------##--------------SSS----SSS!----SSSSS-S---SSS!-SS!SSSSSSSSS-SSS!------SSSSSS---S!!S-------------------------------SSS----S!!S---------------##-------
#-------------------------------------------------###----------------------------------------------------------------------------------------------------------------------------------------###-------
#------------------------------------------------####---------------------------------------------------------------------------------------------------------------------------------------####-------
#-----------------------------------------------#####-----------------------g--------------------------------------------------------------------------------------------------------------#####-------
#@S--------------C---SS-------C----------#-----######------#-----------------C-----------------C---C-------------C---S@S----------SS------#-#----------tt--tttt-------------SS------------######-------
#---------------------------------------##----#######------##----------------------------------------------------------------------------##-##--------#tt--tttt-------------------------########-------
#--------------------------------------###tt-########------###--------------------------------------------------------------------------###-###------##tt--tttt---------------------tt-#########------F
#--M----------------------#------------###tt#########-gg---####-----------------------------ggg----------k---------------g-------------####-####----###tt--tttt-------------g-------tt##########------#
XXXXXXXXX---XXXXXXXXXXXXXXXXXXXXXXXXXXXXXXXXXXXXXXXXXXXXXXXXXXXXXXXXX---XXXXXXXXXXXXXXX---XXXXXXXXXXXXXXXXXXXXXXXXXXXXXXXXXXXXXXXXXXXXXXXXXXXXXXXXXXXXXXXXXXXXXXXXXXXXXXXXXXXXXXXXXXXXXXXXXXXXXXXXXXXXX
XXXXXXXXX---XXXXXXXXXXXXXXXXXXXXXXXXXXXXXXXXXXXXXXXXXXXXXXXXXXXXXXXXX---XXXXXXXXXXXXXXX---XXXXXXXXXXXXXXXXXXXXXXXXXXXXXXXXXXXXXXXXXXXXXXXXXXXXXXXXXXXXXXXXXXXXXXXXXXXXXXXXXXXXXXXXXXXXXXXXXXXXXXXXXXXXX
