-------------------------------------------------------------------------------------------------------------------------------------------------------------------------------------------------------
-------------------------------------------------------------------------------------------------------------------------------------------------------------------------------------------------------
-------------------------------------------------------------------------------------------------------------------------------------------------------------------------------------------------------
-------------------------------------------------------------------------------------------------------------------------------------------------------------------------------------------------------
-------------------------------------------------------------------------------------------------------------------------------------------------------------------------------------------------------
-------------------------------------------------------------------------------------------------------------------------------------------------------------------------------------------------------
--##-------SSSSSS-------SSSSSS---------------------##-------------SSSS--SS----S!!S-SSSS-S---SSS!---------SSS----S!!S-----SSSSSSSSS!!S-------------------------------SSS!----SSSSSS-----------####------
-###-----------------------------------------------##---------------------------------------------------------------------------------------------------------------------------------------#####------
####----------------------------------------------###--------------------------------------------------------------------------------------------------------------------------------------######------
####---------------------------------------------####-----------------------g-------------------------------------------------------------------------------------------------------------#######------
####------S----------S@S------------------------#####-----t----S@S-------------SS--------------C------S----------SS---S@S---------SS------#--#---------###--#----------C---S-------------########------
####-----------------------------------tt------######-----t------------------------------------------------------------------------------##--##-------####--##--------------------------#########------
####--------------------------t--------tt--tt-#######-----t-----------------------------------------------------------------------------###--###-----#####--###---------------------tt-##########-----F
###M--------------------------t--------tt--tt########-gg--t---------------------------------ggg----------k---------------g-------------####--####---######--####------------g-------tt###########-----#
XXXXXXXXXXXXXXXXXXXXXXXXXXXXXXXXXXXXXXXXXXXXXXXXXXXXXXXXXXXXXXXXXXXXXX---XXXXXXXXXXXXXX---XXXXXXXXXXXXXXXXXXXXXXXXXXXXXXXXXXXXX--XXXXXXXXXXXXXXXXXXXXXXXXX--XXXXXXXXXXXXXXXXXXXXXXXXXXXXXXXXXXXXXXXXXXX
XXXXXXXXXXXXXXXXXXXXXXXXXXXXXXXXXXXXXXXXXXXXXXXXXXXXXXXXXXXXXXXXXXXXXX---XXXXXXXXXXXXXX---XXXXXXXXXXXXXXXXXXXXXXXXXXXXXXXXXXXXX--XXXXXXXXXXXXXXXXXXXXXXXXX--XXXXXXXXXXXXXXXXXXXXXXXXXXXXXXXXXXXXXXXXXXX
