-------------------------------------------------------------------------------------------------------------------------------------------------------------------------------------------------------
-------------------------------------------------------------------------------------------------------------------------------------------------------------------------------------------------------
-------------------------------------------------------------------------------------------------------------------------------------------------------------------------------------------------------
-------------------------------------------------------------------------------------------------------------------------------------------------------------------------------------------------------
-------------------------------------------------------------------------------------------------------------------------------------------------------------------------------------------------------
-------------------------------------------------------------------------------------------------------------------------------------------------------------------------------------------------------
-##-----SSS----S!!SSSSSSSSSSS-----------------------##---------SSSSSSS----SS----SSSSSSS-S---SSS!------SSSSSSS--SSS----S!!S---SSS-##----------------------------SSS----S!!SSSS----S!------------##------
###------------------------------------------------###--------------------------------------------------------------------------###---------------------------------------------------------#-###------
###-----------------------------------------------####--------------------------------------------------------------------------###--------------------------------------------------------######------
###----------------------------------------------#####----------------------g---------------------------------------------------###-------------------------------------------------------#######------
###-------------SS------------------------------######------S@S--------------S@S---------------C-----S-----------------SS-------###-------###----------##--#-----------SS---------S------########------
###------------------------------------tt------#######--------------------------------------------------------------------------###------#####--------###--##---------------------------#########------
###--------------------------tt--------tt-----########--------------------------------------------------------------------------###-----#######------####--###----------------------tt-##########-----F
###M-------------------------tt--------tt-----########gg------------------------------------ggg----------k---------------g--#---###----#########----#####--####-------------g-------tt###########-----#
XXXXXXXXXXXXXXXXXXXXXXXXXXXXXXXXXXXXXXXXXXXXXXXXXXXXXXXXXXXXXXXXXXXXX---XXXXXXXXXXXXXX----XXXXXXXXXXXXXXXXXX-XXXXXXXXXXXXXXXXXXXXXXXXXXXXXXXXXXXXXXXXXXXX--XXXXXXXXXXXXXXXXXXXXXXXXXXXXXXXXXXXXXXXXXXXX
XXXXXXXXXXXXXXXXXXXXXXXXXXXXXXXXXXXXXXXXXXXXXXXXXXXXXXXXXXXXXXXXXXXXX---XXXXXXXXXXXXXX----XXXXXXXXXXXXXXXXXX-XXXXXXXXXXXXXXXXXXXXXXXXXXXXXXXXXXXXXXXXXXXX--XXXXXXXXXXXXXXXXXXXXXXXXXXXXXXXXXXXXXXXXXXXX
