-------------------------------------------------------------------------------------------------------------------------------------------------------------------------------------------------------
-------------------------------------------------------------------------------------------------------------------------------------------------------------------------------------------------------
-------------------------------------------------------------------------------------------------------------------------------------------------------------------------------------------------------
-------------------------------------------------------------------------------------------------------------------------------------------------------------------------------------------------------
-------------------------------------------------------------------------------------------------------------------------------------------------------------------------------------------------------
-------------------------------------------------------------------------------------------------------------------------------------------------------------------------------------------------------
-##------------SSSSSSS!SSSSSS----S!!S---------------#-----------SSSSSS-----SSS!--SSSSSS-S---SSSSSSSSSSSSSSS---SSS----S!!S--SS----S!!S-----------------------------SSS----S!!S-----------------##-------
###------------------------------------------------##----------------------------------------------------------------------------------------------------------------------------------------###-------
###-----------------------------------------------###----------------------------------------------------------------------------------------#----------------------------------------------####-------
###----------------------------------------------####-----------------------g---------------------------------------------------------------##---------------------------------------------#####-------
###-------------------C-----------SS------#----t#####-------tt-S--------------C-S--------------------------S----------SS----------SS-------###---------###--#-------------SS--------------######-------
###--------------------------------------##----t#####t------tt----------------------------------------------------------------------------####--------####--##---------------------------#######-------
###-------------------------------------###----t#####t------tt-------------------------------------------------------------------------t-######------#####--###---------------------ttt-########------F
###M-----------------------------------####----t#####tgg----tt------------------------------ggg----------k---------------g-------------t########----######--####------------g--#----ttt#########------#
XXXXXXXXXXXXXXXXXXXXXXXXXXXXXXXXXXXXXXXXXXXXXXXXXXXXXXXXXXXXXXXXXXXXXX---XXXXXXXXXXXXXX---XXXXXXXXXXXXXXXX-XXXXXXXXXXXXXXXXXXXXXXXXXXXXXXXXXXXXXXXXXXXXXXX--XXXXXXXXXXXXXXXXXXXXXXXXXXXXXXXXXXXXXXXXXXX
XXXXXXXXXXXXXXXXXXXXXXXXXXXXXXXXXXXXXXXXXXXXXXXXXXXXXXXXXXXXXXXXXXXXXX---XXXXXXXXXXXXXX---XXXXXXXXXXXXXXXX-XXXXXXXXXXXXXXXXXXXXXXXXXXXXXXXXXXXXXXXXXXXXXXX--XXXXXXXXXXXXXXXXXXXXXXXXXXXXXXXXXXXXXXXXXXX
