-------------------------------------------------------------------------------------------------------------------------------------------------------------------------------------------------------
-------------------------------------------------------------------------------------------------------------------------------------------------------------------------------------------------------
-------------------------------------------------------------------------------------------------------------------------------------------------------------------------------------------------------
-------------------------------------------------------------------------------------------------------------------------------------------------------------------------------------------------------
-------------------------------------------------------------------------------------------------------------------------------------------------------------------------------------------------------
-------------------------------------------------------------------------------------------------------------------------------------------------------------------------------------------------------
-##-----SSSS----S!!S-SSS----S!!S----SSSS---------------------------SSS---SSSSSS-SSSSSSS----SSSSSSSSSS---SSS!SS------SSS----S!!SS-S!!--------------------------------------SSS----S!SS---------##-------
###------------------------------------------------------------------------------------------------------------------------------------------------------------------------------------------###-------
###-----------------------------------------------------------------------------------------------------------------------------------------------------------------------------------------####-------
###---------------------------------------#---------------------------------g---------------------------------------------------------------#----------------------------------------------#####-------
###--------------SS----------SS----------##-#--#--#------------SS!S-----S------S---------------------------C-----S----------SS----SS-------###----------##-#-----------S----------S-------######-------
###-------------------------------------#####--##-##--------------------------------------------------------------------------------------#####--------###-##----------------------------#######-------
###-------------------------------------#####--######-----tt--------------------------------------------------------------------------tt-#######------####-###-----------------------tt-########------F
###M------------------------------#-----#####--#######gg--tt--------------------------------ggg----------k---------------g------------tt#########----#####-####-------------g--------tt#########------#
XXXXXXXXXXXXXXXXXXXXXXXXXXXXXXXXXXXXXXXXXXXXXXXXXXXXXXXXXXXXXXXXXXXXX---XXXXXXXXXXXXXX---XXXXXXXXXX---XXXXXXXXXXXXXXXXXXXXXXXXXXXXXXXXXXXXXXXXXXXXXXXXXXXX-XXXXXXXXXXXXXXXXXXXXXXXXXXXXXXXXXXXXXXXXXXXX
XXXXXXXXXXXXXXXXXXXXXXXXXXXXXXXXXXXXXXXXXXXXXXXXXXXXXXXXXXXXXXXXXXXXX---XXXXXXXXXXXXXX---XXXXXXXXXX---XXXXXXXXXXXXXXXXXXXXXXXXXXXXXXXXXXXXXXXXXXXXXXXXXXXX-XXXXXXXXXXXXXXXXXXXXXXXXXXXXXXXXXXXXXXXXXXXX
