-------------------------------------------------------------------------------------------------------------------------------------------------------------------------------------------------------
-------------------------------------------------------------------------------------------------------------------------------------------------------------------------------------------------------
-------------------------------------------------------------------------------------------------------------------------------------------------------------------------------------------------------
-------------------------------------------------------------------------------------------------------------------------------------------------------------------------------------------------------
-------------------------------------------------------------------------------------------------------------------------------------------------------------------------------------------------------
-------------------------------------------------------------------------------------------------------------------------------------------------------------------------------------------------------
-##------SSS----S!!-----SSSSSSS---------------------##--SS---------SSS----SSS!S!!SSSSSS-S---SSS!--SSS----S!!S-SSS!------SSSSSSSSSS!!S-----------SSSS------------SS----S!!S-SSSSSSSS-----------##-------
###------------------------------------------------###---------------------------------------------------------------------------------------------------------------------------------------###-------
###-----------------------------------------------####--------------------------------------------------------------------------------------------------------------------------------------####-------
###---------------------------------------#------#####----------------------g--------------------------------------------------------------------------------------------------------------#####-------
###--------------SS--S@S-----------------##-----######-----#-----------------C-SS--------------C----------SS-----C----@S----------SS------#--#----------##--#----------SS-----------------######-------
###-------------------------------------###----#######-----##----------------------------------------------------------------------------##--##--------###--##---------------------------#######-------
###---------------------------------tt-####tt-########-----###--------------------------------------------------------------------------###--##-------####--###---------------------tt--########------F
###M--------------------------------tt#####tt#########gg---####-----------------------------ggg----------k---------------g-------------####--##------#####--####------------g-------tt##########------#
XXXXXXXXXXXXXXXXXXXXXXXXXXXXXX-XXXXXXXXXXXXXXXXXXXXXXXXXXXXXXXXXXXXXX---XXXXXXXXXXXXXXX---XXXXXXXXXXXXXXXXXXXXXXXXXXXXXXXXXXXXXXXXXXXXXXXXXXXXXXXXXXXXXXXX--XXXXXXXXXXXXXXXXXXXXXXXXXXXXXXXXXXXXXXXXXXX
XXXXXXXXXXXXXXXXXXXXXXXXXXXXXX-XXXXXXXXXXXXXXXXXXXXXXXXXXXXXXXXXXXXXX---XXXXXXXXXXXXXXX---XXXXXXXXXXXXXXXXXXXXXXXXXXXXXXXXXXXXXXXXXXXXXXXXXXXXXXXXXXXXXXXX--XXXXXXXXXXXXXXXXXXXXXXXXXXXXXXXXXXXXXXXXXXX
