-------------------------------------------------------------------------------------------------------------------------------------------------------------------------------------------------------
-------------------------------------------------------------------------------------------------------------------------------------------------------------------------------------------------------
-------------------------------------------------------------------------------------------------------------------------------------------------------------------------------------------------------
-------------------------------------------------------------------------------------------------------------------------------------------------------------------------------------------------------
-------------------------------------------------------------------------------------------------------------------------------------------------------------------------------------------------------
-------------------------------------------------------------------------------------------------------------------------------------------------------------------------------------------------------
#-##----------SS----S!!S---SSS!---------------------##---------------------------SSSSSS-S--!SS----S!!S----SS----S!!S--!!S-SSSSSS-S!!SS-----------------------------------SSS----S!!S---------##--------
####-----------------------------------------------###--------------------------------------------------------------------------------------------------------------------------------------###--------
####----------------------------------------------####-------------------------------------------------------------------------------------------------------------------------------------####--------
####---------------------------------------------#####----------------------g-------------------------------------------------------------------------------------------------------------#####--------
####-----------------SS-------C----------------tt#####-----tt-----------------S@S----------S-------SS------------SS---SS-S--------SS------#--#----------##--##-------------------SS------######--------
####-----------------------------------tt------tt#####-----tt----------------------------------------------------------------------------##--##--------###-###--------------------------#######--tt----
####-----------------------------------tt------tt#####-----tt--------------------------------------------#----------------------------tt-##--###------####-####-----tt--------------tt-########--tt---F
###M-----------------------------------tt------tt#####gg---tt-------------------------------ggg---------#k---------------g------------tt###--####----#####-#####----tt------g-------tt#########--tt---#
XXXXXXXXXXXXXXXXXXXXXXXXXXXXXXXXXXXXXXXXXXXXXXXXXXXXXXXXXXXXXXXXXXXXXX--XXXXXXXXXXXXXXX---XXXXXXXXXXXXXXXXXXXXXXXXXXXXXXXXXXXXXXXXXXXXXXXXXXXXXXXXXXXXXXXX-XXXXXXXXXXXXXXXXXXXXXXXXXXXXXXXXXXXXXXXXXXXX
XXXXXXXXXXXXXXXXXXXXXXXXXXXXXXXXXXXXXXXXXXXXXXXXXXXXXXXXXXXXXXXXXXXXXX--XXXXXXXXXXXXXXX---XXXXXXXXXXXXXXXXXXXXXXXXXXXXXXXXXXXXXXXXXXXXXXXXXXXXXXXXXXXXXXXX-XXXXXXXXXXXXXXXXXXXXXXXXXXXXXXXXXXXXXXXXXXXX
