-------------------------------------------------------------------------------------------------------------------------------------------------------------------------------------------------------
-------------------------------------------------------------------------------------------------------------------------------------------------------------------------------------------------------
-------------------------------------------------------------------------------------------------------------------------------------------------------------------------------------------------------
-------------------------------------------------------------------------------------------------------------------------------------------------------------------------------------------------------
-------------------------------------------------------------------------------------------------------------------------------------------------------------------------------------------------------
-------------------------------------------------------------------------------------------------------------------------------------------------------------------------------------------------------
--##---------SSS----S!!SSSSS------------------------##------------------SS----S!!S--SSS-S---SSSSSSSSS---SSS!SSSSS----S!!S-SSS----S!!S-------------------------------------SSS----S!!-----------##------
-###-----------------------------------------------###--------------------------------------------------------------------------------------------------------------------------------------#-###------
####----------------------------------------------####-------------------------------------------------------------------------------------------------------------------------------------######------
####---------------------------------------------#####----------1-----------g-------------------------------------------------------------------------------------------------------------#######------
####------S----------SS-------------------------######----t--------------------SS--------------------------C----------SS----------SS-----#--#----------##--#-----------S----------SS-----########------
####-----------------------------------tt------#######----t-----------------------------------------------------------------------------##--##--------###--###--------------------------#########------
####-------------------------tt--------tt-----########----t----------------------------------------------------------------------------###--###------####--####-----tt--------------tt-##########-----F
###M-------------------------tt--------tt----#########gg--t---------------------------------ggg----------k---------------g------------####--####----#####--#####----tt------g-------tt###########-----#
XXXXXXXXXXXXXXXXXXXXXXXXXXXXXXXXXXXXXXXXXXXXXXXXXXXXXXXXXXXXXXXXXXXXX---XXXXXXXXXXXXXXX---XXXXXXXXX---XXXXXXXXXXXXXXXXXXXXXXXXXXXXXXXXXXXXXXXXXXXXXXXXXXX--XXXXXXXXXXXXXXXXXXXXXXXXXXXXXXXXXXXXXXXXXXXX
XXXXXXXXXXXXXXXXXXXXXXXXXXXXXXXXXXXXXXXXXXXXXXXXXXXXXXXXXXXXXXXXXXXXX---XXXXXXXXXXXXXXX---XXXXXXXXX---XXXXXXXXXXXXXXXXXXXXXXXXXXXXXXXXXXXXXXXXXXXXXXXXXXX--XXXXXXXXXXXXXXXXXXXXXXXXXXXXXXXXXXXXXXXXXXXX
