-------------------------------------------------------------------------------------------------------------------------------------------------------------------------------------------------------
-------------------------------------------------------------------------------------------------------------------------------------------------------------------------------------------------------
-------------------------------------------------------------------------------------------------------------------------------------------------------------------------------------------------------
-------------------------------------------------------------------------------------------------------------------------------------------------------------------------------------------------------
-------------------------------------------------------------------------------------------------------------------------------------------------------------------------------------------------------
-------------------------------------------------------------------------------------------------------------------------------------------------------------------------------------------------------
#--SSSSSSSS---SSS!--S!!S--SSS----S!!S---------------##------------SSSS-----------SSSSSS--SSSSSS----SSS----S!!S-SS-SSSSSSSSSSSSS--S!!S------------------------------------SSSSSS---------------##-------
#--------------------------------------------------###---------------------------------------------------------------------------------------------------------------------------------------###-------
#-------------------------------------------------####--------------------------------------------------------------------------------------------------------------------------------------####-------
#------------------------------------------------#####----------------------g--------------------------------------------------------------------------------------------------------------#####-------
#@S--------------C---SS-----------SS------#-----######---------S@S------------S@S---------------S----------SS----S----------------SS------#-#----------##--##---------S@S-----------------######-------
#----------------------------------------##t---#######-----------------------------------------------------------------------------------##-##--------###--###------------------------#--#######-------
#---------------------------------------###t--########----------------------------------------------------------------------------------###-###------####--####-----t----------------##-########------F
#--M-----------------------------------####t--########gg------------------------------------ggg----------k---------------g-------------####-####----#####--#####----t-------g--#----############------#
XXXXXXXXX---XXXXXXXXXXXXXXXXXXXXXXXXXXXXXXXXXXXXXXXXXXXXXXXXXXXXXXXXXX--XXXXXXXXXXXXXX---XXXXXXXXXXXXXXXXXXXXXXXXXXXXXXX-XXXXXXXXXXXXXXXXXXXXXXXXXXXXXXXX--XXXXXXXXXXXXXXXXXXXXXXXXXXXXXXXXXXXXXXXXXXXX
XXXXXXXXX---XXXXXXXXXXXXXXXXXXXXXXXXXXXXXXXXXXXXXXXXXXXXXXXXXXXXXXXXXX--XXXXXXXXXXXXXX---XXXXXXXXXXXXXXXXXXXXXXXXXXXXXXX-XXXXXXXXXXXXXXXXXXXXXXXXXXXXXXXX--XXXXXXXXXXXXXXXXXXXXXXXXXXXXXXXXXXXXXXXXXXXX
