-------------------------------------------------------------------------------------------------------------------------------------------------------------------------------------------------------
-------------------------------------------------------------------------------------------------------------------------------------------------------------------------------------------------------
-------------------------------------------------------------------------------------------------------------------------------------------------------------------------------------------------------
-------------------------------------------------------------------------------------------------------------------------------------------------------------------------------------------------------
-------------------------------------------------------------------------------------------------------------------------------------------------------------------------------------------------------
-------------------------------------------------------------------------------------------------------------------------------------------------------------------------------------------------------
--##---------SSS----S!!S---SSS!---------------------#---------------SS---SSSSSS--SSSSSS-S---SSS-SSS!----SSS!------SSSSSSSS---SSS!##SSSSS--------------------------SSS----S!!S----------------####------
-###-----------------------------------------------##----------------------------------------------------------------------------##---------------------------------------------------------#####------
####----------------------------------------------###----------------------------------------------------------------------------##--------------------------------------------------------######------
####----------------------------------------------###-----------------------g----------------------------------------------------##-------------------------------------------------------#######------
####------S----------SS-------C-----------------tt###------tt-----------S------@S------------------C-------C-----S--------------C##------#--#----------###--#-------------SS-------------########------
####------------------------------------tt------tt####-----tt--------------------------------------------------------------------##-----##--##--------####--##--------------------------#########------
####------------------------------------tt------tt####-----tt--------------------------------------------------------------------##-----##--###------#####--###-----------------#---tt-##########-----F
###M------------------------------------tt------tt####gg---tt-------------------------------ggg----------k---------------g-------##-----##--####----######--####------------g--##---tt###########-----#
XXXXXXXXXXXXXXXXXXXXXXXXXXXXXXXXXXXXXXXXXXXXXXXXXXXXXXXXXXXXXXXXXXXXX---XXXXXXXXXXXXXXX---XXXXXXXXXXXXXXXXXXXXXXXXXXXXXX---XXXXXXXXXXXXXXXXXXXXXXXXXXXXXXX--XXXXXXXXXXXXXXXXXXXXXXXXXXXXXXXXXXXXXXXXXXX
XXXXXXXXXXXXXXXXXXXXXXXXXXXXXXXXXXXXXXXXXXXXXXXXXXXXXXXXXXXXXXXXXXXXX---XXXXXXXXXXXXXXX---XXXXXXXXXXXXXXXXXXXXXXXXXXXXXX---XXXXXXXXXXXXXXXXXXXXXXXXXXXXXXX--XXXXXXXXXXXXXXXXXXXXXXXXXXXXXXXXXXXXXXXXXXX
