-------------------------------------------------------------------------------------------------------------------------------------------------------------------------------------------------------
-------------------------------------------------------------------------------------------------------------------------------------------------------------------------------------------------------
-------------------------------------------------------------------------------------------------------------------------------------------------------------------------------------------------------
-------------------------------------------------------------------------------------------------------------------------------------------------------------------------------------------------------
-------------------------------------------------------------------------------------------------------------------------------------------------------------------------------------------------------
-------------------------------------------------------------------------------------------------------------------------------------------------------------------------------------------------------
-##------SSS----S!!S---SSS!------------------------##-----------SSSSSS-----------SSSSSS-S-S!SSSSS-SSS----S!!S-SSS----S!!S-SSS----S!!S-----------------------------SSS----S!!S-----SS----------##-------
###-----------------------------------------------###----------------------------------------------------------------------------------------------------------------------------------------###-------
###----------------------------------------------####---------------------------------------------------------------------------------------------------------------------------------------####-------
###---------------------------------------------#####-----------------------g--------------------------------------------------------------------------------------------------------------#####-------
###--------------SS-------C-----SU-------------t#####-------------------------S@S----------C--------------SS----------SS----------SS-----#--#----------##--#--------------SS--------------######-------
###------------------------------------tt------t#####-----------------------------------------------------------------------------------##--##--------###--##--------------------#-------#######-------
###------------------------------------tt------t#####----------------------------------------------------------------------------------###--###------####--###------------------##---tt-########------F
###M-----------------------------------tt------t#####-gg------------------------------------ggg----------k---------------g------------####--####----#####--####-------------g--###---tt#########------#
XXXXXXXXXXXXXXXXXXXXXXXXXXXXXXXXXXXXXXXXXXXXXXXXXXXXXXXXXXXXXXXXXXXXX---XXXXXXXXXXXXXXX---XXXXXXXXXXXXXXXXXXXXXXXXXXXXXXXXXXXXXXXXXXXXXXXXXXXXXXXXXXXXXXX--XXXXXXXXXXXXXXXXXXXXXXXXXXXXXXXXXXXXXXXXXXXX
XXXXXXXXXXXXXXXXXXXXXXXXXXXXXXXXXXXXXXXXXXXXXXXXXXXXXXXXXXXXXXXXXXXXX---XXXXXXXXXXXXXXX---XXXXXXXXXXXXXXXXXXXXXXXXXXXXXXXXXXXXXXXXXXXXXXXXXXXXXXXXXXXXXXX--XXXXXXXXXXXXXXXXXXXXXXXXXXXXXXXXXXXXXXXXXXXX
