-------------------------------------------------------------------------------------------------------------------------------------------------------------------------------------------------------
-------------------------------------------------------------------------------------------------------------------------------------------------------------------------------------------------------
-------------------------------------------------------------------------------------------------------------------------------------------------------------------------------------------------------
-------------------------------------------------------------------------------------------------------------------------------------------------------------------------------------------------------
-------------------------------------------------------------------------------------------------------------------------------------------------------------------------------------------------------
-------------------------------------------------------------------------------------------------------------------------------------------------------------------------------------------------------
-##--SSSSSSS----S!SSS!-------------------------------------------SSSSS----SSS-S!!S--SSS-S---SSSSSSSSSSSSS----S!!S-------SSSSS----S!!S---------------------------SSSSS----S!!S-----------------##-------
###------------------------------------------------#-----------------------------------------------------------------------------------------------------------------------------------------###-------
###-----------------------------------------------##----------------------------------------------------------------------------------------------------------------------------------------####-------
###----------------------------------------------###------------------------g--------------------------------------------------------------------------------------------------------------#####-------
###--------------S---C----------------------#--#-###--------tt-----------------SS-----------------------------SS-----S@S----------SS------#-#----------##--#--------------SS--------------######-------
###------------------------------------tt--##--#####tt------tt---------------------------------------------------------------------------##-##--------###--##---------------------------########-------
###--------------------------tt--------tt-###--#####tt------tt------------------------------------------------------------------------t-###-###------####--###----------------------tt-#########------F
###M-------------------------tt--------tt####--#####ttgg----tt------------------------------ggg----------k---------------g------------t####-####----#####--####-------------g-------tt##########------#
XXXXXXXXXXXXXXXXXXXXXXXXXXXXXXXXXXXXXXXXXXXXXXXXXXXXXXXXXXXXXXXXXXXXX---XXXXXXXXXXXXXXX---XXXXXXXXXXXXXXXXXXXXXXXXXXXXXXXXXXXXXXXXXXXXXXXXXXXXXXXXXXXXXXX--XXXXXXXXXXXXXXXXXXXXXXXXXXXXXXXXXXXXXXXXXXXX
XXXXXXXXXXXXXXXXXXXXXXXXXXXXXXXXXXXXXXXXXXXXXXXXXXXXXXXXXXXXXXXXXXXXX---XXXXXXXXXXXXXXX---XXXXXXXXXXXXXXXXXXXXXXXXXXXXXXXXXXXXXXXXXXXXXXXXXXXXXXXXXXXXXXX--XXXXXXXXXXXXXXXXXXXXXXXXXXXXXXXXXXXXXXXXXXXX
