-------------------------------------------------------------------------------------------------------------------------------------------------------------------------------------------------------
-------------------------------------------------------------------------------------------------------------------------------------------------------------------------------------------------------
-------------------------------------------------------------------------------------------------------------------------------------------------------------------------------------------------------
-------------------------------------------------------------------------------------------------------------------------------------------------------------------------------------------------------
-------------------------------------------------------------------------------------------------------------------------------------------------------------------------------------------------------
-------------------------------------------------------------------------------------------------------------------------------------------------------------------------------------------------------
-##--------SSSSSS----S!!S----SSS----S!--------------##----------SSSSSS----SSS!---SSSSSS-S---SSS!---SSSSSSSSSSSS#S!S-------SSS----S!!SS-----------------------------------SSSSSS---------------##-------
###------------------------------------------------###---------------------------------------------------------#-----------------------------------------------------------------------------###-------
###-----------------------------------------------####---------------------------------------------------------#----------------------------------------------------------------------------####-------
###---------------------------------------#------#####----------------------g----------------------------------#--------------------------------------------------------------------------######-------
###-------------------SS-------------S---##-----######----#------------------C-----------------C---------------#-S-----S----------SS-----#--#----------###--#----------------------------#######-------
###-------------------------------------###t---#######----##---------------------------------------------------#------------------------##--##--------####--##--------------------------########-------
###------------------------------------####t---#######----###--------------------------------------------------#-----------------------###--###------#####--###-----tt--------------tt-#########------F
###M----------------------------------#####t---#######gg--####------------------------------ggg----------k-----#---------g------------####--####----######--####----tt------g-------tt##########------#
XXXXXXXXXXXXXXXXXXXXXXXXXXXXXXXXXXXXXXXXXXXXXXXXXXXXXXXXXXXXXXXXXXXXX---XXXXXXXXXXXXXXX---XXXXXXXXXXXXXXXXXXXXXXXXXXXXXXXXXXXXXXXXXXXXXXXXXXXXXXXXXXXXXXXX--XXXXXXXXXXXXXXXXXXXXXXXXXXXXXXXXXXXXXXXXXXX
XXXXXXXXXXXXXXXXXXXXXXXXXXXXXXXXXXXXXXXXXXXXXXXXXXXXXXXXXXXXXXXXXXXXX---XXXXXXXXXXXXXXX---XXXXXXXXXXXXXXXXXXXXXXXXXXXXXXXXXXXXXXXXXXXXXXXXXXXXXXXXXXXXXXXX--XXXXXXXXXXXXXXXXXXXXXXXXXXXXXXXXXXXXXXXXXXX
