-------------------------------------------------------------------------------------------------------------------------------------------------------------------------------------------------------
-------------------------------------------------------------------------------------------------------------------------------------------------------------------------------------------------------
-------------------------------------------------------------------------------------------------------------------------------------------------------------------------------------------------------
-------------------------------------------------------------------------------------------------------------------------------------------------------------------------------------------------------
-------------------------------------------------------------------------------------------------------------------------------------------------------------------------------------------------------
-------------------------------------------------------------------------------------------------------------------------------------------------------------------------------------------------------
-##--------SSSS----S!!--SSSSSSSS---SSS--------------##---------SSSSSSS----S-----SSSSSSS-S--SSS----S!!-SSSSSSSSSS----SSS----S!!S--S!!S------------------------------SSS----S!!S-SSSS-----------##-------
###------------------------------------------------###---------------------------------------------------------------------------------------------------------------------------------------###-------
###-----------------------------------------------####--------------------------------------------------------------------------------------------------------------------------------------####-------
###---------------------------------------#------#####----------------------g--------------------------------------------------------------------------------------------------------------#####-------
###-----------------SS@S-----------------##-----######------S@S--------------S@S-------------------SSS-----------S----------SS----SS------#--#---------##--#tt-------------SS-------------######-------
###-------------------------------------###----#######-----------------------------------------------------------------------------------##--##-------###--#tt---------------------------#######-------
###------------------------------------####tt-########----------------------------------------------------------------------------------###--##------####--#tt----------------------tt-#########------F
###M----------------------------------#####tt#########gg------------------------------------ggg----------k---------------g-------------####--###----#####--#tt--------------g-------tt##########------#
XXXXXXXXXXXXXXXXXXXXXXXXXXXXXX---XXXXXXXXXXXXXXXXXXXXXXXXXXXXXXXXXXXX---XXXXXXXXXXXXXX----XXXXXXXXXXXXXXXXXX-XXXXXXXXXXXXXXXXXXXXXXXXXXXXXXXXXXXXXXXXXXXX--XXXXXXXXXXXXXXXXXXXXXXXXXXXXXXXXXXXXXXXXXXXX
XXXXXXXXXXXXXXXXXXXXXXXXXXXXXX---XXXXXXXXXXXXXXXXXXXXXXXXXXXXXXXXXXXX---XXXXXXXXXXXXXX----XXXXXXXXXXXXXXXXXX-XXXXXXXXXXXXXXXXXXXXXXXXXXXXXXXXXXXXXXXXXXXX--XXXXXXXXXXXXXXXXXXXXXXXXXXXXXXXXXXXXXXXXXXXX
