-------------------------------------------------------------------------------------------------------------------------------------------------------------------------------------------------------
-------------------------------------------------------------------------------------------------------------------------------------------------------------------------------------------------------
-------------------------------------------------------------------------------------------------------------------------------------------------------------------------------------------------------
-------------------------------------------------------------------------------------------------------------------------------------------------------------------------------------------------------
-------------------------------------------------------------------------------------------------------------------------------------------------------------------------------------------------------
-------------------------------------------------------------------------------------------------------------------------------------------------------------------------------------------------------
-##----------SSS----S!@-SSS!----------------------------------------SS----S------SSSSSS-S-SSSSS-----SSSSSSS!!SSSS-SSSSSSSS---SSS-##!S---------------------------SSSSSSSSS----S!!S-------------##-------
###-----------------------------------------------------------------------------------------------------------------------------###----------------------------------------------------------###-------
###-----------------------------------------------#-----------------------------------------------------------------------------###---------------------------------------------------------####-------
###----------------------------------------------##-------------------------g---------------------------------------------------###-------------------------------------------------------######-------
###------------------S!----C-----SU----#--------###--------tt-----------------S@S----------------S@S-------SS----S--------------###S------#--#----------##--#--S--------------SS---------#######-------
###------------------------------------##------####tt------tt-------------------------------------------------------------------###------##--##--------###--##--------------------------########-------
###------------------------------------###-tt-#####tt------tt-------------------------------------------------------------------###-----###--###------####--###---------------------tt-#########------F
###M-----------------------------------###-tt######tt-gg---tt-------------------------------ggg----------k---------------g------###----####--####----#####--###-------------g-------tt##########------#
XXXXXXXXXXXXXXXXXXXXXXXXXXXXXXXXXXXXXXXXXXXXXXXXXXXXXXXXXXXXXXXXXXXXX---XXXXXXXXXXXXXXX---XXXXXXXXXXXXXXXXXXXXXXXXXXXXXX---XXXXXXXXXXXXXXXXXXXXXXXXXXXXXXX--XXXXXXXXXXXXXXXXXXXXXXXXXXXXXXXXXXXXXXXXXXX
XXXXXXXXXXXXXXXXXXXXXXXXXXXXXXXXXXXXXXXXXXXXXXXXXXXXXXXXXXXXXXXXXXXXX---XXXXXXXXXXXXXXX---XXXXXXXXXXXXXXXXXXXXXXXXXXXXXX---XXXXXXXXXXXXXXXXXXXXXXXXXXXXXXX--XXXXXXXXXXXXXXXXXXXXXXXXXXXXXXXXXXXXXXXXXXX
