-------------------------------------------------------------------------------------------------------------------------------------------------------------------------------------------------------
-------------------------------------------------------------------------------------------------------------------------------------------------------------------------------------------------------
-------------------------------------------------------------------------------------------------------------------------------------------------------------------------------------------------------
-------------------------------------------------------------------------------------------------------------------------------------------------------------------------------------------------------
-------------------------------------------------------------------------------------------------------------------------------------------------------------------------------------------------------
-------------------------------------------------------------------------------------------------------------------------------------------------------------------------------------------------------
--##SSS----S!!S--------SSSSSSSSS--------------------##--------------S------------SSSSSS-S---SSS!---SS----S!!S----SSSSSS-SSSSS----S!!S------------------------------SS----S!!S----SSSS---------##-------
-###-----------------------------------------------###---------------------------------------------------------------------------------------------------------------------------------------###-------
####----------------------------------------------####---------------------------------------------------------------------------------------#----------------------------------------------####-------
####---------------------------------------------#####----------------------g---------------------------------------------------------------##---------------------------------------------#####-------
####--------SS------S@S-------------------------######-----#------------------S@S--------------C----------SS----S------S----------SS-------###---------##--#--------------SS--------------######-------
####------------------------------------tt-----#######-----##----------------------------------------------------------------------------#####--------###--##----------------------------#######-tt----
####------------------------------------tt----########-----###------------------------------------------------------------------------t-#######------####--###------------------#----tt-########-tt---F
###M------------------------------------tt----########gg---####----#------------------------ggg----------k-----#---------g------------t#########----#####--####-------------g--##----tt#########-tt---#
XXXXXXXXXXXXXXXXXXXXXXXXXXXXXXXXXXXXXXXXXXXXXXXXXXXXXXXXXXXXXXXXXXXXXX--XXXXXXXXXXXXXXX---XXXXXXXXXXXXXXXXXXXXXXXXXXXXXXXXXXXXXXXXXXXXXXXXXXXXXXXXXXXXXXX--XXXXXXXXXXXXXXXXXXXXXXXXXXXXXXXXXXXXXXXXXXXX
XXXXXXXXXXXXXXXXXXXXXXXXXXXXXXXXXXXXXXXXXXXXXXXXXXXXXXXXXXXXXXXXXXXXXX--XXXXXXXXXXXXXXX---XXXXXXXXXXXXXXXXXXXXXXXXXXXXXXXXXXXXXXXXXXXXXXXXXXXXXXXXXXXXXXX--XXXXXXXXXXXXXXXXXXXXXXXXXXXXXXXXXXXXXXXXXXXX
