-------------------------------------------------------------------------------------------------------------------------------------------------------------------------------------------------------
-------------------------------------------------------------------------------------------------------------------------------------------------------------------------------------------------------
-------------------------------------------------------------------------------------------------------------------------------------------------------------------------------------------------------
-------------------------------------------------------------------------------------------------------------------------------------------------------------------------------------------------------
-------------------------------------------------------------------------------------------------------------------------------------------------------------------------------------------------------
-------------------------------------------------------------------------------------------------------------------------------------------------------------------------------------------------------
-##-----------SSSSSSSS----S!!S----------------------##-------------SSS----SSS!-----SSSS-S---SSS!-------SS-----SSS----S!!--SSS----S!!--------------------------------SSS!-----SSSSSSS---------##--------
###------------------------------------------------###--------------------------------------------------------------------------------------------------------------------------------------###--------
###-----------------------------------------------####-------------------------------------------------------------------------------------------------------------------------------------####--------
###----------------------------------------------#####----------------------g-------------------------------------------------------------------------------------------------------------#####--------
###------------------------SS-------------------######----tt-----------------C-----------------C-----SU----S----------SS----------SS-----#--#-----------##-#-----------C-----------------######--------
###----------------------------------------#---#######----tt----------------------------------------------------------------------------##--##---------###-##---------------------------#######--#-----
###------------------------------------tt-##t-########----tt---------------------------------------------------------------------------###--###-------####-###-----t----------------tt-########--##---F
###M-----------------------------------tt###t#########gg--tt--------------------------------ggg----------k---------------g------------####--####-----#####-####----t--------g-------tt#########--###--#
XXXXXXXXXXXXXXXXXXXXXXXXXXXXXXXXXXXXXXXXXXXXXXXXXXXXXXXXXXXXXXXXXXXXX---XXXXXXXXXXXXXXX---XXXXXXXXXXXXXXXXXXXXXXXXXXXXXXXXXXXXXXXXXXXXXXXXXXXXXXXXXXXXXXXX-XXXXXXXXXXXXXXXXXXXXXXXXXXXXXXXXXXXXXXXXXXXX
XXXXXXXXXXXXXXXXXXXXXXXXXXXXXXXXXXXXXXXXXXXXXXXXXXXXXXXXXXXXXXXXXXXXX---XXXXXXXXXXXXXXX---XXXXXXXXXXXXXXXXXXXXXXXXXXXXXXXXXXXXXXXXXXXXXXXXXXXXXXXXXXXXXXXX-XXXXXXXXXXXXXXXXXXXXXXXXXXXXXXXXXXXXXXXXXXXX
