-------------------------------------------------------------------------------------------------------------------------------------------------------------------------------------------------------
-------------------------------------------------------------------------------------------------------------------------------------------------------------------------------------------------------
-------------------------------------------------------------------------------------------------------------------------------------------------------------------------------------------------------
-------------------------------------------------------------------------------------------------------------------------------------------------------------------------------------------------------
-------------------------------------------------------------------------------------------------------------------------------------------------------------------------------------------------------
-------------------------------------------------------------------------------------------------------------------------------------------------------------------------------------------------------
--##---------SSS----S!!S-SSSSSS---S!!S--------------##---------SSSSSSS----SS-----SSSSSS-S---SSSS----S!!SSS----SSS----S!!S-#SSS---S!!S-------------SSSSS---------------SSSSSSSSSSSS------------##-------
-###-----------------------------------------------###--------------------------------------------------------------------#------------------------------------------------------------------###-------
####----------------------------------------------####--------------------------------------------------------------------#-----------------------------------------------------------------####-------
####---------------------------------------------#####----------------------g---------------------------------------------#----------------------------------------------------------------#####-------
####-----------------SS------------SS------#---t######------------------------S@S--------------------SS----S----------SS--#-------SS-----#--#-----------##--#--------S-------------------#######-------
####--------------------------------------##---t######--------------------------------------------------------------------#-------------##--##---------###--##--------------------------########-------
####-------------------------------------###---t######--------------------------------------------------------------------#------------###--###--------###--###-----t---------------tt-#########------F
###M------------------------------------####---t######gg------------------------------------ggg----------k---------------g#-----------####--####-------###--####----t-------g-------tt##########------#
XXXXXXXXXXXXXXXXXXXXXXXXXXXXXXXXXXXXXXXXXXXXXXXXXXXXXXXXXXXXXXXXXXXXX---XXXXXXXXXXXXXXX---XXXXXXXXXXXXXXXXXXXXXXXXXXXXXXXXXXXXXXXXXXXXXXXXXXXXXXXXXXXXXXXX--XXXXXXXXXXXXXXXX-XXXXXXXXXXXXXXXXXXXXXXXXXX
XXXXXXXXXXXXXXXXXXXXXXXXXXXXXXXXXXXXXXXXXXXXXXXXXXXXXXXXXXXXXXXXXXXXX---XXXXXXXXXXXXXXX---XXXXXXXXXXXXXXXXXXXXXXXXXXXXXXXXXXXXXXXXXXXXXXXXXXXXXXXXXXXXXXXX--XXXXXXXXXXXXXXXX-XXXXXXXXXXXXXXXXXXXXXXXXXX
