-------------------------------------------------------------------------------------------------------------------------------------------------------------------------------------------------------
-------------------------------------------------------------------------------------------------------------------------------------------------------------------------------------------------------
-------------------------------------------------------------------------------------------------------------------------------------------------------------------------------------------------------
-------------------------------------------------------------------------------------------------------------------------------------------------------------------------------------------------------
-------------------------------------------------------------------------------------------------------------------------------------------------------------------------------------------------------
-------------------------------------------------------------------------------------------------------------------------------------------------------------------------------------------------------
--##--------SSSSSS--SSS----S!!S-----------------------------------SSSS--SS-SSS!!!S--SSS-S---SSS!--SSS----S!!S-SSS----S!!S-SSS----S!!S---------------------------S----S!!S-SSS----S!------------##------
-###--------------------------------------------------------------------------------------------------------------------------------------------------------#-------------------------------#-###------
####----------------------------------------------#--------------------------------------------------------------------------------------------------------##------------------------------######------
####---------------------------------------------##-------------------------g------------------------------------------------------------------------------##-----------------------------#######------
####------@S----------------SS------------------###-------tt---S@S------------CSS--------------C----------SS----------SS----------SS-----#--#-----------##-##tt-------SS----------S------########------
####-----------------------------------tt------####t------tt----------------------------------------------------------------------------##--##---------###-##tt-------------------------#########------
####-----------------------------------tt--tt-#####t------tt---------------------------------------------------------------------------###--###------#####-##tt---------------------tt-##########-----F
###M-----------------------------------tt--tt######t--gg--tt--------------------------------ggg----------k---------------g------------####--####----######-##tt-------------g-------tt###########-----#
XXXXXXXXXXXXXXXXXXXXXXXXXXXXXXXXXXXXXXXXXXXXXXXXXXXXXXXXXXXXXXXXXXXXXX----XXXXXXXXXXXXX---XXXXXXXXXXXXXXXXXXXXXXXXXXXXXXXXXXXXXXXXXXXXXXXXXXXXXXXXXXXXXXXX-XXXXXXXXXXXXXXXXXXXXXXXXXXXXXXXXXXXXXXXXXXXX
XXXXXXXXXXXXXXXXXXXXXXXXXXXXXXXXXXXXXXXXXXXXXXXXXXXXXXXXXXXXXXXXXXXXXX----XXXXXXXXXXXXX---XXXXXXXXXXXXXXXXXXXXXXXXXXXXXXXXXXXXXXXXXXXXXXXXXXXXXXXXXXXXXXXX-XXXXXXXXXXXXXXXXXXXXXXXXXXXXXXXXXXXXXXXXXXXX
