wwwwwwwwwwwww
www..ww....Aw
w....w.....ww
w.......www.w
w+w........ww
w.w..wwwwww.w
w.......wwwww
w....w..w..gw
wwwwwwwwwwwww
