wwwwwwwwwwwww
w....ww....Aw
w....w......w
w.w.....wwwww
w+w.........w
w.w..wwwwwwww
w.2..2..w...w
w....w...2wgw
wwwwwwwwwwwww
