wwwwwwwwwwwww
ww.2.ww....Aw
ww...w......w
w.w.....wwwww
w+w.........w
www..wwwwwwww
w.......w...w
w....w...2wgw
wwwwwwwwwwwww
