wwwwwwwwwwwww
w..2.ww....Aw
w....w......w
w.w.....wwwww
w+w.........w
w.w..wwwwwwww
w.......w...w
w....w...2wgw
wwwwwwwwwwwww
