wwwwwwwwwwwww
w...2ww....Aw
w....w......w
w.w.....wwwww
w+w...2.....w
w.w..wwwwwwww
w....2..w...w
w....w..22wgw
wwwwwwwwwwwww
