wwwwwwwwwwwww
w....ww....Aw
w.3..w......w
w.w.....wwwww
w+w3......www
w.w..wwwwwwww
w3.332..w...w
w..3.w...2wgw
wwwwwwwwwwwww
