wwwwwwwwwwwww
w....ww....Aw
w....w......w
w.w.....www.w
w+w3......www
w.w..wwwwwwww
w3.3.2..w...w
w....w....wgw
wwwwwwwwwwwww
