wwwwwwwwwwwww
w....ww....Aw
w....w......w
w.w.....wwwww
w+w3........w
w.w..wwwwwwww
w3.3.2..w...w
w....w....wgw
wwwwwwwwwwwww
