wwwwwwwwwwwww
w...2ww....Aw
w....w......w
w.w..2..wwwww
w+w.........w
w.w..wwwwwwww
w..3....w...w
w....w...2wgw
wwwwwwwwwwwww
