wwwwwwwwwwwww
w....ww....Aw
w....w......w
w.w.....wwwww
w+w.........w
w.w..wwwwwwww
w.......w...w
w....w....wgw
wwwwwwwwwwwww
