-------------------------------------------------------------------------------------------------------------------------------------------------------------------------------------------------------
-------------------------------------------------------------------------------------------------------------------------------------------------------------------------------------------------------
-------------------------------------------------------------------------------------------------------------------------------------------------------------------------------------------------------
-------------------------------------------------------------------------------------------------------------------------------------------------------------------------------------------------------
-------------------------------------------------------------------------------------------------------------------------------------------------------------------------------------------------------
-------------------------------------------------------------------------------------------------------------------------------------------------------------------------------------------------------
--##-------SSSSSS-------SSS----S!!S-----------------#----------#SSSSS-----SSSSS--SSSSSSSS---SSSSSSSS----SSS----S!!S--S!!SSSSSSS-S!!S------------------------------SSS----S!!S---SSSS----------##-------
-###-----------------------------------------------##---------##-----------------------------------------------------------------------------------------------------------------------------###-------
####----------------------------------------------###--------###----------------------------------------------------------------------------------------------------------------------------####-------
####---------------------------------------------####-------####------------g-gg-----------------------------------------------------------------------------------------------------------#####-------
####----S@S----------S----------SS--------------#####------#####--------@S-----@S--------------------S----------SS----SS---------SS------#--#----------##--#---S----------SS--------------######-------
####-------------------------------------------######-----######------------------------------------------------------------------------##--##--------###--##----------------------------#######-------
####---------------------------------------tt-#######-tt-#######-----------------------------------------------------------------------###--###------####--##------------------------tt-########------F
###M---------------g-----------------------tt#####g##-gg########----------------------------------------k-----------------g--ggg------####--####----#####--##---------------g--#-----tt#########------#
XXXXXXXXXXXXXXXXXXXXXXXXXXXXXXXXXXXXXXXXXXXXXXXXXXXXXXXXXXXXXXXXXXXXX---XXXXXXXXXXXXXXX---XXXXXXXXXXXXXXXXXXXXXXXXXXXXXXXXXXXXXXXXXXXXXXXXXXXXXXXXXXXXXXX--XXXXXXXXXXXXXXXXXXXXXXXXXXXXXXXXXXXXXXXXXXXX
XXXXXXXXXXXXXXXXXXXXXXXXXXXXXXXXXXXXXXXXXXXXXXXXXXXXXXXXXXXXXXXXXXXXX---XXXXXXXXXXXXXXX---XXXXXXXXXXXXXXXXXXXXXXXXXXXXXXXXXXXXXXXXXXXXXXXXXXXXXXXXXXXXXXX--XXXXXXXXXXXXXXXXXXXXXXXXXXXXXXXXXXXXXXXXXXXX
