-------------------------------------------------------------------------------------------------------------------------------------------------------------------------------------------------------
-------------------------------------------------------------------------------------------------------------------------------------------------------------------------------------------------------
-------------------------------------------------------------------------------------------------------------------------------------------------------------------------------------------------------
-------------------------------------------------------------------------------------------------------------------------------------------------------------------------------------------------------
-------------------------------------------------------------------------------------------------------------------------------------------------------------------------------------------------------
-------------------------------------------------------------------------------------------------------------------------------------------------------------------------------------------------------
---##---------------S!!S--------##-----------##----------------##------SS----S!!S--SSSSSS---SSS!--SSS----S!!S-SSS----S!!-SSS----S!!-------------------------------SSS----S!!S--SSSSSS---------##-------
--###--------------------------###----------###-----#---------###----------------------------------------------------------------------------------------------------------------------------###-------
-####-------------------------####---------####----##--------####---------------------------------------------------------------------------------------------------------------------------####-------
#####------------------------#####--------#####---###-------#####--------------------------------------------------------------------------------------------------------------------------#####-------
#####----------------SS-----######-------######--####tt----######-------------SS---------------C----------SS----------SS---------SS-----###--#----------##-#--------------SS--------------######-------
#####----------------------#######------#######--####tt---#######----------------------------------------------------------------------####--##--------###-##----------------------------#######-------
#####---------------------########--tt-########--####tt--########---------------------------------------------------------------------#####--###------####-###-----------------------tt-########------F
###M#--------------g-----#########--tt#########--####tgg#########---------------------------g-----------------------------g----------######--####----#####-####-------------g--------tt#########------#
XXXXXXXXXXXXXXXXXXXXXXXXXXXXXXXXXXXXXXXXXXXXXXXXXXXXXXXXXXXXXXXXXXXXXX-XXXXXXXXXXXXXXXX---XXXXXXXXXXXXXXXXXXXXXXXXXXXXXXXXXXXXXXXXXXXXXXXXXXXXXXXXXXXXXXXX-XXXXXXXXXXXXXXXXXXXXXXXXXXXXXXXXXXXXXXXXXXXX
XXXXXXXXXXXXXXXXXXXXXXXXXXXXXXXXXXXXXXXXXXXXXXXXXXXXXXXXXXXXXXXXXXXXXX-XXXXXXXXXXXXXXXX---XXXXXXXXXXXXXXXXXXXXXXXXXXXXXXXXXXXXXXXXXXXXXXXXXXXXXXXXXXXXXXXX-XXXXXXXXXXXXXXXXXXXXXXXXXXXXXXXXXXXXXXXXXXXX
