-------------------------------------------------------------------------------------------------------------------------------------------------------------------------------------------------------
-------------------------------------------------------------------------------------------------------------------------------------------------------------------------------------------------------
-------------------------------------------------------------------------------------------------------------------------------------------------------------------------------------------------------
-------------------------------------------------------------------------------------------------------------------------------------------------------------------------------------------------------
-------------------------------------------------------------------------------------------------------------------------------------------------------------------------------------------------------
-------------------------------------------------------------------------------------------------------------------------------------------------------------------------------------------------------
--##---------SSSSSSSS!!SSS----S!!S-----------##----------------##---------------SSSSSSSSS---SSSSS-SSS----S!!S--##-------SSSSS----S!!S----------##------------------------S!!S----SSSS---------##-------
-###----------------------------------------###----#----------###---------------------------------------------###-----------------------------###--------------------------------------------###-------
####---------------------------------------####---##-#-------####---------------------------------------------###----------------------------####-------------------------------------------####-------
####--------------------------------------#####--#####------#####---------------------------------------------###---------------------------#####------------------------------------------#####-------
####-----------------SS--------SS--------######-######-----######------------S@S--------------------------SS--###-----@S----------SS-------######-------##-#------------S-SS--------------######-------
####------------------------------------#######-######----#######---------------------------------------------###------------------------########------###-##----------------------------#######-------
####---------------------------------t-########-######tt-########---------------------------------------------###-----------------------#########-----####-###-----tt-----------#----tt-########------F
###M---------------g----------------#t#########-######tg#########---------------------------------------------###-----------g----------##########----#####-####----tt----------##----tt#########------#
XXXXXXXXXXXXXXXXXXX-XXXXXXXXXXXXXXXXXXXXXXXXXXXXXXXXXXXXXXXXXXXXXXXXXXXXXXXXXXXXXXXXXX----XXXXXXXXXXXXXXXXXXXXXXXXXXXXXXXXXXXXXXXXXXXXXXXXXXXXXXXXXXXXXXXX-XXXXXXXXXXXXXXXXXXXXXXXXXXXXXXXXXXXXXXXXXXXX
XXXXXXXXXXXXXXXXXXX-XXXXXXXXXXXXXXXXXXXXXXXXXXXXXXXXXXXXXXXXXXXXXXXXXXXXXXXXXXXXXXXXXX----XXXXXXXXXXXXXXXXXXXXXXXXXXXXXXXXXXXXXXXXXXXXXXXXXXXXXXXXXXXXXXXX-XXXXXXXXXXXXXXXXXXXXXXXXXXXXXXXXXXXXXXXXXXXX
