-------------------------------------------------------------------------------------------------------------------------------------------------------------------------------------------------------
-------------------------------------------------------------------------------------------------------------------------------------------------------------------------------------------------------
-------------------------------------------------------------------------------------------------------------------------------------------------------------------------------------------------------
-------------------------------------------------------------------------------------------------------------------------------------------------------------------------------------------------------
-------------------------------------------------------------------------------------------------------------------------------------------------------------------------------------------------------
-------------------------------------------------------------------------------------------------------------------------------------------------------------------------------------------------------
-##---------SSS----S!!!S--------!!S-----------------##---------##SSSSSS---S------SSSSSSSS---SS--SSS!-----S!!S-----SSSSSSSS---SSS!!!S----------##-------------------SS----S!!S-----------------##-------
###-----------------------------------------#------###--------###----------------------------------------------------------------------------###---------------------------------------------###-------
###----------------------------------------##-----####-------####---------------------------------------------------------------------------####--------------------------------------------####-------
###---------------------------------------###----#####------#####--------------------------------------------------------------------------#####-------------------------------------------#####-------
###!-----S----------SSS------#--SS-------####---######-----######-------------S@S------------------C------SS----@S--------------CSS-------######--------##--#-------------SS-------------#######-------
###-------------------------##----------#####--#######----#######-----------------------------------------------------------------------########-------###--##--------------------------########-------
###------------------------###------tt-######-########---########----------------------------------------------------------------------#########------####--###---------------------tt-#########------F
###M----------------------####------tt################---########----------------------------------------------#----------------------##########-----#####--####--------------------tt##########------#
XXXXXXXXXXXXXXXXXXXXXXXXXXXXXXXXXXXXXXXXXXXXXXXXXXXXXXXXXXXXXXXXXXXXX---XXXXXXXXXXXXXXX---XXXXXXXXXXXXXXXXXXXXXXXXXXXXXX---XXXXXXXXXXXXXXXXXXXXXXXXXXXXXXX--XXXXXXXXXXXXXXXXXXXXXXXXXXXXXXXXXXXXXXXXXXX
XXXXXXXXXXXXXXXXXXXXXXXXXXXXXXXXXXXXXXXXXXXXXXXXXXXXXXXXXXXXXXXXXXXXX---XXXXXXXXXXXXXXX---XXXXXXXXXXXXXXXXXXXXXXXXXXXXXX---XXXXXXXXXXXXXXXXXXXXXXXXXXXXXXX--XXXXXXXXXXXXXXXXXXXXXXXXXXXXXXXXXXXXXXXXXXX
