-------------------------------------------------------------------------------------------------------------------------------------------------------------------------------------------------------
-------------------------------------------------------------------------------------------------------------------------------------------------------------------------------------------------------
-------------------------------------------------------------------------------------------------------------------------------------------------------------------------------------------------------
-------------------------------------------------------------------------------------------------------------------------------------------------------------------------------------------------------
-------------------------------------------------------------------------------------------------------------------------------------------------------------------------------------------------------
-------------------------------------------------------------------------------------------------------------------------------------------------------------------------------------------------------
@-----------SSS----S!!S!S------S!!S-S---------------##------------SSSSS-SSSS-----SSSSSSSS---SS----S!!S-SSS----S!!---------SSS----S!!S---------------------------------------SSSSSS------------##-------
---------------------------------------------------###-----------#---------------------------------------------------------------------------------------------------------------------------###-------
--------------------------------------------------####----------##--------------------------------------------------------------------------------------------------------------------------####-------
-------------------------------------------------#####---------###-------------------------------------------------------------------------------------------------------------------------#####-------
!--!-----S----------SS-S--------SS--------------######---------###------------S@S------------------SS----------SS!-----S----------SS-----#--#----------##--##------------SS!--------------######-------
-----------------------------#-----------#-----#######---------###----------------------------------------------------------------------##--##--------###--###---------------------------#######-------
----------------------------##----------##-tt-########---------###----------------------------------------------------------------------##--###------####--####-----tt---------------tt-########------F
---M-----------------------###---------###-tt#########---------###---------------------------------------------------------------------###--####----#####--#####----tt---------------tt#########------#
XXXXXXXXXXXXXXXXXXXXXXXXXXXXXXXXXXXXXXXXXXXXXXXXXXXXXXXXXXXXXXXXXXXXX---XXXXXXXXXXXXXXX---XXXXXXXXXXXXXXXXXXXXXXXXXXXXXXXXXXXXXXXXXXXXXXXXXXXXXXXXXXXXXXX--XXXXXXXXXXXXXXXXXXXXXXXXXXXXXXXXXXXXXXXXXXXX
XXXXXXXXXXXXXXXXXXXXXXXXXXXXXXXXXXXXXXXXXXXXXXXXXXXXXXXXXXXXXXXXXXXXX---XXXXXXXXXXXXXXX---XXXXXXXXXXXXXXXXXXXXXXXXXXXXXXXXXXXXXXXXXXXXXXXXXXXXXXXXXXXXXXX--XXXXXXXXXXXXXXXXXXXXXXXXXXXXXXXXXXXXXXXXXXXX
