-------------------------------------------------------------------------------------------------------------------------------------------------------------------------------------------------------
-------------------------------------------------------------------------------------------------------------------------------------------------------------------------------------------------------
-------------------------------------------------------------------------------------------------------------------------------------------------------------------------------------------------------
-------------------------------------------------------------------------------------------------------------------------------------------------------------------------------------------------------
-------------------------------------------------------------------------------------------------------------------------------------------------------------------------------------------------------
-------------------------------------------------------------------------------------------------------------------------------------------------------------------------------------------------------
-##SSSS------SSS----S!!S---------------------##-----##---------##----------------SSSSSSSS---SSS!--S!!S--------SSS----S!!SSSS----S!!-----------#S!!S--------------------SSS----S!!S-------------##------
###-----------------------------------------###----###--------###----------------------------------------------------------------------------##-----------------------------------------------###------
###----------------------------------------####---####-------####---------------------------------------------------------------------------###-------------------------------------------#--####------
###---------------------------------------#####--#####------#####-----------g-gg-----------------------------------------------------------####------------------------------------------##-#####------
###-------S----------SS----!S------------######-######-----######-------------S@S--------------C---SS------S----------SS---------SS-------#####-SS------#--#--------S----------SS-------#########------
###-------------------------------------#######-######-----######------------------------------------------------------------------------######--------##--##--------------------------##########------
###---------------------------------tt-########-######-----######----------------------------------------#---------------------------tt-#######-------###--###-----------------------############-----F
###M---------------g------#---------tt#########-##g###gg---######---------------------------------------k#----------------g--ggg-----tt########------####--####-------------g-------#############-----#
XXXXXXXXXXXXXXXXXXXXXXXXXXXXXXXXXXXXXXXXXXXXXXXXXXXXXXXXXXXXXXXXXXXXX--XXXXXXXXXXXXXXXX---XXXXXXXXXXXXXXXXXXXXXXXXXXXXXXXXXXXXXXXXXXXXXXXXXXXXXXXXXXXXXXXXXXXXXXXXXXXXXXXXXXXXXXXXXXXXXXXXXXXXXXXXXXXXX
XXXXXXXXXXXXXXXXXXXXXXXXXXXXXXXXXXXXXXXXXXXXXXXXXXXXXXXXXXXXXXXXXXXXX--XXXXXXXXXXXXXXXX---XXXXXXXXXXXXXXXXXXXXXXXXXXXXXXXXXXXXXXXXXXXXXXXXXXXXXXXXXXXXXXXXXXXXXXXXXXXXXXXXXXXXXXXXXXXXXXXXXXXXXXXXXXXXX
