-------------------------------------------------------------------------------------------------------------------------------------------------------------------------------------------------------
-------------------------------------------------------------------------------------------------------------------------------------------------------------------------------------------------------
-------------------------------------------------------------------------------------------------------------------------------------------------------------------------------------------------------
-------------------------------------------------------------------------------------------------------------------------------------------------------------------------------------------------------
-------------------------------------------------------------------------------------------------------------------------------------------------------------------------------------------------------
-------------------------------------------------------------------------------------------------------------------------------------------------------------------------------------------------------
-##------------SSSSS--SSSSSS----S!!S-----------------##--------##-------SSS----S!!SSSSSSS---SSS!---!S----S!!S-------------SSS----S!!S-----------------------------------SSS----S!!S-----------##-------
###-----------------------------------------------#-###-------###----------------------------------------------------------------------------------------------------------------------------###-------
###----------------------------------------------######------####---------------------------------------------------------------------------------------------------------------------------####-------
###---------------------------------------------#######-----#####------------------------------------------------------------------------------------------------------------------------#-#####-------
###-----------------@S-----------SS------#-----########----######---------------SS-------------C---S------SS-----!-----S----------SS------#--#----------##-#---------S----------SS------########-------
###-------------------------------------##----#########---#######------------------------------------------------------------------------##--##--------###-##--------------------------#########-------
###------------------------------------###tt-##########--########-----------------------------------------------------------------------###--###------####-###-----tt-----------------##########------F
###M---------------g------------------####tt##########gg#########---------------------------g------------------#----------g------------####--####----#####-####----tt-------g--------###########------#
XXXXXXXXXXXXXXXXXXXXXXXXXXXXXXXXXXXXXXXXXXXXXXXXXXXXXXXXXXXXXXXXXXXXXX-XXXXXXXXXXXXXXX----XXXXXXXXXXXXXXXXXXXXXXXXXXXXXXXXXXXXXXXXXXXXXXXXXXXXXXXXXXXXXXXX-XXXXXXXXXXXXXXXXXXXXXXXXXXXXXXXXXXXXXXXXXXXX
XXXXXXXXXXXXXXXXXXXXXXXXXXXXXXXXXXXXXXXXXXXXXXXXXXXXXXXXXXXXXXXXXXXXXX-XXXXXXXXXXXXXXX----XXXXXXXXXXXXXXXXXXXXXXXXXXXXXXXXXXXXXXXXXXXXXXXXXXXXXXXXXXXXXXXX-XXXXXXXXXXXXXXXXXXXXXXXXXXXXXXXXXXXXXXXXXXXX
