-------------------------------------------------------------------------------------------------------------------------------------------------------------------------------------------------------
-------------------------------------------------------------------------------------------------------------------------------------------------------------------------------------------------------
-------------------------------------------------------------------------------------------------------------------------------------------------------------------------------------------------------
-------------------------------------------------------------------------------------------------------------------------------------------------------------------------------------------------------
-------------------------------------------------------------------------------------------------------------------------------------------------------------------------------------------------------
-------------------------------------------------------------------------------------------------------------------------------------------------------------------------------------------------------
##S----S!!S---SSS----S!!S-------------------------##-##-----------##-------------SSSSSSSS---SS----S!!S-SSSS----S!!S---##---------S!!S--------##S!!S------------------SSSSS@----S!!S-----------##----!S-
##-----------------------------------------------######----------###--------------------------------------------------##--------------------###----------------------------------------------###-------
##----------------------------------------------#######---------####--------------------------------------------------##-------------------####---------------------------------------------####-------
##---------------------------------------------########--------#####--------------------------------------------------##------------------#####--------------------------------------------#####-------
##------SS------------SS------#--#------------#########-------######-----------@S------------------SS-----------SS----##----------SS-----######-SS------#--#--------------!-----SS------#-######----S--
##---------------------------##--#-----------##########------#######--------------------------------------------------##----------------#######--------##--##--------------------------#########-------
##--------------------------###--#-------tt-###########------#######--------------------------------------------------##----------------#######-------###--###------#-----------------##########------F
##-M---------#-----g-------####--#-------tt############g-----#######-------------------------------------------------###----g----------########------####--####----##----------------###########------#
XXXXXXXXXXXXXXXXXXXXXXXXXXXXXXXXXXXXXXXXXXXXXXXXXXXXXXXXXXXXXXXXXXXXXXXXXXXXXXXXXXXXXXX---XXXXXXXXXXXXXXXXXXXXXXXXXXXXXXXXXXXXXXXXXXXXXXXXXXXXXXXXXXXXXXXXXXXXXXXXXXXXXXXXXXXXXXXXXXXXXXXXXXXXXXXXXXXXX
XXXXXXXXXXXXXXXXXXXXXXXXXXXXXXXXXXXXXXXXXXXXXXXXXXXXXXXXXXXXXXXXXXXXXXXXXXXXXXXXXXXXXXX---XXXXXXXXXXXXXXXXXXXXXXXXXXXXXXXXXXXXXXXXXXXXXXXXXXXXXXXXXXXXXXXXXXXXXXXXXXXXXXXXXXXXXXXXXXXXXXXXXXXXXXXXXXXXX
