-------------------------------------------------------------------------------------------------------------------------------------------------------------------------------------------------------
-------------------------------------------------------------------------------------------------------------------------------------------------------------------------------------------------------
-------------------------------------------------------------------------------------------------------------------------------------------------------------------------------------------------------
-------------------------------------------------------------------------------------------------------------------------------------------------------------------------------------------------------
-------------------------------------------------------------------------------------------------------------------------------------------------------------------------------------------------------
-------------------------------------------------------------------------------------------------------------------------------------------------------------------------------------------------------
@-----------SSS----S!!S---------##------------------##---------##----------SS----SSSSSSSS---SSS!--@-----------SSS----S!!S-SS----S!!S----------------------------SSSS-------------------------##---##---
-------------------------------###-----------------###--------###---------------------------------------------------------------------------------------------------------------------------###--###---
------------------------------####----------------####--------###--------------------------------------------------------------------------------------------------------------------------####-####---
-----------------------------#####---------------#####--------###-------------------------------------------------------------------------------------------------------------------------##########---
!--!-----S----------SS------######--------------######--------###-------------S@S--------------C--!--!-----S----------SS---------SS------#--#-----------##--#------------SS!S------------###########---
---------------------------#######-------------#######--------###-----------------------------------------------------------------------##--##---------###--##--------------------------############---
--------------------------########---------tt-########--------###----------------------------------------------------------------------###--###-------####--###-----tt--------------tt-#############--F
---M---------------g-----#########---------tt#########gg------###---------------------------g-----------------------------g-----------####--####-----#####--####----tt------g-------tt##############--#
XXXXXXXXXXXXXXXXXXXXXXXXXXXXXXXXXXXXXXXXXXXXXXXXXXXXXXXXXXXXXXXXXXXXXX-XXXXXXXXXXXXXXXX---XXXXXXXXXXXXXXXXXXXXXXXXXXXXXXXXXXXXXXXXXXXXXXXXXXXXXXXXXXXXXXXX--XXXXXXXXXXXXXXXXXXXXXXXXXXXXXXXXXXXXXXXXXXX
XXXXXXXXXXXXXXXXXXXXXXXXXXXXXXXXXXXXXXXXXXXXXXXXXXXXXXXXXXXXXXXXXXXXXX-XXXXXXXXXXXXXXXX---XXXXXXXXXXXXXXXXXXXXXXXXXXXXXXXXXXXXXXXXXXXXXXXXXXXXXXXXXXXXXXXX--XXXXXXXXXXXXXXXXXXXXXXXXXXXXXXXXXXXXXXXXXXX
