-------------------------------------------------------------------------------------------------------------------------------------------------------------------------------------------------------
-------------------------------------------------------------------------------------------------------------------------------------------------------------------------------------------------------
-------------------------------------------------------------------------------------------------------------------------------------------------------------------------------------------------------
-------------------------------------------------------------------------------------------------------------------------------------------------------------------------------------------------------
-------------------------------------------------------------------------------------------------------------------------------------------------------------------------------------------------------
-------------------------------------------------------------------------------------------------------------------------------------------------------------------------------------------------------
##----------SSS----S!!S-----------------------------##-S--------SSSSS--S---SSS!----!!SSSS---SSS!---------------S!!S------SSS----S!!!S---------------------------------------SSSS-------------##--------
##-------------------------------------------------###--------------------------------------------------------------------------------------------------------------------------------------###--------
##------------------------------------------------####-------------------------------------------------------------------------------------------------------------------------------------####--------
##-----------------------------------------------#####----------------------g-gg----------------------------------------------------------------------------------------------------------#####--------
##-!-----S----------SS------#---SS!S------------######----#--S@S--------------C----SS----------C-----SU----!----SS----S----------SSS------#--#----------##-#------------SS!S-------------######--------
##-------------------------##------------------#######----##-----------------------------------------------------------------------------##--##--------###-##---------------------------#######--------
##------------------------###--------------tt-########----###---------------------------------------------------------------------------###--###------####-###-----tt---------------tt-########-------F
##-M---------------g-----####--------------tt#####g###gg--###-------------------------------------------k-----------------g--ggg-------####--####----#####-####----tt-------g-------tt#########-------#
XXXXXXXXXXXXXXXXXXXXXXXXXXXXXXXXXXXXXXXXXXXXXXXXXXXXXXXXXXXXXXXXXXXXX----XXXXXXXXXXXXXX---XXXXXXXXXXXXXXXXXXXXXXXXXXXXXXXXXXXXXXXXXXXXXXXXXXXXXXXXXXXXXXXX-XXXXXXXXXXXXXXXXXXXXXXXXXXXXXXXXXXXXXXXXXXXX
XXXXXXXXXXXXXXXXXXXXXXXXXXXXXXXXXXXXXXXXXXXXXXXXXXXXXXXXXXXXXXXXXXXXX----XXXXXXXXXXXXXX---XXXXXXXXXXXXXXXXXXXXXXXXXXXXXXXXXXXXXXXXXXXXXXXXXXXXXXXXXXXXXXXX-XXXXXXXXXXXXXXXXXXXXXXXXXXXXXXXXXXXXXXXXXXXX
