-------------------------------------------------------------------------------------------------------------------------------------------------------------------------------------------------------
-------------------------------------------------------------------------------------------------------------------------------------------------------------------------------------------------------
-------------------------------------------------------------------------------------------------------------------------------------------------------------------------------------------------------
-------------------------------------------------------------------------------------------------------------------------------------------------------------------------------------------------------
-------------------------------------------------------------------------------------------------------------------------------------------------------------------------------------------------------
-------------------------------------------------------------------------------------------------------------------------------------------------------------------------------------------------------
@-----------SSS----S!!!S----------------------------##---------##----------------SSSSSSSS---SSSSSSSS---SSS!---------------SSS----S------------##-----------------------------------------------##------
---------------------------------------------------###--------###----------------------------------------------------------------------------###--------------------------------------------#-###------
--------------------------------------------------####-------####---------------------------------------------------------------------------####-------------------------------------------######------
-------------------------------------------------#####------#####1-------------------------------------------------------------------------#####------------------------------------------#######------
!--!-----S----------SSS---------SS!S------------######t----######-------------S@S---------@S--------------C-----SU-----S------------------######--------##--#------------SS!S------------########------
----------------------------#------------------#######t---#######------------------------------------------------------------------------#######-------###--##--------------------------#########------
---------------------------##--------------tt-########t--########--------------------------------------------------------------------tt-########------####--###-----tt--------------tt-##########-----F
---M----------------------###--------------tt#########t-#########--------------------------------------------------------------------tt#########-----#####--####----tt--------------tt###########-----#
XXXXXXXXXXXXXXXXXXXXXXXXXXXXXXXXXXXXXXXXXXXXXXXXXXXXXXXXXXXXXXXXXXXXXX--XXXXXXXXXXXXXXX---XXXXXXXX---XXXXXXXXXXXXXXXXXXXXXXXXXXXXXXXXXXXXXXXXXXXXXXXXXXXXX--XXXXXXXXXXXXXXXXXXXXXXXXXXXXXXXXXXXXXXXXXXX
XXXXXXXXXXXXXXXXXXXXXXXXXXXXXXXXXXXXXXXXXXXXXXXXXXXXXXXXXXXXXXXXXXXXXX--XXXXXXXXXXXXXXX---XXXXXXXX---XXXXXXXXXXXXXXXXXXXXXXXXXXXXXXXXXXXXXXXXXXXXXXXXXXXXX--XXXXXXXXXXXXXXXXXXXXXXXXXXXXXXXXXXXXXXXXXXX
