-------------------------------------------------------------------------------------------------------------------------------------------------------------------------------------------------------
-------------------------------------------------------------------------------------------------------------------------------------------------------------------------------------------------------
-------------------------------------------------------------------------------------------------------------------------------------------------------------------------------------------------------
-------------------------------------------------------------------------------------------------------------------------------------------------------------------------------------------------------
-------------------------------------------------------------------------------------------------------------------------------------------------------------------------------------------------------
-------------------------------------------------------------------------------------------------------------------------------------------------------------------------------------------------------
--##----S!!SSSSS----S!!S---------S!!S---------------#----------##--SSS-----------SSSSSSSS---SSS!-SSSSSS@-----------SSS----S!!S--S!!S---------------------------------------------------------##--------
-###-----------------------------------------------##---------###---------------------------------------------------------------------------------------------------------------------------###--------
####---------------------------------------#------###--------####--------------------------------------------------------------------------------------------------------------------------####--------
####---------------------------------------#-----####-------#####-------------------------------------------------------------------------------------------------------------------------#####--------
####-----SS----------SS------#----SS------##----#####------######-------------S@S--------------C-------!--!-----S----------SS----SS------#--#-----------##--#------------SS!S------------######--------
####------------------------##-----------###---######-----#######-----------------------------------------------------------------------##--##--------####--##--------------------------#######--------
####-----------------------###----------####t-#######-tt-########----------------------------------------------------------------------###--###------#####--###-----tt--------------tt-########-------F
###M---------------g------####---------#####t########-tg#########-----------------------------------------------------------g---------####--####----######--####----tt--------------tt#########-------#
XXXXXXXXXXXXXXXXXXXXXXXXXXXXXXXXXXXXXXXXXXXXXXXXXXXXXXXXXXXXXXXXXXXXX---XXXXXXXXXXXXXXX---XXXXXXXXXXXXXXXXXXXXXXXXXXXXXXXXXXXXXXXXXXXXXXXXXXXXXXXXXXXXXXXX--XXXXXXXXXXXXXXXXXXXXXXXXXXXXXXXXXXXXXXXXXXX
XXXXXXXXXXXXXXXXXXXXXXXXXXXXXXXXXXXXXXXXXXXXXXXXXXXXXXXXXXXXXXXXXXXXX---XXXXXXXXXXXXXXX---XXXXXXXXXXXXXXXXXXXXXXXXXXXXXXXXXXXXXXXXXXXXXXXXXXXXXXXXXXXXXXXX--XXXXXXXXXXXXXXXXXXXXXXXXXXXXXXXXXXXXXXXXXXX
