-------------------------------------------------------------------------------------------------------------------------------------------------------------------------------------------------------
-------------------------------------------------------------------------------------------------------------------------------------------------------------------------------------------------------
-------------------------------------------------------------------------------------------------------------------------------------------------------------------------------------------------------
-------------------------------------------------------------------------------------------------------------------------------------------------------------------------------------------------------
-------------------------------------------------------------------------------------------------------------------------------------------------------------------------------------------------------
-------------------------------------------------------------------------------------------------------------------------------------------------------------------------------------------------------
####--SSSSSS@-----------SSS----S!!S----------#-----------------##---------------SSSSSSSSS---SSS!---------S!!S--S!!SSSS#-SSSSS---S!!S----------------------------------------------------------##-------
####----------------------------------------##----------------###-----------------------------------------------------#----------------------------------------------------------------------###-------
####---------------------------------------###---------------####-----------------------------------------------------#---------------------------------------------------------------------####-------
####--------------------------------------####--------------#####-----------------------------------------------------#--------------------------------------------------------------------#####-------
####--------!--!-----S----------SS-------#####S------------######------------S@S---------------C----------SS----SS----#S---------SS------#--#-----------##-#------------SS!S--------------######-------
####-----------------------------------#######------------#######-----------------------------------------------------#-----------------##--##--------####-##----------------------------#######-------
####----------------------------------########--------tt-########-----------------------------------------------------#----------------###--###------#####-###-----tt----------------tt-########------F
###M---------------g-----------------#########--------tg#########-----------------------------------------------------#-----g---------####--####----######-####----tt----------------tt#########------#
XXXXXXXXXXXXXXXXXXXXXXXXXXXXXXXXXXXXXXXXXXXXXXXXXXXXXXXXXXXXXXXXXXXXX--XXXXXXXXXXXXXXX----XXXXXXXXXXXXXXXXXXXXXXXXXXXXXXXXXXXXXXXXXXXXXXXXXXXXXXXXXXXXXXXX-XXXXXXXXXXXXXXXXXXXXXXXXXXXXXXXXXXXXXXXXXXXX
XXXXXXXXXXXXXXXXXXXXXXXXXXXXXXXXXXXXXXXXXXXXXXXXXXXXXXXXXXXXXXXXXXXXX--XXXXXXXXXXXXXXX----XXXXXXXXXXXXXXXXXXXXXXXXXXXXXXXXXXXXXXXXXXXXXXXXXXXXXXXXXXXXXXXX-XXXXXXXXXXXXXXXXXXXXXXXXXXXXXXXXXXXXXXXXXXXX
