-------------------------------------------------------------------------------------------------------------------------------------------------------------------------------------------------------
-------------------------------------------------------------------------------------------------------------------------------------------------------------------------------------------------------
-------------------------------------------------------------------------------------------------------------------------------------------------------------------------------------------------------
-------------------------------------------------------------------------------------------------------------------------------------------------------------------------------------------------------
-------------------------------------------------------------------------------------------------------------------------------------------------------------------------------------------------------
-------------------------------------------------------------------------------------------------------------------------------------------------------------------------------------------------------
@-----------SSS----S!!S----------------------#-----------------##----------------SSSSSSSS---SSS--SSS!--------------@------SSS----S!!S-----------------------------SSS----S!!S----------------##--------
--------------------------------------------##-----#----------###---------------------------------------------------------------------------------------------------------------------------###--------
-------------------------------------------###----##---------####--------------------------------------------------------------------------------------------------------------------------####--------
------------------------------------------####---###--------#####-----------g-gg----------------------------------------------------------------------------------------------------------#####--------
!--!-----S----------SS------S------------#####--####-------######-------------S@S-------------------C-----SU----!--!--!S----------SS-----#--#----------##--#---S----------SS-------------######--------
---------------------------#------------######-#####------#######-----------------------------------------------------------------------##--##--------###--##---------------------------#######--------
--------------------------##--------tt-#############--tt-########----------------------------------------------------------------------###--###------####--###------------------#---tt-########-------F
---M---------------g-----###--------tt############g#--gg#########---------------------------------------k-----------------g--ggg------####--####----#####--####-------------g--##---tt#########-------#
XXXXXXXXXXXXXXXXXXXXXXXXXXXXXXXXXXXXXXXXXXXXXXXXXXXXXXXXXXXXXXXXXXXXX---XXXXXXXXXXXXXXX---XXXXXXXXXXXXXXXXXXXXXXXXXXXXXXXXXXXXXXXXXXXXXXXXXXXXXXXXXXXXXXX--XXXXXXXXXXXXXXXXXXXXXXXXXXXXXXXXXXXXXXXXXXXX
XXXXXXXXXXXXXXXXXXXXXXXXXXXXXXXXXXXXXXXXXXXXXXXXXXXXXXXXXXXXXXXXXXXXX---XXXXXXXXXXXXXXX---XXXXXXXXXXXXXXXXXXXXXXXXXXXXXXXXXXXXXXXXXXXXXXXXXXXXXXXXXXXXXXX--XXXXXXXXXXXXXXXXXXXXXXXXXXXXXXXXXXXXXXXXXXXX
