-------------------------------------------------------------------------------------------------------------------------------------------------------------------------------------------------------
-------------------------------------------------------------------------------------------------------------------------------------------------------------------------------------------------------
-------------------------------------------------------------------------------------------------------------------------------------------------------------------------------------------------------
-------------------------------------------------------------------------------------------------------------------------------------------------------------------------------------------------------
-------------------------------------------------------------------------------------------------------------------------------------------------------------------------------------------------------
-------------------------------------------------------------------------------------------------------------------------------------------------------------------------------------------------------
---##---------------------SSS----S!!S---------------##---------------------------SSSSSSS---SS-----SSS----S!!S-SSS----S!!S--S----S!!S-------------------------------------SS----S!!S-----------##-------
--###----------------------------------------------###---------------------------------------------------------------------------------------------------------------------------------------###-------
-####---------------------------------------------####--------------------------------------------------------------------------------------------------------------------------------------####-------
#####--------------------------------------------#####-----------1-----------------------------------------------------------------------------------------------------------------------#-#####-------
#####------------!-----S----------SS------#--#--######----tt------------------S@S--------------S----------SS----------SS---------SS------#--#-----------##--#-------------------SS------########-------
#####------------------------------------##--##-######----tt----------------------------------------------------------------------------##--##---------###--##-------------------------#########-------
#####-----------------------------------###--#########----tt---------------------------------------------------------------------------###--###------#####--###-----tt----------------##########------F
###M#--------------g-------------------####--#########gg--tt--------------------------------g-----------------------------g-----------####--####----######--####----tt------g--------###########------#
XXXXXXXXXXXXXXXXXXXXXXXXXXXXXXXXXXXXXXXXXXXXXXXXXXXXXXXXXXXXXXXXXXXXXX--XXXXXXXXXXXXXX---XXXXXXXXXXXXXXXXXXXXXXXXXXXXXXXXXXXXXXXXXXXXXXXXXXXXXXXXXXXXXXXXX--XXXXXXXXXXXXXXXXXXXXXXXXXXXXXXXXXXXXXXXXXXX
XXXXXXXXXXXXXXXXXXXXXXXXXXXXXXXXXXXXXXXXXXXXXXXXXXXXXXXXXXXXXXXXXXXXXX--XXXXXXXXXXXXXX---XXXXXXXXXXXXXXXXXXXXXXXXXXXXXXXXXXXXXXXXXXXXXXXXXXXXXXXXXXXXXXXXX--XXXXXXXXXXXXXXXXXXXXXXXXXXXXXXXXXXXXXXXXXXX
