-------------------------------------------------------------------------------------------------------------------------------------------------------------------------------------------------------
-------------------------------------------------------------------------------------------------------------------------------------------------------------------------------------------------------
-------------------------------------------------------------------------------------------------------------------------------------------------------------------------------------------------------
-------------------------------------------------------------------------------------------------------------------------------------------------------------------------------------------------------
-------------------------------------------------------------------------------------------------------------------------------------------------------------------------------------------------------
-------------------------------------------------------------------------------------------------------------------------------------------------------------------------------------------------------
--##---------SSS----S!!S----------------------------##------------##-------------SSSSSSSS---SSS!--------SSS----S!!S------SSS----S!!S----------------------------------------------------------##-------
-###-----------------------------------------------###-----------###-------------------------------------------------------------------------------------------------------------------------###-------
####----------------------------------------------####----------####------------------------------------------------------------------------------------------------------------------------####-------
####---------------------------------------------#####---------#####-----------------------------------------------------------------------------------------------------------------------#####-------
####------S----------SS------#--SS!S------------######--------######------------S--------------C-----S----------SS----S----------SS------#--#----------###--#------------SS!S-------------######-------
####------------------------##-----------------#######-------#######--------------------------------------------------------------------##--##--------####--##---------------------------#######-------
####-----------------------###-------------tt-########---tt-########-------------------------------------------------------------------###--###------#####--###-----tt---------------tt-########------F
###M----------------------####-------------tt#########---tt#########------------------------------------------------------------------####--####----######--####----tt---------------tt#########------#
XXXXXXXXXXXXXXXXXXXXXXXXXXXXXXXXXXXXXXXXXXXXXXXXXXXXXXXXXXXXXXXXXXXXXXXXXXXXXXXXXXXXXXX---XXXXXXXXXXXXXXXXXXXXXXXXXXXXXXXXXXXXXXXXXXXXXXXXXXXXXXXXXXXXXXXX--XXXXXXXXXXXXXXXXXXXXXXXXXXXXXXXXXXXXXXXXXXX
XXXXXXXXXXXXXXXXXXXXXXXXXXXXXXXXXXXXXXXXXXXXXXXXXXXXXXXXXXXXXXXXXXXXXXXXXXXXXXXXXXXXXXX---XXXXXXXXXXXXXXXXXXXXXXXXXXXXXXXXXXXXXXXXXXXXXXXXXXXXXXXXXXXXXXXX--XXXXXXXXXXXXXXXXXXXXXXXXXXXXXXXXXXXXXXXXXXX
