--#####------#####--------#####------#####-------------#####----------#####----#####------#####------#####--#####-----#####----##########--#####----#####-----#####-----#####--------#####SSSSSS-#####-
-######-----######-------######-----######------------######---------######---######-----######-----######-######----######---###########-######---######----######----######-------######------######-
#######----#######------#######----#######-----------#######--------#######--#######----#######----#######-######---#######--###################--#######---#######---#######------#######------######-
#######tt-########--tt-########tt-########-------tt-########----tt-########-########tt-########tt-########-######t-########-####################-########t-########t-########--tt-########------######-
#######tt#########--tt#########tt#########-------tt#########----tt##################tt#########tt#########-######t#######################################t#########t#########--tt#########------######-
XXXXXXXXXXXXXXXXXXXXXXXXXXXXXXXXXXXXXXXXXXXXXXXXXXXXXXXXXXXXXXXXXXXXXXXXXXXXXXXXXXXXXXXXXXXXXXXXXXXXXXXXXXXXXXXXXXXXXXXXXXXXXXXXXXXXXXXXXXXXXXXXXXXXXXXXXXXXXXXXXXXXXXXXXXXXXXXXXXXXXXXXXX------XXXXXXX
XXXXXXXXXXXXXXXXXXXXXXXXXXXXXXXXXXXXXXXXXXXXXXXXXXXXXXXXXXXXXXXXXXXXXXXXXXXXXXXXXXXXXXXXXXXXXXXXXXXXXXXXXXXXXXXXXXXXXXXXXXXXXXXXXXXXXXXXXXXXXXXXXXXXXXXXXXXXXXXXXXXXXXXXXXXXXXXXXXXXXXXXXX------XXXXXXX
###----------------------------###-----------------###--------###---------------------SSS---------------------------------------------------###---------------------------------------------#####------
###---------------------------####----------------####-------####--------------------------------------------------------------------------####--------------------------------------------######------
###--------------------------#####---------------#####-------####-------------------------------------------------------------------------#####-------------#---------------1-------------#######------
###------S----------S@S-----######--------------######------#####-----------!---S@S!S---------------------SU----!-----SU----------SS-----######-S!-----##--##------------SS--------------########------
###------------------------#######-------------#######-----######-----------------------------------------------------------------------#######-------###--###--------------------------#########------
###-----------------------########---------tt-########----#######--------------------------------------------------------------------t-########------####--####-----tt--------------tt-##########-----F
###M---------#------------########---------tt#########---########--------------------------------------------------------------------t#########-----#####--#####----tt--------------tt###########-----#
XXXXXXXXXXXXXXXXXXXXXXXXXXXXXXXXXXXXXXXXXXXXXXXXXXXXXXXXXXXXXXXXXXXXXXXXXXXXXXXXXXXXXX---XXXXXXXXXXXXXXXXXXXXXXXXXXXXXXXXXXXXXXXXXXXXXXXXXXXXXXXXXXXXXXXX--X#XXXXXXXXXXXXXXXXXXXXXXXXXXXXXXXXXXXXXXXXXX
XXXXXXXXXXXXXXXXXXXXXXXXXXXXXXXXXXXXXXXXXXXXXXXXXXXXXXXXXXXXXXXXXXXXXXXXXXXXXXXXXXXXXXX--XXXXXXXXXXXXXXXXXXXXXXXXXXXXXXXXXXXXXXXXXXXXXXXXXXXXXXXXXXXXXXXX--X#XXXXXXXXXXXXXXXXXXXXXXXXXXXXXXXXXXXXXXXXXX
