------##---------#######---------XXXXXXXXXXX---##--------------------###--########--##---------####-######---------####-----####-----####-----------####-------####------####--####---####--------####-
-----###--------########---------XXXXXXXXXXX--###-------------------####-#########--##--------#####-######--------#####----#####----#####----------#####------#####-----#####-#####--#####-------#####-
----####-------#########---------------------####------------------###############--##-------######-######-------######---######---######---------######-----######----############-######-------#####-
---#####------##########--------------------!####-----------------################--##------#######-######------#######--#######--#######--------#######----#######---####################-------#####-
--######-----###########-SSSSSSSS------------####----------------#################--##--tt-########-######--tt-########-########-########----tt-########tt-########--#####################-------#####-
-#######----#######XXXXX---------------------####---------------######################--tt#########-######--tt#########-#################----tt#########tt#########--#####################-------#####-
########tt-########XXXXX---------------------####-----------tt-########XXXXXXXXXXX####XXXXXXXXXXXXXXXXXXXXXXXXXXXXXXXXXXXXXXXXXXXXXXXXXXXXXXXXXXXXXXXXXXXXXXXXXXXXXXXXXXXXXXXXXXXXXXXXXXXXXXXXXXXXXXXXX
########tt#########-------------------------X####-----------tt#########XXXXXXXXXXX##XXXXXXXXXXXXXXXXXXXXXXXXXXXXXXXXXXXXXXXXXXXXXXXXXXXXXXXXXXXXXXXXXXXXXXXXXXXXXXXXXXXXXXXXXXXXXXXXXXXXXXXXXXXXXXXXXXX
XXXXXXXXXXXXXXXXXXX-----S------------------#------####--------####----------------##------------------------------------------------------####-----------------------------------------------####------
XXXXXXXXXXXXXXXXXXX-----------------------##-----#####-------#####----------------##-------------------------------1----------------------####----------------------------------------------#####------
#-----SS!S-------!--SS!S-----------------###----######-----#######------------S@S!##----------C------------!---S@S----SU----------------######----------##--#------#------------S----------######---!--
#---------------------------------------####---#######-----#######----------------##---------------------------------------------------#######---------###--##-----##-------------------#-#######------
#tt---------------------XXXXXXX-----tt-#####t-########-----#######----------------##--------------------------------------------------########---------###--##t----###-----tt-------tt-##########-----F
#ttM---------------g----XXXXXXX-----tt######t#########-g---#######----------t-----XX--------------#-------------------------g--------#########---------###--##t----####----tt-------tt###########-----#
XXXXXXXXXXXXXXXXXXXXXXXXXXXXXXXXXXXXXXXXXXXXXXXXXXXXXXXXXXX##XXXXXXXXXXXXXXXtXXXXXXXXX---XXXXXXXXX#XXXXXXXXXXXXXXXXXXXXXXXXXXXXXXXXXXXXXXXXXXXXXXXXXXXXXXX--XXXXXXXXXXXXXXXXXXXXXXXXXXXXXXXXXXXXXXXXXXX
XXXXXXXXXXXXXXXXXXXXXXXXXXXXXXXXXXXXXXXXXXXXXXXXXXXXXXXXXXX##XXXXXXXXXXXXXXXtXXXXXttXX---XXXXXXXXX#XXXXXXXXXXXXXXXXXXXXXXXXXXXXXXXXXXXXXXXXXXXXXXXXXXXXXXX--XXXXXXXXXXXXXXXXXXXXXXXXXXXXXXXXXXXXXXXXXXX
