-------####----####----------####--####---########--------##----####-----####------####--####----######--####-------####-###-------####----------####-------####----------####-##----####---------####-
------#####---#####---------#####-#####--#########-------###----####----#####-----#####-#####---#######-#####------#####-###------#####---------#####------#####---------#####-##---#####--------#####-
-----######--######--------######-#####-##########------####----####---######----############--##############-----######-###-----######--------######-----######--------######-##--######--------#####-
----#######-#######-------#######-################-----#####----####---######---#############-###############----#######-###----#######-------#######----#######-------#######-##-#######--------#####-
tt-################---tt-########-################----######----####---######t-##############################tt-########-###tt-########---tt-########tt-########---tt-########-##########--------#####-
tt#################---tt#########-################---#######----#####--######t###############################tt#########-###tt#########---tt#########tt#########---tt#########-##########----##--#####-
XXXXXXXXXXXXXXXXXXXXXXXXXXXXXXXXXXXXXXXXXXXXXXXX##t-########----####X--XXXXXXXXXXXXXXXXXXXXXXXXXXXXXX##XXXXXXXXXXXXXXXXXXXXXXXXXXXXXXXXXXXXXXXXXXXXXXXXXXXXXXXXXXXXXXXXXXXXXXXX##XXXXXXXXXXX###--XXXXXX
XXXXXXXXXXXXXXXXXXXXXXXXXXXXXXXXXXXXXXXXXXXXXXXXXXt#########----XXX#X--XXXXXXXXXXXXXXXXXXXXXXXXXXXXXXXXXXXXXXXXXXXXXXXXXXXXXXXXXXXXXXXXXXXXXXXXXXXXXXXXXXXXXXXXXXXXXXXXXXXXXXXXXXXXXXXXXXXXX###--XXXXXX
###----------------------------------------##-----####-------####--------------------------------------------------------------------------##-----------------------------------------------####-------
###---------------------------------------###----#####------#####-----------g-gg-------------------1--------------------------------------###----------------------------------------------#####-------
###-----S@S---------SS------#------------####---######-----######-------------S@S-------------------------SS----@S----SU---------SS------####----------##--##-----------------------------#######------
###------------------------##-----------#####--#######----#######-----------------------------------------------------------------------######--------###--###---------------------------#########-----
###-----------------------###-------tt-######-########---########-------------------------------tt-------------------------------------########------####--####-----tt--------------tt-############---F
###M---------------g-----####-------tt############g###gg#########-------------------------------tt------k------#----------g--ggg------##########----#####--#####----tt------g-------tt#############---#
XXXXXXXXXXXXXXXXXXXXXXXXXXXXXXXXXXXXXXXXXXXXXXXXXXXXXXXXXXXXXXXXXXXXX---XXXXXXXXXXXXXXX---XXXXXXXXXXXXXXXXXXXXXXXXXXXXXXXXXXXXXXXXXXXXXXX####XXXXXXXXXXXX--XXXXXXXXXXXXXXXXXXXXXXXXXXXXXXXXXXXXXXXXXXXX
XXXXXXXXXXXXXXXXXXXXXXXXXXXXXXXXXXXXXXXXXXXXXXXXXXXXXXXXXXXXXXXXXXXXX---XXXXXXXXXXXXXXX---XXXXXXXXXXXXXXXXXXXXXXXXXXXXXXXXXXXXXXXXXXXXXXXXXXXXXXXXXXXXXXX--XXXXXXXXXXXXXXXXXXXXXXXXXXXXXXXXXXXXXXXXXXXX
