XXXXXXXXXXXXXXXXXXXXXXXXXXXXXXXXXXXXXXXXXX##XXXXXXXXXXXXXXXXXXXXXXXXXX-XXXXXXXXXXXXXXXXXXXXXXXX####--------######--######----#########tt------######---#XXXXXXXXXXXXXX#-########----#####--------------
-----------------------------------------------------------------------------------------------####-------#######-#######---##########tt-----#######---#--------------#-XXXXXXXX---######-----------##-
-----------------------------------------------------------------------------------------------####---tt-########-#######t-###########tt-tt-########---X--------------#-XXXXXXXX--#######----------###-
-----------------------------------------------------------------------------------------------####---tt#########-#######t############tt-tt#########---X--------------#----------########---------####-
-----------------------------------------------------------------------------------------------####XXXXXXXXXXXXXXXXXXXXXXXXXXXXXXXX###XXXXXXXXXXXXXXXXX---------------#---------#########--------#####-
-----------------------------------------------------------------------------------------------####XXXXXXXXXXXXXXXXXXXXXXXXXXXXXXXXXXXXXXXXXXXXXXXXXXXX---------------X#--------XXXXXXXXX-------######-
--##---------SSSS----S!!SSS----S!!S-----------------##---------##--SSS----SSS!---SSSSSSSS---SSS-SSS!--SSSSSS--SSS----S!!S-SSS----S!!S---------------------------------X#-S!!S---XXXXXXXXX------#######-
-###----------------------------------------##-----###--------###------------------------------------------------------------------------------------------------------#-------------------tt-########-
####---------------------------------------###----####-------####--------------------------------------------------------------------------#---------------------------#-------------------tt#########-
####--------------------------------------####---#####------#####-------------------------------------------------------------------------##---------------------------#-----------------XXXXXXXXXXXXXX
####------------------SS--------SS-------#####--######-----######------------C--S------------------C------------------SS----------SS-----####----------t##--#----------#--SS-------------XXXXXXXXXXXXXX
####------------------------------------######-#######-----######-----------------------------------------------------------------------######--------#t##--##---------#----------------#--#######-----
####-----------------------------------###############-----######----------------------------------------------------------------------########------##t##--###-----tt-#------------tt-##-########----F
###M---------------g----------------t-################gg---######---------------------------g-----------------------------g-----------##########----###t##--####----tt#X----g--#----tt############----#
XXXXXXXXXXXXXXXXXXXXXXXXXXXXXXXXXXXXt#########XXXXXXXXXXXXXXXXXXXXXXX---XXXXXXXXXXXXXXX---XXXXXXXXXXXXXXXXXXXXXXXXXXXXXXXXXXXXXXXXXXXX######XXXXXXXXXXXXXX--XXXXXXXXXX#XXXXXXXXXXXXXXXXXXXXXXXXXXXXXXXX
XXXXXXXXXXXXXXXXXXXXXXXXXXXXXXXXXXXXXXXXXXXXXXXXXXXXXXXXXXXXXXXXXXXXX---XXXXXXXXXXXXXXX---XXXXXXXXXXXXXXXXXXXXXXXXXXXXXXXXXXXXXXXXXXXXXXXXXXXXXXXXXXXXXXXX--XXXXXXXXXX#XXXXXXXXXXXXXXXXXXXXXXXXXXXXXXXX
