-------------------------------------------------------------------------------------------------------------------------------------------------------------------------------------------------------
-------------------------------------------------------------------------------------------------------------------------------------------------------------------------------------------------------
-------------------------------------------------------------------------------------------------------------------------------------------------------------------------------------------------------
-------------------------------------------------------------------------------------------------------------------------------------------------------------------------------------------------------
-------------------------------------------------------------------------------------------------------------------------------------------------------------------------------------------------------
-------------------------------------------------------------------------------------------------------------------------------------------------------------------------------------------------------
#--SSSSSSSS---SSS!-SSS!----------------------------##------------SSSSS----SSS----SSSSSS-S---SSS!SSSSSSSS------SSS----S!!S--SS----S!!S----------------------------------!SSS----S!!S-----------##-------
#-------------------------------------------------###----------------------------------------------------------------------------------------------------------------------------------------###-------
#------------------------------------------------####---------------------------------------------------------------------------------------------------------------------------------------####-------
#-----------------------------------------------#####-----------------------g--------------------------------------------------------------------------------------------------------------#####-------
#@S--------------C----C-------------------------#####-------------------------S@S--------------C-----------S----------SS----------SS------#--#---------###--#----------S--------SS--------######-------
#--------------------------------------tttt-----#####------------------------------------------------------------------------------------##--#--------####--##-------------------------#-#######-------
#----------------------------tt--------tttt-----#####-----------------------------------------------------------------------------------###--##------#####--###-----tt----------------##########------F
#--M-------------------------tt--------tttt-----#####-gg------------------------------------ggg----------k---------------g-------------####--###----######--####----tt------g--------###########------#
XXXXXXXXX---XXXXXXXXXXXXXXXXXXXXXXXXXXXXXXXXXXXXXXXXXXXXXXXXXXXXXXXXX---XXXXXXXXXXXXXXX---XXXXXXXXXXXXXXXXXXXXXXXXXXXXXXXXXXXXXXXXXXXXXXXXXXXXXXXXXXXXXXXX--XXXXXXXXXXXXXXXXXXXXXXXXXXXXXXXXXXXXXXXXXXX
XXXXXXXXX---XXXXXXXXXXXXXXXXXXXXXXXXXXXXXXXXXXXXXXXXXXXXXXXXXXXXXXXXX---XXXXXXXXXXXXXXX---XXXXXXXXXXXXXXXXXXXXXXXXXXXXXXXXXXXXXXXXXXXXXXXXXXXXXXXXXXXXXXXX--XXXXXXXXXXXXXXXXXXXXXXXXXXXXXXXXXXXXXXXXXXX
