-------------------------------------------------------------------------------------------------------------------------------------------------------------------------------------------------------
-------------------------------------------------------------------------------------------------------------------------------------------------------------------------------------------------------
-------------------------------------------------------------------------------------------------------------------------------------------------------------------------------------------------------
-------------------------------------------------------------------------------------------------------------------------------------------------------------------------------------------------------
-------------------------------------------------------------------------------------------------------------------------------------------------------------------------------------------------------
-------------------------------------------------------------------------------------------------------------------------------------------------------------------------------------------------------
---SSSSSSSS---SSS!SSS!------------------------------##----------SSSSSSS-S--------SSSSSSSSSSSSS--SSS!----------SSS----S!---SSSSSSSS!!S------------SSSSS-----------------SSSS----S!!S-----------##-------
---------------------------------------------------###---------------------------------------------------------------------------------------------------------------------------------------###-------
--------------------------------------------------####--------------------------------------------------------------------------------------------------------------------------------------####-------
-------------------------------------------------#####-------------------------------------------------------------------------------------------------------------------------------------#####-------
S@S--------------C---C-----SU----!--------##----######-----#------------------S@S------------------C-------S----------SS@S--------SS------#--#----------##--#-------------------SS--------######-------
---------------------------------------tt###---#######-----##----------------------------------------------------------------------------##--##--------###--##-------------------------#-#######-------
---------------------------------------tt###t-########-----###--------------------------------------------------------------------------###--###------####--###-----tt----------------##########------F
---M-----------------------------------tt###t#########-----####------------------------------------------------------------------------####--####-----####--####----tt---------------###########------#
XXXXXXXXX---XXXXXXXXXXXXXXXXXXXXXXXXXXXXXXXXXXXXXXXXXXXXXXXXXXXXXXXXX---XXXXXXXXXXXXXXX--XXXXXXXXXXXXXXXXXXXXXXXXXXXXXXXXXXXXXXX-XXXXXXXXXXXXXXXXXXXXXXXXX--XXXXXXXXXXXXXXXXXXXXXXXXXXXXXXXXXXXXXXXXXXX
XXXXXXXXX---XXXXXXXXXXXXXXXXXXXXXXXXXXXXXXXXXXXXXXXXXXXXXXXXXXXXXXXXX---XXXXXXXXXXXXXXX--XXXXXXXXXXXXXXXXXXXXXXXXXXXXXXXXXXXXXXX-XXXXXXXXXXXXXXXXXXXXXXXXX--XXXXXXXXXXXXXXXXXXXXXXXXXXXXXXXXXXXXXXXXXXX
