-------------------------------------------------------------------------------------------------------------------------------------------------------------------------------------------------------
-------------------------------------------------------------------------------------------------------------------------------------------------------------------------------------------------------
-------------------------------------------------------------------------------------------------------------------------------------------------------------------------------------------------------
-------------------------------------------------------------------------------------------------------------------------------------------------------------------------------------------------------
-------------------------------------------------------------------------------------------------------------------------------------------------------------------------------------------------------
-------------------------------------------------------------------------------------------------------------------------------------------------------------------------------------------------------
--##-------------------SSSSSS----------------------##-------------SSS--SSS----S!!S-SSSS-S---S----S!!SS----S!!S------SSS----S!!SSSSS!SSSSS-------------------------------SSS----S!!S-----------##-------
-###----------------------------------------------###----------------------------------------------------------------------------------------------------------------------------------------###-------
####---------------------------------------------####---------------------------------------------------------------------------------------------------------------------------------------####-------
####--------------------------------------------#####-----------------------g-g------------------------------------------------------------------------------------------------------------#####-------
####----------------S@S------------------------######------#---S@S-------------SS-----------------SS-------SS----S----------SS-----C------#--#----------##-#--------------------SS--------######-------
####-----------------------------------ttt----#######------##----------------------------------------------------------------------------##--##--------###-##----------------------------#######-------
####-------------------------tt--------ttttt-########------###---------------------------------------------------------------------------##--###------####-###-----tt----------------tt-########------F
###M---------------g---------tt--------tttttg#######g-gg---###-------------------------------gg---------kk---------------g---g-g---------##--####----#####-####----tt-------g--------tt#########------#
XXXXXXXXXXXXXXXXXXXXXXXXXXXXXXXXXXXXXXXXXXXXXXXXXXXXXXXXXXXXXXXXXXXXX--XXXXXXXXXXXXXXXX---XXXXXXXXXXXXXXXXXXXXXXXXXXXXXXXXXXXXXXXXXXXXXXXXXXXXXXXXXXXXXXXX-XXXXXXXXXXXXXXXXXXXXXXXXXXXXXXXXXXXXXXXXXXXX
XXXXXXXXXXXXXXXXXXXXXXXXXXXXXXXXXXXXXXXXXXXXXXXXXXXXXXXXXXXXXXXXXXXXX--XXXXXXXXXXXXXXXX---XXXXXXXXXXXXXXXXXXXXXXXXXXXXXXXXXXXXXXXXXXXXXXXXXXXXXXXXXXXXXXXX-XXXXXXXXXXXXXXXXXXXXXXXXXXXXXXXXXXXXXXXXXXXX
