-------------------------------------------------------------------------------------------------------------------------------------------------------------------------------------------------------
-------------------------------------------------------------------------------------------------------------------------------------------------------------------------------------------------------
-------------------------------------------------------------------------------------------------------------------------------------------------------------------------------------------------------
-------------------------------------------------------------------------------------------------------------------------------------------------------------------------------------------------------
-------------------------------------------------------------------------------------------------------------------------------------------------------------------------------------------------------
-------------------------------------------------------------------------------------------------------------------------------------------------------------------------------------------------------
-##----------SSS----S!!SSSSSS----S!!S-------------------------------SSSSS----S!!S-SSSSSS---SSS----S!!S------SSSSS!SSSS----SSS----S!!S----------------------------------------SSSSSS-----------##-------
###------------------------------------------------#-----------------------------------------------------------------------------------------------------------------------------------------###-------
###-----------------------------------------------##----------------------------------------------------------------------------------------------------------------------------------------####-------
###----------------------------------------------###---------------------------------------------------------------------------------------------------------------------------------------#####-------
###-!-----S----------SS-----------SS------#-----####--------tt----------------SS-------------------SS-----@S-----S-----S----------SS-----#--#----------###--#------------SS!S-------------######-------
###--------------------------------------##----#####tt------tt--------------------------------------------------------------------------##--##--------####--##---------------------------#######-------
###-------------------------------------###tt-######tt------tt-------------------------------------------#-----------------------------###--###------#####--###-----tt---------------tt-########------F
###M-----------------------------------####ttg######tt-g----tt--------------------------------g---------##-----------------------------###--####----######--####----tt---------------tt#########------#
XXXXXXXXXXXXXXXXXXXXXXXXXXXXXXXXXXXXXXXXXXXXXXXXXXXXXXXXXXXXXXXXXXXXX-XXXXXXXXXXXXXXXX---XXXXXXXXXXXXXXXXXXXXXXXXXXXXXXXXXXXXXXXXXXXXXXXXXXXXXXXXXXXXXXXXX--XXXXXXXXXXXXXXXXXXXXXXXXXXXXXXXXXXXXXXXXXXX
XXXXXXXXXXXXXXXXXXXXXXXXXXXXXXXXXXXXXXXXXXXXXXXXXXXXXXXXXXXXXXXXXXXXX-XXXXXXXXXXXXXXXX---XXXXXXXXXXXXXXXXXXXXXXXXXXXXXXXXXXXXXXXXXXXXXXXXXXXXXXXXXXXXXXXXX--XXXXXXXXXXXXXXXXXXXXXXXXXXXXXXXXXXXXXXXXXXX
