-------------------------------------------------------------------------------------------------------------------------------------------------------------------------------------------------------
-------------------------------------------------------------------------------------------------------------------------------------------------------------------------------------------------------
-------------------------------------------------------------------------------------------------------------------------------------------------------------------------------------------------------
-------------------------------------------------------------------------------------------------------------------------------------------------------------------------------------------------------
-------------------------------------------------------------------------------------------------------------------------------------------------------------------------------------------------------
-------------------------------------------------------------------------------------------------------------------------------------------------------------------------------------------------------
--##----------------S!!S-----SSS----S!-------------##---------------------------SSSSSSSSS---SSSSS-S!!S----!!S-@-----------SSS----S!!----------------------------SSSSSSSSSSSSS----------------##--------
-###----------------------------------------------###---------------------------------------------------------------------------------------------------------------------------------------###--------
####---------------------------------------------####----------------------------------------------------------------------------------------#---------------------------------------------####--------
####--------------------------------------------#####-----------1---------------------------------------------------------------------------##--------------------------------------------#####--------
####-----------------SS---S----------S---------######------#-----------------S@S-------------------SS-----SS--!--!-----S----------SS-------###---------##--#-----------------------------######--tt----
####------------------------------------------#######------##-----------------------------------------------------------------------------####--------###--##---------------------------#######--tt----
####--------------------------------------tt-########------###-------------------------------------------#----------------------------tt-######------####--###----------------------tt-########--tt---F
###M--------------------------------------tt#########------####-----------------------------------------##----------------------------tt########----#####--###----------------------tt#########--tt---#
XXXXXXXXXXXXXXXXXXXXXXXXXXXXXXXXXXXXXXXXXXXXXXXXXXXXXXXXXXXXXXXXXXXXX--XXXXXXXXXXXXXXXX---XXXXXXXXXXXXXXXXXXXXXXXXXXXXXXXXXXXXXXXXXXXXXXXXXXXXXXXXXXXXXXX--XXXXXXXXXXXXXX-XXXXXXXXXXXXXXXXXXXXXXXXXXXXX
XXXXXXXXXXXXXXXXXXXXXXXXXXXXXXXXXXXXXXXXXXXXXXXXXXXXXXXXXXXXXXXXXXXXX--XXXXXXXXXXXXXXXX---XXXXXXXXXXXXXXXXXXXXXXXXXXXXXXXXXXXXXXXXXXXXXXXXXXXXXXXXXXXXXXX--XXXXXXXXXXXXXX-XXXXXXXXXXXXXXXXXXXXXXXXXXXXX
