-------------------------------------------------------------------------------------------------------------------------------------------------------------------------------------------------------
-------------------------------------------------------------------------------------------------------------------------------------------------------------------------------------------------------
-------------------------------------------------------------------------------------------------------------------------------------------------------------------------------------------------------
-------------------------------------------------------------------------------------------------------------------------------------------------------------------------------------------------------
-------------------------------------------------------------------------------------------------------------------------------------------------------------------------------------------------------
-------------------------------------------------------------------------------------------------------------------------------------------------------------------------------------------------------
---##------------!S-----SSSSSSS------------------------------------------S----S!!S-SSSSSS---SSS!--SSS----S!!--SSS----S!!S---S----S!!S---------------------------------!!S-SSSSSS-------------##--------
--###---------------------------------------------------------------------------------------------------------------------------------------------------------------------------------------###--------
-####---------------------------------------------#----------------------------------------------------------------------------------------------------------------------------------------####--------
#####--------------------------------------------##---------------------------------------------------------------------------------------------------------------------------------------#####--------
#####------------S---S@S------------------------####------------SS!S-----------SS--------------C----------SS----------SS----------SS------#--#----------##--#---------SS-S---------------######--------
#####----------------------------------tt------######------------------------------------------------------------------------------------##--##--------###--##--------------------------#######--------
#####----------------------------------tt-----########-----tt---------------------------------------------------------------------------###--###------####--###-----tt--------------tt-########-------F
###M#----------------------------------tt----g#########g---tt---------------------------------g----------------------------#-----------####--####----#####--####----tt--------------tt#########-------#
XXXXXXXXXXXXXXXXXXXXXXXXXXXXXX-XXXXXXXXXXXXXXXXXXXXXXXXXXXXXXXXXXXXXXXXXXXXXXXXXXXXXXXX---XXXXXXXXXXXXXXXXXXXXXXXXXXXXXXXXXXXXXXXXXXXXXXXXXXXXXXXXXXXXXXXX--XXXXXXXXXXXXXXXXXXXXXXXXXXXXXXXXXXXXXXXXXXX
XXXXXXXXXXXXXXXXXXXXXXXXXXXXXX-XXXXXXXXXXXXXXXXXXXXXXXXXXXXXXXXXXXXXXXXXXXXXXXXXXXXXXXX---XXXXXXXXXXXXXXXXXXXXXXXXXXXXXXXXXXXXXXXXXXXXXXXXXXXXXXXXXXXXXXXX--XXXXXXXXXXXXXXXXXXXXXXXXXXXXXXXXXXXXXXXXXXX
