-------------------------------------------------------------------------------------------------------------------------------------------------------------------------------------------------------
-------------------------------------------------------------------------------------------------------------------------------------------------------------------------------------------------------
-------------------------------------------------------------------------------------------------------------------------------------------------------------------------------------------------------
-------------------------------------------------------------------------------------------------------------------------------------------------------------------------------------------------------
-------------------------------------------------------------------------------------------------------------------------------------------------------------------------------------------------------
-------------------------------------------------------------------------------------------------------------------------------------------------------------------------------------------------------
-##----------SSS----S!!S--SSSSSSS------------------##--------------------S----S!!SSSSSS-S---SSS!--SSS----S!!S-SS----SSS----S!!S--S!!S---------------------------SSSSS-----SSS----S!----------#-##------
###-----------------------------------------------###---------------------------------------------------------------------------------------------------------------------------------------#####------
###----------------------------------------------####--------------------------------------------------------------------------------------------------------------------------------------######------
###---------------------------------------------#####------------1----------g-------------------------------------------------------------------------------------------------------------#######------
###-!-----S----------SS----------!S------------######-----tt-------------------SS--------------C----------SS-----S----------SS----SS--------#----------##--#-----------S----------S------########------
###-------------------------------------------#######-----tt-----------------------------------------------------------------------------#--##--------###--##---------------------------#########------
###---------------------------------------tt-########-----tt----------------------------------------------------------------------------##--###------####--###----------------------tt-##########-----F
###M--------------------------------------tt#########-gg--tt--------------------------------ggg----------k---------------g-------------###--####----#####--####-------------g-------tt###########-----#
XXXXXXXXXXXXXXXXXXXXXXXXXXXXXXXX-XXXXXXXXXXXXXXXXXXXXXXXXXXXXXXXXXXXXX--XXXXXXXXXXXXXXX---XXXXXXXXXXXXXXXXXXXXXXXXXXXXXXXXXXXXXXXXXXXXXXXXXXXXXXXXXXXXXXX--XXXXXXXXXXXXXXXXXXXXXXXXXXXXXXXXXXXXXXXXXXXX
XXXXXXXXXXXXXXXXXXXXXXXXXXXXXXXX-XXXXXXXXXXXXXXXXXXXXXXXXXXXXXXXXXXXXX--XXXXXXXXXXXXXXX---XXXXXXXXXXXXXXXXXXXXXXXXXXXXXXXXXXXXXXXXXXXXXXXXXXXXXXXXXXXXXXX--XXXXXXXXXXXXXXXXXXXXXXXXXXXXXXXXXXXXXXXXXXXX
