-------------------------------------------------------------------------------------------------------------------------------------------------------------------------------------------------------
-------------------------------------------------------------------------------------------------------------------------------------------------------------------------------------------------------
-------------------------------------------------------------------------------------------------------------------------------------------------------------------------------------------------------
-------------------------------------------------------------------------------------------------------------------------------------------------------------------------------------------------------
-------------------------------------------------------------------------------------------------------------------------------------------------------------------------------------------------------
-------------------------------------------------------------------------------------------------------------------------------------------------------------------------------------------------------
-##-----SS---SSS----S!!S---SS----S!!S---------------##-------------SS------------SSSSSS-S---SSS!--SSS----S!!S-------SSS----S!!S--S!!S----------------------------SSSSSSSS---SSS!-------------##--------
###------------------------------------------------###--------------------------------------------------------------------------------------------------------------------------------------###--------
###-----------------------------------------------####-------------------------------------------------------------------------------------------------------------------------------------####--------
###----------------------------------------------#####----------------------g-g-----------------------------------------------------------------------------------------------------------#####--------
###-------S----------SS-----------SS------#-----######-----tt-----------------S@S--------------C----------SS-----S----------SS----SS------#-#----------##--#-------------------C---------######-tt-----
###--------------------------------------##----#######-----tt----------------------------------------------------------------------------##-##--------###--##---------------------------#######-tt-----
###-------------------------------------###tt-########-----tt---------------------------------------------------------------------------###-###------####--###t---------------------tt-########-tt----F
###M---------------g------#------------####tg#######g#gg---tt--------------------------------gg---------kk---------------g---g-g-------####-####----#####--###t-------------g-------tt#########-tt----#
XXXXXXXXXXXXXXXXXXXXXXXXXXXXXXXXXXXXXXXXXXXXXXXXXXXXXXXXXXXXXXXXXXXXX---XXXXXXXXXXXXXXX---XXXXXXXXXXXXXXXXXXXXXXXXXXXXXXXXXXXXXXXXXXXXXXXXXXXXXXXXXXXXXXX--XXXXXXXXXXXX---XXXXXXXXXXXXXXXXXXXXXXXXXXXXX
XXXXXXXXXXXXXXXXXXXXXXXXXXXXXXXXXXXXXXXXXXXXXXXXXXXXXXXXXXXXXXXXXXXXX---XXXXXXXXXXXXXXX---XXXXXXXXXXXXXXXXXXXXXXXXXXXXXXXXXXXXXXXXXXXXXXXXXXXXXXXXXXXXXXX--XXXXXXXXXXXX---XXXXXXXXXXXXXXXXXXXXXXXXXXXXX
