-------------------------------------------------------------------------------------------------------------------------------------------------------------------------------------------------------
-------------------------------------------------------------------------------------------------------------------------------------------------------------------------------------------------------
-------------------------------------------------------------------------------------------------------------------------------------------------------------------------------------------------------
-------------------------------------------------------------------------------------------------------------------------------------------------------------------------------------------------------
-------------------------------------------------------------------------------------------------------------------------------------------------------------------------------------------------------
-------------------------------------------------------------------------------------------------------------------------------------------------------------------------------------------------------
##-----------SSS----S!!SSS!------------------------##-------------SSSS-----------SSSSSS-S---SSSSSSS-----------SSS----S!!S--S----S!!S---------------------------------------------------------##--------
##------------------------------------------------###---------------------------------------------------------------------------------------------------------------------------------------###--------
##-----------------------------------------------####--------------------------------------------------------------------------------------------------------------------------------------####--------
##----------------------------------------------#####-----------------------g-------------------------------------------------------------------------------------------------------------#####--------
##--!-----S----------SS---C-----SU-------------######------#------------------S@S--------------------!-----S----------SS---------SS------#--#----------###--#------------SS!S------------######--------
##--------------------------------------------#######------##---------------------------------------------------------------------------##--##--------####--##--------------------------#######--#-----
##----------------------------------------tt-########------###-------------------------------------------------------------------------###--###------#####--###-----tt--------------tt-########--##---F
##-M--------------------------------------tt#########-gg---####-----------------------------ggg----------k---------------g------------####--####----######--####----tt------g-------tt#########--###--#
XXXXXXXXXXXXXXXXXXXXXXXXXXXXXXXXXXXXXXXXXXXXXXXXXXXXXXXXXXXXXXXXXXXXX---XXXXXXXXXXXXXXX---XXXXXXXXXXXXXXXXXXXXXXXXXXXXXXXXXXXXXXXXXXXXXXXXXXXXXXXXXXXXXXXX--XXXXXXXXXXXXXXXXXXXXXXXXXXXXXXXXXXXXXXXXXXX
XXXXXXXXXXXXXXXXXXXXXXXXXXXXXXXXXXXXXXXXXXXXXXXXXXXXXXXXXXXXXXXXXXXXX---XXXXXXXXXXXXXXX---XXXXXXXXXXXXXXXXXXXXXXXXXXXXXXXXXXXXXXXXXXXXXXXXXXXXXXXXXXXXXXXX--XXXXXXXXXXXXXXXXXXXXXXXXXXXXXXXXXXXXXXXXXXX
