-------------------------------------------------------------------------------------------------------------------------------------------------------------------------------------------------------
-------------------------------------------------------------------------------------------------------------------------------------------------------------------------------------------------------
-------------------------------------------------------------------------------------------------------------------------------------------------------------------------------------------------------
-------------------------------------------------------------------------------------------------------------------------------------------------------------------------------------------------------
-------------------------------------------------------------------------------------------------------------------------------------------------------------------------------------------------------
-------------------------------------------------------------------------------------------------------------------------------------------------------------------------------------------------------
--##--------SSSSSSSS---SSS!------------------------------------------------------SSSSSS-S---SSS!--S!S----S!!S-------SSS----S!!S---!S-----------------------------------------------------------##------
-###----------------------------------------------------------------------------------------------------------------------------------------------------------------------------------------#-###------
####---------------------------------------------------------------------------------------------------------------------------------------------------------------------------------------######------
####---------------------------------------------------------------1--------g-g-----------------------------------------------------------------------------------------------------------#######------
####------@S--------------C-----SU----------#--#-tt---------tt----------------S@S--------------C---S------SS-----S----------SS----S------#--#----------###--#------------SS!S------------########------
####-----------------------------------tt--##--##tt---------tt--------------------------------------------------------------------------##--##--------####--##--------------------------#########------
####-----------------------------------tt-###--##tt---------tt-------------------------------------------------------------------------###--###------#####--###-----tt--------------tt-##########-----F
###M---------------g-------------------tt###g--##tt-g-gg----tt-------------------------------gg---------kk-----#---------g---g-g-#----####--####----######--####----tt------g-------tt###########-----#
XXXXXXXXXXXXXXXXXX---XXXXXXXXXXXXXXXXXXXXXXXXXXXXXXXXXXXXXXXXXXXXXXXX--XXXXXXXXXXXXXXXX---XXXXXXXXXXXXXXXXXXXXXXXXXXXXXXXXXXXXXXXXXXXXXXXXXXXXXXXXXXXXXXXX--XXXXXXXXXXXXXXXXXXXXXXXXXXXXXXXXXXXXXXXXXXX
XXXXXXXXXXXXXXXXXX---XXXXXXXXXXXXXXXXXXXXXXXXXXXXXXXXXXXXXXXXXXXXXXXX--XXXXXXXXXXXXXXXX---XXXXXXXXXXXXXXXXXXXXXXXXXXXXXXXXXXXXXXXXXXXXXXXXXXXXXXXXXXXXXXXX--XXXXXXXXXXXXXXXXXXXXXXXXXXXXXXXXXXXXXXXXXXX
