-------------------------------------------------------------------------------------------------------------------------------------------------------------------------------------------------------
-------------------------------------------------------------------------------------------------------------------------------------------------------------------------------------------------------
-------------------------------------------------------------------------------------------------------------------------------------------------------------------------------------------------------
-------------------------------------------------------------------------------------------------------------------------------------------------------------------------------------------------------
-------------------------------------------------------------------------------------------------------------------------------------------------------------------------------------------------------
-------------------------------------------------------------------------------------------------------------------------------------------------------------------------------------------------------
---##------------------SSSSSS-----------------------#----------------SS-SSS------SSSSSSSS---SSS!--------SSS----S!!S-------SSS----S!!S----------------------------------------------------------##------
--###----------------------------------------------##---------------------------------------------------------------------------------------------------------------------------------------#-###------
-####---------------------------------------------###--------------------------------------------------------------------------------------------------------------------------------------######------
#####--------------------------------------------####-------------------------------------------------------------------------------------------------------------------------------------#######------
#####---------------S@S------------------------t#####-------tt----------------S@S--------------C-----S----------SS-----S----------SS------#------------##--#-------------SS!S------------########------
#####----------------------------------tt------t#####t------tt---------------------------------------------------------------------------##--#--------###--###--------------------------#########------
#####------------------------tt--------tt------t#####t------tt--------------------------------------------------------------------------###--##------####--####-----tt--------------tt-##########-----F
###M#------------------------tt--------tt------t#####t------tt-------------------------------------------------------------------------####--###----#####--#####----tt--------------tt###########-----#
XXXXXXXXXXXXXXXXXXXXXXXXXXXXXXXXXXXXXXXXXXXXXXXXXXXXXXXXXXXXXXXXXXXXX---XXXXXXXXXXXXXXX---XXXXXXXXXXXXXXXXXXXXXXXXXXXXXXXXXXXXXXXXXXXXXXXXXXXXXXXXXXXXXXX--XXXXXXXXXXXXXXXXXXXXXXXXXXXXXXXXXXXXXXXXXXXX
XXXXXXXXXXXXXXXXXXXXXXXXXXXXXXXXXXXXXXXXXXXXXXXXXXXXXXXXXXXXXXXXXXXXX---XXXXXXXXXXXXXXX---XXXXXXXXXXXXXXXXXXXXXXXXXXXXXXXXXXXXXXXXXXXXXXXXXXXXXXXXXXXXXXX--XXXXXXXXXXXXXXXXXXXXXXXXXXXXXXXXXXXXXXXXXXXX
