-------------------------------------------------------------------------------------------------------------------------------------------------------------------------------------------------------
-------------------------------------------------------------------------------------------------------------------------------------------------------------------------------------------------------
-------------------------------------------------------------------------------------------------------------------------------------------------------------------------------------------------------
-------------------------------------------------------------------------------------------------------------------------------------------------------------------------------------------------------
-------------------------------------------------------------------------------------------------------------------------------------------------------------------------------------------------------
-------------------------------------------------------------------------------------------------------------------------------------------------------------------------------------------------------
-##SSSSSSSS----S--------SSSSSSSS---SSS!------------------------------------------SSSSSSSS---SSS!S-----SSS----S!!S---------SSS----S!!S--------------------------------------------------------##--------
###-----------------------------------------------------------------------------------------------------------------------------------------------------------------------------------------###--------
###----------------------------------------------------------------------------------------------------------------------------------------------------------------------------------------####--------
###---------------------------------------------------------------------------------------------------------------------------------------------------------------------------------------#####--------
###------------------S@S--------------C----------###------------SS!S----------S@S--------------C---S----------SS-------S----------SS------#-#-----------##--#------------SS!S------------######--------
###------------------------------------#--------#####------------------------------------------------------------------------------------##-##---------###--##--------------------------#######--------
###------------------------------------##------#######-----tt---------------------------------------------------------------------------###-###------#####--###-----tt--------------tt-########-------F
###M-----------------------------------###---g#########g---tt---------------------------------g----------------------------------------####-####----######--####----tt--------------tt#########-------#
XXXXXXXXXXXXXXXXXXXXXXXXXXXXXX---XXXXXXXXXXXXXXXXXXXXXXXXXXXXXXXXXXXXXXXXXXXXXXXXXXXXXX---XXXXXXXXXXXXXXXXXXXXXXXXXXXXXXXXXXXXXXXXXXXXXXXXXXXXXXXXXXXXXXXX--XXXXXXXXXXXXXXXXXXXXXXXXXXXXXXXXXXXXXXXXXXX
XXXXXXXXXXXXXXXXXXXXXXXXXXXXXX---XXXXXXXXXXXXXXXXXXXXXXXXXXXXXXXXXXXXXXXXXXXXXXXXXXXXXX---XXXXXXXXXXXXXXXXXXXXXXXXXXXXXXXXXXXXXXXXXXXXXXXXXXXXXXXXXXXXXXXX--XXXXXXXXXXXXXXXXXXXXXXXXXXXXXXXXXXXXXXXXXXX
