-------------------------------------------------------------------------------------------------------------------------------------------------------------------------------------------------------
-------------------------------------------------------------------------------------------------------------------------------------------------------------------------------------------------------
-------------------------------------------------------------------------------------------------------------------------------------------------------------------------------------------------------
-------------------------------------------------------------------------------------------------------------------------------------------------------------------------------------------------------
-------------------------------------------------------------------------------------------------------------------------------------------------------------------------------------------------------
-------------------------------------------------------------------------------------------------------------------------------------------------------------------------------------------------------
--##-------------------!----------------------------##---------------------SS----SSSSSSSS---SSS!--------SSS!--------------SSS----S!!S-----------SS-------------------------------------------##--------
-###-----------------------------------------------###--------------------------------------------------------------------------------------------------------------------------------------###--------
####----------------------------------------------####-------------------------------------------------------------------------------------------------------------------------------------####--------
####---------------------------------------------#####-----------1------------------------------------------------------------------------------------------------------------------------#####--------
####-------------!---S@S!S----------------------######----tt------------------S@S--------------C-----SU----C-----!-----S----------SS------#--#----------##--#------------SS!S------------######--------
####-----------------------------------t-------#######----tt-----------------------------------------------------------------------------##--##--------###--##--------------------------#######--------
####-------------------------tt--------t---tt-########----tt----------------------------------------------------------------------------###--###------####--###-----tt--------------tt-########-------F
###M-------------------------tt--------t---ttg########-g--tt----------------------------------g----------------------------------------####--###-----#####--####----tt--------------tt#########-------#
XXXXXXXXXXXXXXXXXXXXXXXXXXXXXXXXXXXXXXXXXXXXXXXXXXXXXXXXXXXXXXXXXXXXXX--XXXXXXXXXXXXXXX---XXXXXXXXXXXXXXXXXXXXXXXXXXXXXXXXXXXXXXXXXXXXXXXXXXXXXXXXXXXXXXXX--XXXXXXXXXXXXXXXXXXXXXXXXXXXXXXXXXXXXXXXXXXX
XXXXXXXXXXXXXXXXXXXXXXXXXXXXXXXXXXXXXXXXXXXXXXXXXXXXXXXXXXXXXXXXXXXXXX--XXXXXXXXXXXXXXX---XXXXXXXXXXXXXXXXXXXXXXXXXXXXXXXXXXXXXXXXXXXXXXXXXXXXXXXXXXXXXXXX--XXXXXXXXXXXXXXXXXXXXXXXXXXXXXXXXXXXXXXXXXXX
