-------------------------------------------------------------------------------------------------------------------------------------------------------------------------------------------------------
-------------------------------------------------------------------------------------------------------------------------------------------------------------------------------------------------------
-------------------------------------------------------------------------------------------------------------------------------------------------------------------------------------------------------
-------------------------------------------------------------------------------------------------------------------------------------------------------------------------------------------------------
-------------------------------------------------------------------------------------------------------------------------------------------------------------------------------------------------------
-------------------------------------------------------------------------------------------------------------------------------------------------------------------------------------------------------
---##------------------!---------------------------##-------------SSS-----SSS!----SSSSS-S---SSS!--------------@SS!---S!!S---S----S!!S-----------------------------------SSS----S!!S-----------##-------
--###---------------------------------------------###----------------------------------------------------------------------------------------------------------------------------------------###-------
-####--------------------------------------------####---------------------------------------------------------------------------------------------------------------------------------------####-------
#####-------------------------------------------#####-----------------------g-g------------------------------------------------------------------------------------------------------------#####-------
#####------------!---S@S!S---------------------######------------S-----------C-----------------C-----SU----!--!--C----SS----------SS------#--#----------##--#-------------------SS--------######-------
#####----------------------------------tt------######------------------------------------------------------------------------------------##--##--------###--##-------------------------#-#######-------
#####------------------------tt--------tt------######-----------------------------------------------------------------------------------###--###------####--###-----tt----------------##########------F
###M#--------------g---------tt--------tt---g--#####g-gg-------------------------------------gg---------kk---------------g-#-g-g-------####--####----#####--####----tt------g--------###########------#
XXXXXXXXXXXXXXXXXXXXXXXXXXXXXXXXXXXXXXXXXXXXXXXXXXXXXXXXXXXXXXXXXXXXX---XXXXXXXXXXXXXXX---XXXXXXXXXXXXXXXXXXXXXXXXXXXXXXXXXXXXXXXXXXXXXXXXXXXXXXXXXXXXXXXX--XXXXXXXXXXXXXXXXXXXXXXXXXXXXXXXXXXXXXXXXXXX
XXXXXXXXXXXXXXXXXXXXXXXXXXXXXXXXXXXXXXXXXXXXXXXXXXXXXXXXXXXXXXXXXXXXX---XXXXXXXXXXXXXXX---XXXXXXXXXXXXXXXXXXXXXXXXXXXXXXXXXXXXXXXXXXXXXXXXXXXXXXXXXXXXXXXX--XXXXXXXXXXXXXXXXXXXXXXXXXXXXXXXXXXXXXXXXXXX
