-------------------------------------------------------------------------------------------------------------------------------------------------------------------------------------------------------
-------------------------------------------------------------------------------------------------------------------------------------------------------------------------------------------------------
-------------------------------------------------------------------------------------------------------------------------------------------------------------------------------------------------------
-------------------------------------------------------------------------------------------------------------------------------------------------------------------------------------------------------
-------------------------------------------------------------------------------------------------------------------------------------------------------------------------------------------------------
-------------------------------------------------------------------------------------------------------------------------------------------------------------------------------------------------------
-@-----------SSS----S!!SSSS!-----------------------##----------------------------SSSSSSSS---SSSSSSSSS---SSS!--------SSS----S!!S---!!S----------------------------SSS----S!!S------------------##-------
--------------------------------------------------###----------------------------------------------------------------------------------------------------------------------------------------###-------
-------------------------------------------------####---------------------------------------------------------------------------------------------------------------------------------------####-------
------------------------------------------------#####------------1-------------------------------------------------------------------------------------------------------------------------#####-------
-!--!-----S----------SS----C-----SU------------######-----tt------------------S@S--------------------------C-----S----------SS----SS------#-#----------##--#-------------SS---------------######-------
----------------------------------------------#######-----tt-----------------------------------------------------------------------------##-##--------###--##----------------------------#######-------
------------------------------------------tt-########-----tt----------------------------------------------------------------------------###-###------####--###-----------------------tt-########------F
---M--------------------------------------tt#########-----tt---------------------------------------------------------------------#-----####-####----#####--####----------------------tt#########------#
XXXXXXXXXXXXXXXXXXXXXXXXXXXXXXXXXXXXXXXXXXXXXXXXXXXXXXXXXXXXXXXXXXXXXX--XXXXXXXXXXXXXXX---XXXXXXXXX---XXXXXXXXXXXXXXXXXXXXXXXXXXXXXXXXXXXXXXXXXXXXXXXXXXX--XXXXXXXXXXXXXXXXXXXXXXXXXXXXXXXXXXXXXXXXXXXX
XXXXXXXXXXXXXXXXXXXXXXXXXXXXXXXXXXXXXXXXXXXXXXXXXXXXXXXXXXXXXXXXXXXXXX--XXXXXXXXXXXXXXX---XXXXXXXXX---XXXXXXXXXXXXXXXXXXXXXXXXXXXXXXXXXXXXXXXXXXXXXXXXXXX--XXXXXXXXXXXXXXXXXXXXXXXXXXXXXXXXXXXXXXXXXXXX
