-------------------------------------------------------------------------------------------------------------------------------------------------------------------------------------------------------
-------------------------------------------------------------------------------------------------------------------------------------------------------------------------------------------------------
-------------------------------------------------------------------------------------------------------------------------------------------------------------------------------------------------------
-------------------------------------------------------------------------------------------------------------------------------------------------------------------------------------------------------
-------------------------------------------------------------------------------------------------------------------------------------------------------------------------------------------------------
-------------------------------------------------------------------------------------------------------------------------------------------------------------------------------------------------------
-##----------SSS----S!!S-------------------------------------------SSS----SSS!----SSSSS-S----SSSSSSSS---SSS!--------------SSS----S!!S---------------------------SSS!--S!---------------------##--------
###-----------------------------------------------------------------------------------------------------------------------------------------------------------------------------------------###--------
###----------------------------------------------------------------------------------------------------------------------------------------------------------------------------------------####--------
###---------------------------------------#-----------------------1---------g-------------------------------------------------------------------------------------------------------------#####--------
###-------S----------SS-------------------#-----tt---------tt----------------C-------------@S--------------C-----SU----S----------SS------#--#---------##--#-------C---C-SS!S------------######--------
###------------------------------------tt-#-----tt---------tt----------------------------------------------------------------------------##--#--------###--##-------#-------------------#######--------
###--------------------------tt--------tt-#-----tt---------tt---------------------------------------------------------------------------###--##------####--###------##--------------tt-########-------F
###M-------------------------tt--------tt-#-----tt----gg---tt-------------------------------ggg----------k---------------g-------------####--###----#####--###------##------g-------tt#########-------#
XXXXXXXXXXXXXXXXXXXXXXXXXXXXXXXXXXXXXXXXXXXXXXXXXXXXXXXXXXXXXXXXXXXXX---XXXXXXXXXXXXXXX---XXXXXXXXX---XXXXXXXXXXXXXXXXXXXXXXXXXXXXXXXXXXXXXXXXXXXXXXXXXXX--XXXXXXXXXXXXXXXXXXXXXXXXXXXXXXXXXXXXXXXXXXXX
XXXXXXXXXXXXXXXXXXXXXXXXXXXXXXXXXXXXXXXXXXXXXXXXXXXXXXXXXXXXXXXXXXXXX---XXXXXXXXXXXXXXX---XXXXXXXXX---XXXXXXXXXXXXXXXXXXXXXXXXXXXXXXXXXXXXXXXXXXXXXXXXXXX--XXXXXXXXXXXXXXXXXXXXXXXXXXXXXXXXXXXXXXXXXXXX
