-------------------------------------------------------------------------------------------------------------------------------------------------------------------------------------------------------
---##-------------####-##---------------------------SSS------------###-----------##---#-#--###------##---------##------------##--##----##--------##---##---------------##---------##-------------------
--###------------########--------------SSSSSSS---SSS----SSSSSS----####----------###--##-#-####-----###--------###-----------###--##---###-------###--###--------------###--------###-------------------
-####-----------#########SSSSSSS---SSS!--------------------------#####---------####-###-######----####-------####----------####--##--####------####-####-------------####-------####--------------SSS!-
#####----------##########---------------------------------------######--------#########-######---#####------#####---------#####--##-#####------#########------------#####------#####-------------------
#####---------###########--------------------------------------#######-------##########-######--######-----######--------######--########------#########-----------######-----######----------##-------
#####--------############-------------------------------------########------###########-######-#######----#######-------#######--########------#########----------#######----#######---------###-------
#####----tt-#############-------------C-----------------------########--tt-############-##############tt-########---tt-########--########------#########------tt-########tt-########--------####-----C-
#####----tt##############-------------------------------------########--tt#############-##############tt#########---tt#########--########------#########------tt#########tt#########-------#####-------
XXXXXXXXXXXXXXXXXXXXXXXXX---------------------------X---------XXXXXXXX--XXXXgXXXXXXXXXX-XXXXXXXXXXXXXXXXXXXXXXXXXXXXXXXXXXXXXXXXXXXXXXXXXXXXXXXXXXXXXXXXXXXXXXXXXXXXXXXXXXXXXXXXXXXX------######-------
XXXXXXXXXXXXXXXXXXXXXXXXX--------------XXXXX---XXXXXX---XXXXX-XXXXXXXX--XXXXXXXXXXXXXXX-XXXXXXXXXXXXXXXXXXXXXXXXXXXXXXXXXXXXXXXXXXXXXXXXXXXXXXXXXXXXXXXXXXXXXXXXXXXXXXXXXXXXXXXXXXXX-----#######-------
###-------------------------------------##--------###t------tt---------------------------------------------------------------------------#--##--------#########----##----------------------#######-----
###--------------------------t----------###------####t------tt------------------------------------------------------------------------tt-#--###------##########----###--------------tt-tt-########----F
###M------------------------#t----------####----#####tgg----tt------------------------------ggg----------k---------------g#-----------tt##--####----###########----####-----g-------tt#tt#########----#
XXXXXXXXXXXXXXXXXXXXXXXXXXXXXXXXXXXXXXXXXXXXXXXXXXXXXXXXXXXXXXXXXXXXX---XXXXXXXXXXXXXX----tXXXXXXXXXXXXXXXXXXXXXXXXXXXXXXXXXXXXXXXXXXXXXXXXXXXXXXXXXXXXXXXXXXXXXXXXXXXXXXXXXXXXXXXXXXXXXXXXXXXXXXXXXXXX
XXXXXXXXXXXXXXXXXXXXXXXXXXXXXXXXXXXXXXXXXXXXXXXXXXXXXXXXXXXXXXXXXXXXX---XXXXXXXXXXXXXX----tXXXXXXXXXXXXXXXXXXXXXXXXXXXXXXXXXXXXXXXXXXXXXXXXXXXXXXXXXXXXXXXXXXXXXXXXXXXXXXXXXXXXXXXXXXXXXXXXXXXXXXXXXXXX
