XXXXXXXXXXXXXX------#####-----#####tt-########-------#######------#######----#######---------#######---###-----#######XXXXXXXXXXXXXXXXXXXXXXXXXXXXXXXXXXXXXXXX###########----#######-######------------
XXXXXXXXXXXXXX-----######----######tt#########---tt-########--tt-########tt-########-----tt-########---###-tt-########----------------------------------------###########tt-###############------------
------------------#######---#######XXXXXXXXXXXX--tt#########--tt#########tt#########-----tt#########---###-tt#########----------------------------------------###########tt################------------
-----------------########t-########XXXXXXXXXXXXXXXXXXXXXXXXXXXXXXXXXXXXXXXXXXXXXXXXXXXXXXXXXXXXXXXXXXXX###XXXXXXXXXXXX----------------------------------------#####XXXXXXXXXXXXXXXXX#######------SSSS--
--------------###########t#########------------XXXXXXXXXXXXXXXXXXXXXXXXXXXXXXXXXXXXXXXXXXXXXXXXXXXXXXXXXXXXXXXXXXXXXXX----------------------------------------XXXXXXXXXXXXXXXXXXXXXXXXXXXXXX-----------
--------------##XXXXXXXXXXXXXXXXXXX-----------------------------------------------------------------------------------------------------------------------------------------------------------##-------
-##-----------##XXXXXXXXXXXXXXXXXXX----------------##-------------------SS----S!!SSSSSSSS---SSS!----SSSSSSS-SSS-SSSSSS----SSS----S!SSS----------------------------SSS----S!!S--S!!S----------###-------
###-----------##-----------------------------------##---------------------------------------------------------------------------------------------------------------------------------------####-------
###-----------##----------------------------------###---------------------------------------------------------------------------------------#----------------------------------------------#-####------
###-----------##--1------------------------------####-------------1------------------------------------------------------------------------##---------------------------------------------#######------
###-----------##------S----------S-------tt-----#####-----#tt------------------SS--------------C---S-------S---S-------S----------S-------###----------##--#tt------------SS----SS------#########------
###-----------##-------------------------tt----######-----#tt----------------------------------------------------------------------------#####--------###--#tt-------------------------##########XX---X
###-----------XX-------------------------tt----######-----#tt-------------------------------------------------------------------------t-#######------####--#tt------------------------###########XX---F
###M----------XX-------------------------tt--g-######--g--#tt---------------------------------g---------------------------------------t#########----#####--#tt-----------------------##############--##
XXXXXXXXXXXXXXXXXXXXXXXXXXXXXXXXXXXXXXXXXXXXXXX####XXXXXXXXXXXXXXXXXXXX-XXXXXXXXXXXXXXX---XXXXXXXXXXXXXXXX-XXXXXXXXXXXXXXXXXXXXXXXXXXXXXXXXXXXXXXXXXXXXXX--XXXXXXXXXXXXXXXXXXXXXXXXXXXXXXXXXXXXXXXXXXXX
XXXXXXXXXXXXXXXXXXXXXXXXXXXXXXXXXXXXXXXXXXXXXXX####XXXXXXXXXXXXXXXXXXXX-XXXXXXXXXXXXXXX---XXXXXXXXXXXXXXXX-XXXXXXXXXXXXXXXXXXXXXXXXXXXXXXXXXXXXXXXXXXXXXX--XXXXXXXXXXXXXXXXXXXXXXXXXXXXXXXXXXXXXXXXXXXX
