-------------------------------------------------------------------------------------------------------------------------------------------------------------------------------------------------------
--##--##-----------##--------##---------------------SSS------------------###------------------##---###---------##-------##---------##--##---SSSS----##-----------------------##----##------------------
-###-###----------###-------###-----------------------------------------####-----------------###--####--------###------###--------###-###-SS-------###------SS--------------###---###------------------
########---------####------####-----------S!!S---------SSSSSS---SSS!---#####----##----------####-#####-------####-----####-------####-###---------####--------SS!----------####--####------------------
########--------#####-----#####SSSSSSS---------------------------------#####---###---------###########------#####----#####------#####-###--------#####--------------------#####-#####------------------
########-------######----######----------------------------------------#####--####---------###########-----######---######-----######-###-------######-------------------############---------##-------
########------#######---#######-------------------------------------#--#####-#####---------###########----#######---######----#######-###-------######------------------#############--------###-------
########--tt-########--########------------SS------#---------------C#--###########---------###########tt-########---######tt-########-###-------######----------C---tt-##############-------####-------
########--tt#########-#########-------------------##----------------#--###########---------###########tt#########---######tt#########-###-------######--------------tt###############------#####-------
XXXXXXXXXXXXXXXXXXXXXXXXXXXXXXX------------------###X---------------X--XXXXXg#g###---------XXXXXXXXXXXXXXXXXXXXXXXXXXXXXXXXXXXXXXXXXXXXXXX--XX--XXXXXXXXXXXX-----XXXXXXXXXXXXXXXXXXXXXXXX-######-------
XXXXXXXXXXXXXXXXXXXXXXXXXXXXXXX-----------------####X---------------X--XXXXX######---------XXXXXXXXXXXXXXXXXXXXXXXXXXXXXXXXXXXXXXXXXXXXXXXXXXX--XXXXXXXXXXXXXX---XXXXXXXXXXXXXXXXXXXXXXXX#######-------
###-------------------------------------####---######t------tt--------------------------------------------------------------------------######--------#########----##-------------------##########-----
###--------------------------tt--------#####--#######t------tt------------------------------------------------------------------tt-----########------##########----###--------------tt-###########----F
###M---------------g---------tt-------######g#######gtgg----tt-------------------------------gg---------kk---------------g---g-gtt----##########----###########----####-----g-------tt############----#
XXXXXXXXXXXXXXXXXXXXXXXXXXXXXXXXXXtt-################XXXXXXXXXXXXXXXX---XXXXXXXXXXXXXX----XXXXXXXXXXXXXXXXXXXXXXXXXXXXXXXXXXXXXXXXXXX########XXXXXXXXXXXXXXXXXXXXXXXXXXXXXXXXXXXXXXXXXXXXXXXXXXXXXXXXXX
XXXXXXXXXXXXXXXXXXXXXXXXXXXXXXXXXXtt########XXXXXXXXXXXXXXXXXXXXXXXXX---XXXXXXXXXXXXXX----XXXXXXXXXXXXXXXXXXXXXXXXXXXXXXXXXXXXXXXXXXXXXXXXXXXXXXXXXXXXXXXXXXXXXXXXXXXXXXXXXXXXXXXXXXXXXXXXXXXXXXXXXXXXX
