--###------------###-----###-####-----###----------------###-----------###---###-------###--------###---------##------------##-##-----##-----------##--------------##---------##---##-##---------------
-####-----------####----#########----####---------------####----------####--####------####-------####--------###-----------###-##----###----------###--------------##--------###--######---------------
#####----------#####---##########---#####SSSSSSSS---SSS#####---------#####-#####-----#####------#####-------####----------####-##---####---------####SSSSSSS---SSS!##-------####-#######---------------
#####---------######--###########--######--------------#####--------############----######-----######------#####---------#####-##--#####-----SSS!####--------------##------#####-#######---------------
#####--------#######-############-#######--------------#####-------#############---#######----#######-----######--------######-##-######---------####--------------##-----######-#######---------------
#####----tt-#############################--------------#####----t-##############t-########tt-########----#######-------#######-#########---------####--------------##----#######-#######------##-------
#####----tt##############################--------------#####----t###############t#########tt#########tt-########---tt-########-#########---------####-------------C##tt-########-#######-----###-------
XXXXXXXXXXXXXXXXXXXXXXXXXXXXXXXX#XXXXXXXX--------------XXXXXXXXXXXXXXXXXXXXXXXXXXXXXXXXXXXXXXXXXXXXXXtt#########---tt#########-#########--------C####--------------##tt#########-#######----####-------
XXXXXXXXXXXXXXXXXXXXXXXXXXXXXXXXXXXXXXXXX--------------XXXXXXXXXXXXXXXXXXXXXXXXXXXXXXXXXXXXXXXXXXXXXXXXXXXXXXXXXXXXXXXXXXXXXXXXXXXXXXXXXXXXXX----XXXX--------------XXXXXXXXXXXXXXXXXXXXX---#####-------
###-------------1----------------1-----------------###------##--1------------1---------------1-------XXXXXXXXXXXXXXXXXXXXXXXXXXXXXXXXXXXXXXXX----XXXX--------------XXXXXXXXXXXXXXXXXXXXX--######-------
###-------S------U--S@S!S--------------#----------####-----###----------------S@S------------------!-------!----------SS----------SS-----######--------######----------S------------------######-##----
###------------------------------------##--------#####----####--------------------------------------------------------------------------#######-------########---------------------------#######-##----
###-------------------------tt---------###------######----####-------------------------------------------------------------------------########------##########-----tt--------------ttt-########-##---F
###M------------------------tt---------####----#######----####-------------------------------------------------------------------------########-----############----tt#-------------ttt#########-##---#
XXXXXXXXXXXXXXXXXXXXXXXXXXXXXXXXXXXXXXXXXXXXXXXXXXXXXXXXXX####XXXXXXX--XXXXXXXXXXXXXXXX---XXXXXXXXXXXXXXXXXXXXXXXXXXXXXXXXXXXXXXXXXXXXXXXXXXXXXXXXXXXXXXXXXXX###XXXXXXXXXXXXXXXXXXXXXXXXXXXXXXXXXXXXXXX
XXXXXXXXXXXXXXXXXXXXXXXXXXXXXXXXXXXXXXXXXXXXXXXXXXXXXXXXXX####XXXXXXX--XXXXXXXXXXXXXXXX---XXXXXXXXXXXXXXXXXXXXXXXXXXXXXXXXXXXXXXXXXXXXXXXXXXXXXXXXXXXXXXXXXXXXXXXXXXXXXXXXXXXXXXXXXXXXXXXXXXXXXXXXXXXXX
