-------------------------------------------------------------------------------------------------------------------------------------------------------------------------------------------------------
-------------------------------------------------------------------------------------------------------------------------------------------------------------------------------------------------------
-------------------------------------------------------------------------------------------------------------------------------------------------------------------------------------------------------
-------------------------------------------------------------------------------------------------------------------------------------------------------------------------------------------------------
-------------------------------------------------------------------------------------------------------------------------------------------------------------------------------------------------------
-------------------------------------------------------------------------------------------------------------------------------------------------------------------------------------------------------
--##---------SSS----S!!S-----SSS----S----------------------------SSSSSS---S-----SSSSSSSS---SSS----S!!SS-SSS!--SSS----S!!S--SS----S!!S-------------------------------------SSSSSS-------------####------
-###-----------------------------------------------#----------------------------------------------------------------------------------------------------------------------------------------#####------
####----------------------------------------------##---------------------------------------------------------------------------------------------------------------------------------------######------
####---------------------------------------------###--------------------------------------------------------------------------------------------------------------------------------------#######------
####------S----------SS-------------------------####-------tt----------------S@S-------------------SS------C----------SS----------SS------#------------##--#-----------S@S---------------########------
####-------------------------------------------#####t------tt----------------------------------------------------------------------------##--#--------###--##---------------------------#########------
####---------------------------------------tt-######t------tt---------------------------------------------------------------------------###--##------####--###----------------------tt-##########-----F
###M----------------------#----------------tg######gt--g---tt---------------------------------g----------------------------------------####--###----#####--####---------------------tt###########-----#
XXXXXXXXXXXXXXXXXXXXXXXXXXXXXXXXXXXXXXXXXXXXXXXXXXXXXXXXXXXXXXXXXXXXX---XXXXXXXXXXXXXX---XXXXXXXXXXXXXXXXXXXXXXXXXXXXXXXXXXXXXXXXXXXXXXXXXXXXXXXXXXXXXXXX--XXXXXXXXXXXXXXXXXXXXXXXXXXXXXXXXXXXXXXXXXXXX
XXXXXXXXXXXXXXXXXXXXXXXXXXXXXXXXXXXXXXXXXXXXXXXXXXXXXXXXXXXXXXXXXXXXX---XXXXXXXXXXXXXX---XXXXXXXXXXXXXXXXXXXXXXXXXXXXXXXXXXXXXXXXXXXXXXXXXXXXXXXXXXXXXXXX--XXXXXXXXXXXXXXXXXXXXXXXXXXXXXXXXXXXXXXXXXXXX
