-------------------------------------------------------------------------------------------------------------------------------------------------------------------------------------------------------
-------------------------------------------------------------------------------------------------------------------------------------------------------------------------------------------------------
-------------------------------------------------------------------------------------------------------------------------------------------------------------------------------------------------------
-------------------------------------------------------------------------------------------------------------------------------------------------------------------------------------------------------
-------------------------------------------------------------------------------------------------------------------------------------------------------------------------------------------------------
-------------------------------------------------------------------------------------------------------------------------------------------------------------------------------------------------------
--##-------------------SSSSSS-------------------------------------------SSSSSS!!S-SSSSSSS---SSS!--------SSS----S!!S------SSSSSSSS-------------------------------SSS----S!!SSSSSSSS-------------##------
-###------------------------------------------------------------------------------------------------------------------------------------------------------------------------------------------###------
####-----------------------------------------------------------------------------------------------------------------------------------------#---------------------------------------------#-####------
####-------------------------------------------------------------1--------------------------------------------------------------------------##--------------------------------------------#######------
####----------------S@S------------------------tt--tt-----tt------------------SS---------------C-----S----------SS----S@S------------------###---------##--#------------SS---------------########------
####-----------------------------------tt------tt--tt-----tt------------------------------------------------------------------------------####--------###--##---------------------------#########------
####-------------------------#---------tt------tt--tt-----tt--------------------------------------------------------------------------tt-######------####--###----------------------tt-##########-----F
###M----------------g--------##--------tt---g--tt--tt--g--tt---------------------------------gg---------k--------------------g--------tt########----#####--###--------------g-------tt###########-----#
XXXXXXXXXXXXXXXXXXXXXXXXXXXXXXXXXXXXXXXXXXXXXXXXXXXXXXXXXXXXXXXXXXXXXX--XXXXXXXXXXXXXXX---XXXXXXXXXXXXXXXXXXXXXXXXXXXXXXXXXXXXXXXXXXXXXXXXXXXXXXXXXXXXXXX--XXXXXXXXXXXXXXXXXXXXXXXXXXXXXXXXXXXXXXXXXXXX
XXXXXXXXXXXXXXXXXXXXXXXXXXXXXXXXXXXXXXXXXXXXXXXXXXXXXXXXXXXXXXXXXXXXXX--XXXXXXXXXXXXXXX---XXXXXXXXXXXXXXXXXXXXXXXXXXXXXXXXXXXXXXXXXXXXXXXXXXXXXXXXXXXXXXX--XXXXXXXXXXXXXXXXXXXXXXXXXXXXXXXXXXXXXXXXXXXX
