-------------------------------------------------------------------------------------------------------------------------------------------------------------------------------------------------------
-------------------------------------------------------------------------------------------------------------------------------------------------------------------------------------------------------
-------------------------------------------------------------------------------------------------------------------------------------------------------------------------------------------------------
-------------------------------------------------------------------------------------------------------------------------------------------------------------------------------------------------------
-------------------------------------------------------------------------------------------------------------------------------------------------------------------------------------------------------
-------------------------------------------------------------------------------------------------------------------------------------------------------------------------------------------------------
-##----------SSS----S!!SSS!---------SSS-------------------------SSSSSSSS---SSS!--SSSSSSS-----------SSSSSS-----SSS----S!!S--SSSSSSS!!S-------------------------------------SSS----S!S----------##-------
###------------------------------------------------------------------------------------------------------------------------------------------------------------------------------------------###-------
###-----------------------------------------------------------------------------------------------------------------------------------------------------------------------------------------####-------
###----------------------------------------------------------------------------------------------------------------------------------------------------------------------------------------#####-------
###-------S----------SS---C-----SU--------------#--#----------@S--------------C-----------------S@S--------S----------SS----------SS-----#--#----------##--#-----------S----------S-------######-------
###------------------------------------#-------##--##--------#--------------------------------------------------------------------------##--##--------###--##----------------------------#######-------
###------------------------------------##-----###--###------##--------------------------------------------------------------------------##--###------####--###-----------------------tt-########------F
###M-----------------------------------###---####--####----###-------------------------------------------------------------------------###--####----#####--####----------------------tt#########------#
XXXXXXXXXXXXXXXXXXXXXXXXXXXXXXXXXXXXXXXXXXXXXXXXXXXXXXXXXXXXXXXXXXXXXX---XXXXXXXXXXXXX----XXXXXXXXXXXXXXXXXXXXXXXXXXXXXXXXXXXXXXXXXXXXXXXXXXXXXXXXXXXXXXX--XXXXXXXXXXXXXXXXXXXXXXXXXXXXXXXXXXXXXXXXXXXX
XXXXXXXXXXXXXXXXXXXXXXXXXXXXXXXXXXXXXXXXXXXXXXXXXXXXXXXXXXXXXXXXXXXXXX---XXXXXXXXXXXXX----XXXXXXXXXXXXXXXXXXXXXXXXXXXXXXXXXXXXXXXXXXXXXXXXXXXXXXXXXXXXXXX--XXXXXXXXXXXXXXXXXXXXXXXXXXXXXXXXXXXXXXXXXXXX
