-------------------------------------------------------------------------------------------------------------------------------------------------------------------------------------------------------
-------------------------------------------------------------------------------------------------------------------------------------------------------------------------------------------------------
-------------------------------------------------------------------------------------------------------------------------------------------------------------------------------------------------------
-------------------------------------------------------------------------------------------------------------------------------------------------------------------------------------------------------
-------------------------------------------------------------------------------------------------------------------------------------------------------------------------------------------------------
-------------------------------------------------------------------------------------------------------------------------------------------------------------------------------------------------------
--##----SSS----S!!------SSS----S----SSS------------##----------SSSSSSS----SS-S!!S--SSSS-----SSSSS--SSS----S!!S---!S--S!!S-SSS----S!!S-------------------------------------SSS----S!!----------##-------
-###----------------------------------------------###----------------------------------------------------------------------------------------------------------------------------------------###-------
####---------------------------------------------####---------------------------------------------------------------------------------------------------------------------------------------####-------
####--------------------------------------------#####-------------------------g------------------------------------------------------------------------------------------------------------#####-------
####------------SS---S-----------S-------------######-------------------------SS---------------------------SS----S----SS----------SS------#-#----------##--#-----------S----------SS------######-------
####-----------------------------------#------#######------------------------------------------------------------------------------------##-##--------###--##----------------------------#######-------
####-----------------------------------##----########-----------------------------------------------------------------------------------###-###------####--###-----------------------tt-########------F
###M---------------g-------------------###--g########-gg-------------------------------------ggg--------k-------#-----------gg-g-------####-####----#####--####-------------g--------tt#########------#
XXXXXXXXXXXXXXXXXXXXXXXXXXXXXXXXXXXXXXXXXXXXXXXXXXXXXXXXXXXXXXXXXXXXX---XXXXXXXXXXXXXXX---XXXXXXXXXXXXXXXXXXXXXXXXXXXXXXXXXXXXXXXXXXXXXXXXXXXXXXXXXXXXXXX--XXXXXXXXXXXXXXXXXXXXXXXXXXXXXXXXXXXXXXXXXXXX
XXXXXXXXXXXXXXXXXXXXXXXXXXXXXXXXXXXXXXXXXXXXXXXXXXXXXXXXXXXXXXXXXXXXX---XXXXXXXXXXXXXXX---XXXXXXXXXXXXXXXXXXXXXXXXXXXXXXXXXXXXXXXXXXXXXXXXXXXXXXXXXXXXXXX--XXXXXXXXXXXXXXXXXXXXXXXXXXXXXXXXXXXXXXXXXXXX
