-------------------------------------------------------------------------------------------------------------------------------------------------------------------------------------------------------
-------------------------------------------------------------------------------------------------------------------------------------------------------------------------------------------------------
-------------------------------------------------------------------------------------------------------------------------------------------------------------------------------------------------------
-------------------------------------------------------------------------------------------------------------------------------------------------------------------------------------------------------
-------------------------------------------------------------------------------------------------------------------------------------------------------------------------------------------------------
-------------------------------------------------------------------------------------------------------------------------------------------------------------------------------------------------------
-##-----------------SSS----S!!S---------------------##--------------SS----SS-S!!SSSSSSSSS---SSS!--------------SSS!--------SSS----S!!S--------------------------SSS----S!!S-------------------##--------
###------------------------------------------------###--------------------------------------------------------------------------------------------------------------------------------------###--------
###-----------------------------------------------####-------------------------------------------------------------------------------------------------------------------------------------####--------
###----------------------------------------------#####------------------------------------------------------------------------------------------------------------------------------------#####--------
###--------------S----------SS------------------######-----#------------------SS---------------C-----SU----!-----C-----S----------SS-----#--#----------##--#-----------SS--!S------------######--------
###------------------------------------tt------#######-----##---------------------------------------------------------------------------##--##--------###--##---------------------------#######--------
###------------------------------------tt-----########-----###-------------------------------------------------------------------------###--###------####--###----------------------tt-########---t---F
###M----------------g------------------tt---g-########-g---####----#-------------------------gg---------k--------------------g--------####--####----#####--###--------------g-------tt#########---t---#
XXXXXXXXXXXXXXXXXXXXXXXXXXXXXXXXXXXXXXXXXXXXXXXXXXXXXXXXXXXXXXXXXXXXX---XXXXXXXXXXXXXXX---XXXXXXXXXXXXXXXXXXXXXXXXXXXXXXXXXXXXXXXXXXXXXXXXXXXXXXXXXXXXXXX--XXXXXXXXXXXXXXXXXXXXXXXXXXXXXXXXXXXXXXXXXXXX
XXXXXXXXXXXXXXXXXXXXXXXXXXXXXXXXXXXXXXXXXXXXXXXXXXXXXXXXXXXXXXXXXXXXX---XXXXXXXXXXXXXXX---XXXXXXXXXXXXXXXXXXXXXXXXXXXXXXXXXXXXXXXXXXXXXXXXXXXXXXXXXXXXXXX--XXXXXXXXXXXXXXXXXXXXXXXXXXXXXXXXXXXXXXXXXXXX
