-------------------------------------------------------------------------------------------------------------------------------------------------------------------------------------------------------
-------------------------------------------------------------------------------------------------------------------------------------------------------------------------------------------------------
-------------------------------------------------------------------------------------------------------------------------------------------------------------------------------------------------------
-------------------------------------------------------------------------------------------------------------------------------------------------------------------------------------------------------
-------------------------------------------------------------------------------------------------------------------------------------------------------------------------------------------------------
-------------------------------------------------------------------------------------------------------------------------------------------------------------------------------------------------------
-##-SSS----S!!S-S----S!!S--------------------------##-------------------------S!!S--SSS-----SSS!---SSS----S!!SSSS----S!!S-SSS----S!!S---------------------------------SSSSS-------------------##-------
###-----------------------------------------------###----------------------------------------------------------------------------------------------------------------------------------------###-------
###----------------------------------------------####------------------------------------------------------------------------------------------------------#--------------------------------####-------
###----------------------------------------------####------------1------------g----------------------------------------------------------------------------##-----------------------------######-------
###---------SS--------SS-----------------------tt####-----tt-------------------SS--------------C-----------SS---------SS----------SS-----#--#----------##--##--------------!S------------#######-------
###------------------------------------tt------tt####-----tt----------------------------------------------------------------------------##--##--------###--###--------------------------########-------
###--------------------------tt--------tt------tt####-----tt---------------------------------------------------------------------------###--###------####--####-----tt--------------tt-#########------F
###M---------------g---------tt--------tt---g--tt####-gg--tt---------------------------------ggg--------k-------------------gg-g------####--####----#####--#####----tt------g-------tt##########------#
XXXXXXXXXXXXXXXXXXXXXXXXXXXXXXXXXXXXXXXXXXXXXXXXXXXXXXXXXXXXXXXXXXXXXX--XXXXXXXXXXXXXXX---XXXXXXXXXXXXXXXXXXXXXXXXXXXXXXXXXXXXXXXXXXXXXXXXXXXXXXXXXXXXXXX--XXXXXXXXXXXXXXXXXXXXXXXXXXXXXXXXXXXXXXXXXXXX
XXXXXXXXXXXXXXXXXXXXXXXXXXXXXXXXXXXXXXXXXXXXXXXXXXXXXXXXXXXXXXXXXXXXXX--XXXXXXXXXXXXXXX---XXXXXXXXXXXXXXXXXXXXXXXXXXXXXXXXXXXXXXXXXXXXXXXXXXXXXXXXXXXXXXX--XXXXXXXXXXXXXXXXXXXXXXXXXXXXXXXXXXXXXXXXXXXX
