-------------------------------------------------------------------------------------------------------------------------------------------------------------------------------------------------------
-------------------------------------------------------------------------------------------------------------------------------------------------------------------------------------------------------
-------------------------------------------------------------------------------------------------------------------------------------------------------------------------------------------------------
-------------------------------------------------------------------------------------------------------------------------------------------------------------------------------------------------------
-------------------------------------------------------------------------------------------------------------------------------------------------------------------------------------------------------
-------------------------------------------------------------------------------------------------------------------------------------------------------------------------------------------------------
--##--------S-------SSS----S!!S----------------------------------------SSSSS--S!!SSSSSSSS---SSS!--------SSS!--SSS----S!!--SSS----S!!S-----------SS------------------SSS!--SSSSSSS-------------##-------
-###-----------------------------------------------------------------------------------------------------------------------------------------------------------------------------------------###-------
####---------------------------------------------------------------------------------------------------------------------------------------------------------#------------------------------####-------
####---------------------------------------------------------------1----------------------------------------------------------------------------------------##-----------------------------#####-------
####-------------S----------SS-----------------tttt---------tt-----------------SS--------------C-----SU----C----------SS----------SS------#--#---------##--###---------C------------------######-------
####-----------------------------------tt------tttt---------tt---------------------------------------------------------------------------##--##-------###--###---------------------------#######-------
####-----------------------------------tt------tttt---------tt--------------------------------------------------------------------------###--##------####--###t----------------------tt-########------F
###M-----------------------------------tt------tttt---------tt-------------------------------------------------------------------------####--##-----#####--###t----------------------tt#########------#
XXXXXXXXXXXXXXXXXXXXXXXXXXXXXXXXXXXXXXXXXXXXXXXXXXXXXXXXXXXXXXXXXXXXXXXXXXXXXXXXXXXXXXX---XXXXXXXXXXXXXXXXXXXXXXXXXXXXXXXXXXXXXXXXXXXXXXXXXXXXXXXXXXXXXXX--XXXXXXXXXXXXXXXXXXXXX-XXXXXXXXXXXXXXXXXXXXXX
XXXXXXXXXXXXXXXXXXXXXXXXXXXXXXXXXXXXXXXXXXXXXXXXXXXXXXXXXXXXXXXXXXXXXXXXXXXXXXXXXXXXXXX---XXXXXXXXXXXXXXXXXXXXXXXXXXXXXXXXXXXXXXXXXXXXXXXXXXXXXXXXXXXXXXX--XXXXXXXXXXXXXXXXXXXXX-XXXXXXXXXXXXXXXXXXXXXX
