-------------------------------------------------------------------------------------------------------------------------------------------------------------------------------------------------------
-------------------------------------------------------------------------------------------------------------------------------------------------------------------------------------------------------
-------------------------------------------------------------------------------------------------------------------------------------------------------------------------------------------------------
-------------------------------------------------------------------------------------------------------------------------------------------------------------------------------------------------------
-------------------------------------------------------------------------------------------------------------------------------------------------------------------------------------------------------
-------------------------------------------------------------------------------------------------------------------------------------------------------------------------------------------------------
-##-S----S!!S-------SSS----S!----------------------------------------------------SSSSSSSS-SSSSSSSSSSSSS-------SSS----S!!S--SS----S!!S----------------------------------SSS----S!!S------------##-------
###------------------------------------------------------------------------------------------------------------------------------------------------------------------------------------------###-------
###-----------------------------------------------------------------------------------------------------------------------------------------------------------------------------------------####-------
###----------------------------------------------------------------------------------------------------------------------------------------------------------------------------------------#####-------
###-------SS-----S----------S------------------tt---------tt------------------S@S--------------------------S----------SS----------SS------#-#----------##--#-------------------SS---------######-------
###------------------------------------tt------tt---------tt-t---------------------------------------------------------------------------##-##--------###--##-------#--------------------#######-------
###--------------------------tt--------tt------tt---------tt-t--------------------------------------------------------------------------###-###------####--###-----t##---------------#t-########------F
###M-------------------------tt--------tt---g--tt--g---g--tt-t--------------------------------g----------------------------------------####-####----#####--####----t##--------------##t#########------#
XXXXXXXXXXXXXXXXXXXXXXXXXXXXXXXXXXXXXXXXXXXXXXXXXXXXXXXXXXXXXXXXXXXXXX--XXXXXXXXXXXXXXX---XXXXXXXXXXXX-XXXXXXXXXXXXXXXXXXXXXXXXXXXXXXXXXXXXXXXXXXXXXXXXXX--XXXXXXXXXXXXXXXXXXXXXXXXXXXXXXXXXXXXXXXXXXXX
XXXXXXXXXXXXXXXXXXXXXXXXXXXXXXXXXXXXXXXXXXXXXXXXXXXXXXXXXXXXXXXXXXXXXX--XXXXXXXXXXXXXXX---XXXXXXXXXXXX-XXXXXXXXXXXXXXXXXXXXXXXXXXXXXXXXXXXXXXXXXXXXXXXXXX--XXXXXXXXXXXXXXXXXXXXXXXXXXXXXXXXXXXXXXXXXXXX
