-------------------------------------------------------------------------------------------------------------------------------------------------------------------------------------------------------
-------------------------------------------------------------------------------------------------------------------------------------------------------------------------------------------------------
-------------------------------------------------------------------------------------------------------------------------------------------------------------------------------------------------------
-------------------------------------------------------------------------------------------------------------------------------------------------------------------------------------------------------
-------------------------------------------------------------------------------------------------------------------------------------------------------------------------------------------------------
-------------------------------------------------------------------------------------------------------------------------------------------------------------------------------------------------------
-@-----------SSS----S!!S------------------------------------------SSSS----SSS!-----SSSS-----SSS!SSSSSSSSSSSSSS------SSS----S!!S---!S--------------------------------------SSS----S!!S----------##------
----------------------------------------------------------------------------------------------------------------------------------------------------------------------------------------------###------
---------------------------------------------------------------------------------------------------------------------------------------------------------------------------------------------####------
------------------------------------------------------------------------------g-------------------------------------------------------------------------------------------------------------#####------
-!--!-----S----------SS-------------------------tt---------tt---!------------C-----------------C-----------------S----------SS----S------#--#----------##--#----------------------SS------#######------
---------------------------------------tt-------tt---------tt---------------------------------------------------------------------------##--##--------###--##----------------------------########------
-----------------------------tt--------tt-------tt---------tt--------------------------------------------------------------------------###--###------####--###-----tt-------------------#########-----F
---M---------------g------#--tt--------tt---g---tt----gg---tt--------------------------------ggg--------k-------------------gg-g-#----####--####----#####--####----tt-------g----------##########-----#
XXXXXXXXXXXXXXXXXXXXXXXXXXXXXXXXXXXXXXXXXXXXXXXXXXXXXXXXXXXXXXXXXXXXX---XXXXXXXXXXXXXXX---XXXXXXXXXXXXXXXXXXXXXXXXXXXXXXXXXXXXXXXXXXXXXXXXXXXXXXXXXXXXXXX--XXXXXXXXXXXXXXXXXXXXXXXXXXXXXXXXXXXXXXXXXXXX
XXXXXXXXXXXXXXXXXXXXXXXXXXXXXXXXXXXXXXXXXXXXXXXXXXXXXXXXXXXXXXXXXXXXX---XXXXXXXXXXXXXXX---XXXXXXXXXXXXXXXXXXXXXXXXXXXXXXXXXXXXXXXXXXXXXXXXXXXXXXXXXXXXXXX--XXXXXXXXXXXXXXXXXXXXXXXXXXXXXXXXXXXXXXXXXXXX
