-------------------------------------------------------------------------------------------------------------------------------------------------------------------------------------------------------
-------------------------------------------------------------------------------------------------------------------------------------------------------------------------------------------------------
-------------------------------------------------------------------------------------------------------------------------------------------------------------------------------------------------------
-------------------------------------------------------------------------------------------------------------------------------------------------------------------------------------------------------
-------------------------------------------------------------------------------------------------------------------------------------------------------------------------------------------------------
-------------------------------------------------------------------------------------------------------------------------------------------------------------------------------------------------------
-##----------SSS----S!!S----------------------------##------------SSSSS----------SSSSSSSS---S-SSS----S!!S-SSSSSSS!--------SSS----S!!S------------------------------------SSSSSS--------------##--------
###------------------------------------------------###--------------------------------------------------------------------------------------------------------------------------------------###--------
###-----------------------------------------------####-------------------------------------------------------------------------------------------------------------------------------------####--------
###----------------------------------------------#####------------------------------------------------------------------------------------------------------------------------------------#####--------
###-------S----------SS--S----------------------######-----#------------------S@S---------------------SS---------C-----S----------SS------#-#----------##--#----------S@S----------------######--------
###------------------------------------tt------#######-----##----------------------------------------------------------------------------##-##--------###--##---------------------------#######--------
###--------------------------tt--------tt--tt-########-----###--------------------------------------------------------------------------###-###------####--###-----tt---------------tt-########-------F
###M-------------------------tt--------tt--tt#########-----####------------------------------------------------------------------------####-####----#####--####----tt---------------tt#########-------#
XXXXXXXXXXXXXXXXXXXXXXXXXXXXXXXXXXXXXXXXXXXXXXXXXXXXXXXXXXXXXXXXXXXXX---XXXXXXXXXXXXXXX---XXXXXXXXXXXXXXXXXXXXXXXXXXXXXXXXXXXXXXXXXXXXXXXXXXXXXXXXXXXXXXX--XXXXXXXXXXXXXXXXXXXXXXXXXXXXXXXXXXXXXXXXXXXX
XXXXXXXXXXXXXXXXXXXXXXXXXXXXXXXXXXXXXXXXXXXXXXXXXXXXXXXXXXXXXXXXXXXXX---XXXXXXXXXXXXXXX---XXXXXXXXXXXXXXXXXXXXXXXXXXXXXXXXXXXXXXXXXXXXXXXXXXXXXXXXXXXXXXX--XXXXXXXXXXXXXXXXXXXXXXXXXXXXXXXXXXXXXXXXXXXX
