-------------------------------------------------------------------------------------------------------------------------------------------------------------------------------------------------------
-------------------------------------------------------------------------------------------------------------------------------------------------------------------------------------------------------
-------------------------------------------------------------------------------------------------------------------------------------------------------------------------------------------------------
-------------------------------------------------------------------------------------------------------------------------------------------------------------------------------------------------------
-------------------------------------------------------------------------------------------------------------------------------------------------------------------------------------------------------
-------------------------------------------------------------------------------------------------------------------------------------------------------------------------------------------------------
---SSSSSSSS---SSS!-----SSS!-------------------------##-----------------SSS----S!!S--SSSSS---SSS!--------------------SSS----S!!S--S!!S---------------------------------SSSSSSS----------------##--------
---------------------------------------------------###--------------------------------------------------------------------------------------------------------------------------------------###--------
--------------------------------------------------####-------------------------------------------------------------------------------------------------------------------------------------####--------
-------------------------------------------------#####-----------1------------------------------------------------------------------------------------------------------------------------#####--------
S@S--------------C--------C-----SU--------------######----tt-------------------SS--------------C-----SU----!-----S----------SS----SS------#--#---------##--#-----------------------------######--------
-----------------------------------------------#######----tt-----------------------------------------------------------------------------##--##--------##--##---------------------------#######--------
-------------------------------------------tt-########----tt----------------------------------------------------------------------------###--###------###--###-----tt---------------tt-########-------F
---M---------------------------------------tg######g##-g--tt----------------------------------g----------------------------------------####--####----####--####----tt---------------tt#########-------#
XXXXXXXXX---XXXXXXXXXXXXXXXXXXXXXXXXXXXXXXXXXXXXXXXXXXXXXXXXXXXXXXXXXX-XXXXXXXXXXXXXXXX---XXXXXXXXXXXXXXXXXXXXXXXXXXXXXXXXXXXXXXXXXXXXXXXXXXXXXXXXXXXXXXX--XXXXXXXXXXXXXXXXX-XXXXXXXXXXXXXXXXXXXXXXXXXX
XXXXXXXXX---XXXXXXXXXXXXXXXXXXXXXXXXXXXXXXXXXXXXXXXXXXXXXXXXXXXXXXXXXX-XXXXXXXXXXXXXXXX---XXXXXXXXXXXXXXXXXXXXXXXXXXXXXXXXXXXXXXXXXXXXXXXXXXXXXXXXXXXXXXX--XXXXXXXXXXXXXXXXX-XXXXXXXXXXXXXXXXXXXXXXXXXX
