-------------------------------------------------------------------------------------------------------------------------------------------------------------------------------------------------------
-------------------------------------------------------------------------------------------------------------------------------------------------------------------------------------------------------
-------------------------------------------------------------------------------------------------------------------------------------------------------------------------------------------------------
-------------------------------------------------------------------------------------------------------------------------------------------------------------------------------------------------------
-------------------------------------------------------------------------------------------------------------------------------------------------------------------------------------------------------
-------------------------------------------------------------------------------------------------------------------------------------------------------------------------------------------------------
-##-----SS--SSSSSSSS---SSS!---------SS--------------------------SSSSSS----SSS!----SSSSSS----------SSS----S!!S-----SSSSS---SSS----S!!S---------------------------------------------------------##-------
###------------------------------------------------------------------------------------------------------------------------------------------------------------------------------------------###-------
###-----------------------------------------------------------------------------------------------------------------------------------------------------------------------------------------####-------
###---------------------------------------------------------------------------------------------------------------------------------------------------------------------------------------######-------
###-------@S--------------C-----SU-------------tt---------tt-----------------C-----------------S----------SS-----S-----S----------SS------#-#----------##--#-------------SS!S------------#######-------
###------------------------------------tt------tt---------tt-----------------------------------------------------------------------------##-##--------###--###--------------------------########-------
###------------------------------------tt------tt---------tt----------------------------------------------------#-----------------------###-###------####--####-----tt--------------tt-#########------F
###M----------------g------------------tt---g--tt------g--tt---------------------------------gg---------k------##------------g---------####-####----#####--#####----tt------g-------tt##########------#
XXXXXXXXXXXXXXXXXX---XXXXXXXXXXXXXXXXXXXXXXXXXXXXXXXXXXXXXXXXXXXXXXXX---XXXXXXXXXXXXXX----XXXXXXXXXXXXXXXXXXXXXXXXXXXXXXXXXXXXXXXXXXXXXXXXXXXXXXXXXXXXXXX--XXXXXXXXXXXXXXXXXXXXXXXXXXXXXXXXXXXXXXXXXXXX
XXXXXXXXXXXXXXXXXX---XXXXXXXXXXXXXXXXXXXXXXXXXXXXXXXXXXXXXXXXXXXXXXXX---XXXXXXXXXXXXXX----XXXXXXXXXXXXXXXXXXXXXXXXXXXXXXXXXXXXXXXXXXXXXXXXXXXXXXXXXXXXXXX--XXXXXXXXXXXXXXXXXXXXXXXXXXXXXXXXXXXXXXXXXXXX
