-------------------------------------------------------------------------------------------------------------------------------------------------------------------------------------------------------
-------------------------------------------------------------------------------------------------------------------------------------------------------------------------------------------------------
-------------------------------------------------------------------------------------------------------------------------------------------------------------------------------------------------------
-------------------------------------------------------------------------------------------------------------------------------------------------------------------------------------------------------
-------------------------------------------------------------------------------------------------------------------------------------------------------------------------------------------------------
-------------------------------------------------------------------------------------------------------------------------------------------------------------------------------------------------------
---SSSSSSSS---SSS!S--SSS----S!!S-------------------------------------------------SSSSSS------SSS----S!!S@-----------SSS----S!!S--S!!S-----------SSS-------------------------------------------##-------
---------------------------------------------------#-----------------------------------------------------------------------------------------------------------------------------------------###-------
--------------------------------------------------##----------------------------------------------------------------------------------------------------------------------------------------####-------
-------------------------------------------------###-------------1------------g------------------------------------------------------------------------------------------------------------#####-------
S@S--------------C-----------SS-SS!S------------####-------tt-----------------S@S--------------------SS-!--!-----S----------SS----SS------#--#---------##--#------------SS!S--------------######-------
-----------------------------------------------#####t------tt----------------------------------------------------------------------------##--##-------###--##----------------------------#######-------
-------------------------------------------tt-######t------tt---------------------------------------------------------------------------###--##------####--###-----tt----------------tt-########------F
---M---------------g-----------------------tg#######t-gg---tt--------------------------------ggg--------k-------------------gg-g-------####--##-----#####--####----tt-------g--------tt#########------#
XXXXXXXXX---XXXXXXXXXXXXXXXXXXXXXXXXXXXXXXXXXXXXXXXXXXXXXXXXXXXXXXXXXX--XXXXXXXXXXXXXXX---XXXXXXXXXXXXXXXXXXXXXXXXXXXXXXXXXXXXXXXXXXXXXXXXXXXXXXXXXXXXXXX--XXXXXXXXXXXXXXXXXXXXXXXXXXXXXXXXXXXXXXXXXXXX
XXXXXXXXX---XXXXXXXXXXXXXXXXXXXXXXXXXXXXXXXXXXXXXXXXXXXXXXXXXXXXXXXXXX--XXXXXXXXXXXXXXX---XXXXXXXXXXXXXXXXXXXXXXXXXXXXXXXXXXXXXXXXXXXXXXXXXXXXXXXXXXXXXXX--XXXXXXXXXXXXXXXXXXXXXXXXXXXXXXXXXXXXXXXXXXXX
