-------------------------------------------------------------------------------------------------------------------------------------------------------------------------------------------------------
-------------------------------------------------------------------------------------------------------------------------------------------------------------------------------------------------------
-------------------------------------------------------------------------------------------------------------------------------------------------------------------------------------------------------
-------------------------------------------------------------------------------------------------------------------------------------------------------------------------------------------------------
-------------------------------------------------------------------------------------------------------------------------------------------------------------------------------------------------------
-------------------------------------------------------------------------------------------------------------------------------------------------------------------------------------------------------
-##-----SSSSSSSS---SSS!-----------------------------##---------------------------SSSSSSSS--SSSSSSSS---SSS!----------SSS----S!!--S!!S-----------------------------------------------------------##------
###------------------------------------------------###--------------------------------------------------------------------------------------------------------------------------------------#-###------
###-----------------------------------------------####-------------------------------------------------------------------------------------------------------------------------------------######------
###----------------------------------------------#####-----------1------------------------------------------------------------------------------------------------------------------------#######------
###-------------------C-----SU------------------######-----t------------------S@S------------------------C-------S----------SS---SS------#--#----------##--#-------------SS!S------------########------
###------------------------------------tt------#######-----t----------------------------------------------------------------------------##--##--------###--##---------------------------#########------
###------------------------------------tt-----########-----t---------------------------------------------------------------------------###--###------####--###------tt--------------tt-##########-----F
###M----------------g------------------tt---g-########-g---t---------------------------------gg---------k--------------------g--------####--####----#####--#####----tt------g-------tt###########-----#
XXXXXXXXXXXXXX---XXXXXXXXXXXXXXXXXXXXXXXXXXXXXXXXXXXXXXXXXXXXXXXXXXXXX--XXXXXXXXXXXXXXX---XXXXXXX---XXXXXXXXXXXXXXXXXXXXXXXXXXXXXXXXXXXXXXXXXXXXXXXXXXXXX--XXXXXXXXXXXXXXXXXXXXXXXXXXXXXXXXXXXXXXXXXXXX
XXXXXXXXXXXXXX---XXXXXXXXXXXXXXXXXXXXXXXXXXXXXXXXXXXXXXXXXXXXXXXXXXXXX--XXXXXXXXXXXXXXX---XXXXXXX---XXXXXXXXXXXXXXXXXXXXXXXXXXXXXXXXXXXXXXXXXXXXXXXXXXXXX--XXXXXXXXXXXXXXXXXXXXXXXXXXXXXXXXXXXXXXXXXXXX
