-------------------------------------------------------------------------------------------------------------------------------------------------------------------------------------------------------
-------------------------------------------------------------------------------------------------------------------------------------------------------------------------------------------------------
-------------------------------------------------------------------------------------------------------------------------------------------------------------------------------------------------------
-------------------------------------------------------------------------------------------------------------------------------------------------------------------------------------------------------
-------------------------------------------------------------------------------------------------------------------------------------------------------------------------------------------------------
-------------------------------------------------------------------------------------------------------------------------------------------------------------------------------------------------------
--##------------SSSSSS-!---------------------------##---------------------------SSSSSSSS-----------SSSSSSSS---SSS!--------SSS----S!!S--------------------------------------------------------##--------
-###----------------------------------------------###---------------------------------------------------------------------------------------------------------------------------------------###--------
####---------------------------------------------####--------------------------------------------------------------------------------------------------------------------------------------####--------
####---------------------------------------------####-------------------------------------------------------------------------------------------------------------------------------------#####--------
####------------------@S!S---------------------tt####------------------------S@S----------------S@S--------------C-----S----------SS------#------------##--#------------SS!S-------------######--------
####-----------------------------------tt------tt####------------------------------------------------------------------------------------##--#--------###--##---------------------------#######--------
####-------------------------tt--------tt------tt####-----------------------------------------------------------------------------------###--##------####--###-----tt---------------tt-########-------F
###M-------------------------tt--------tt---g--tt##g#--g--------------------------------------g----------------------------------------####--###----#####--####----tt---------------tt#########-------#
XXXXXXXXXXXXXXXXXXXXXXXXXXXXXXXXXXXXXXXXXXXXXXXXXXXXXXXXXXXXXXXXXXXXX--XXXXXXXXXXXXXXX----XXXXXXXXXXXXXXX---XXXXXXXXXXXXXXXXXXXXXXXXXXXXXXXXXXXXXXXXXXXXX--XXXXXXXXXXXXXXXXXXXXXXXXXXXXXXXXXXXXXXXXXXXX
XXXXXXXXXXXXXXXXXXXXXXXXXXXXXXXXXXXXXXXXXXXXXXXXXXXXXXXXXXXXXXXXXXXXX--XXXXXXXXXXXXXXX----XXXXXXXXXXXXXXX---XXXXXXXXXXXXXXXXXXXXXXXXXXXXXXXXXXXXXXXXXXXXX--XXXXXXXXXXXXXXXXXXXXXXXXXXXXXXXXXXXXXXXXXXXX
