-------------------------------------------------------------------------------------------------------------------------------------------------------------------------------------------------------
-------------------------------------------------------------------------------------------------------------------------------------------------------------------------------------------------------
-------------------------------------------------------------------------------------------------------------------------------------------------------------------------------------------------------
-------------------------------------------------------------------------------------------------------------------------------------------------------------------------------------------------------
-------------------------------------------------------------------------------------------------------------------------------------------------------------------------------------------------------
-------------------------------------------------------------------------------------------------------------------------------------------------------------------------------------------------------
---SSSSSSSS---SSS!-----!----------------------------##--------------SSS---SSS!---SSSSSSSS---SSS!----------SS----S!!S-----SSSSSSSS!!S----------------------------------------------------------##-------
---------------------------------------------------###---------------------------------------------------------------------------------------------------------------------------------------###-------
--------------------------------------------------####--------------------------------------------------------------------------------------------------------------------------------------####-------
-------------------------------------------------#####-------------1-----------------------------------------------------------------------------------------------------------------------#####-------
S@S--------------C---S@S!S----------------------######----tttt---------------C--S--------------C-----SU----------SS---S@S--------SS------#--#----------##--#-------------SS!S------------#######-------
---------------------------------------tt------#######----tttt--------------------------------------------------------------------------##--##--------###--###--------------------------########-------
-----------------------------tt--------tt--tt-########----tttt-------------------------------------------------------------------------###--###------####--####-----tt--------------tt-#########------F
---M-------------------------tt--------tt--tt#########----tttt------------------------------------------------------------------------####--####----#####--#####----tt--------------tt##########------#
XXXXXXXXX---XXXXXXXXXXXXXXXXXXXXXXXXXXXXXXXXXXXXXXXXXXXXXXXXXXXXXXXXX---XXXXXXXXXXXXXXX---XXXXXXXXXXXXXXXXXXXXXXXXXXXXXXXXXXXXX-XXXXXXXXXXXXXXXXXXXXXXXXX--XXXXXXXXXXXXXXXXXXXXXXXXXXXXXXXXXXXXXXXXXXXX
XXXXXXXXX---XXXXXXXXXXXXXXXXXXXXXXXXXXXXXXXXXXXXXXXXXXXXXXXXXXXXXXXXX---XXXXXXXXXXXXXXX---XXXXXXXXXXXXXXXXXXXXXXXXXXXXXXXXXXXXX-XXXXXXXXXXXXXXXXXXXXXXXXX--XXXXXXXXXXXXXXXXXXXXXXXXXXXXXXXXXXXXXXXXXXXX
