-------####---####XXXXXX##---###------------###--------#####-------###-####---#####---###-#--#####-#####--##########-------#####--######---#############---#####------#####------#####---SSSSSSSS-SSS--
------#####--#####------##--####-----------####-------######------####-####--######--####-#-############-###########------######--######--##############--######-----######-----######-----------------
-----######-######------##-#####----------#####------#######-----#####-####-#######-#####-##########################-----#######--######-#######XXXXXXXX-#######----#######----#######-----------------
----##############------########---------######-----########-tt-######-##################-##########################-tt-########--##############XXXXXXXX########tt-########tt-########---------------S-
tt-###############------########---------######----#########-tt#######-##################-##########################-tt#########--##############--------########tt#########tt#########-@S--------------
tt################------########---------######----XXXXXXXXXXXXXXXXXXX-X###XXXXXXXXXXXXXX-XXXXXXXXXXXXXXXXXXXXXXXXXXXXXXXXXXXXXXXXXXXXX#XXXXXXXX--------XXXXXXXXXXXXXXXXXXXXXXXXXXXXXXX----------------
XXXXXXXXXXXXXXXXXXSSSSSSXX######---------######----XXXXXXXXXXXXXXXXXXX-XXXXXXXXXXXXXXXXXX-XXXXXXXXXXXXXXXXXXXXXXXXXXXXXXXXXXXXXXXXXXXXXXXXXXXXXX!!S-----XXXXXXXXXXXXXXXXXXXXXXXXXXXXXXX----------------
XXXXXXXXXXXXXXXXXX--------XXXXXXXXXXXXXXX----------###--------------------------------------------------------------------------------------------------------------------------------------#-###------
####----------------------XXXXXXXXXXXXXXX---------####-------------------------------------------------------------------------------------------------------------------------------------######------
####--------------------1------------------------#####-----------1---------------------------------1--1------------------1----------------------------------------------------------------#######------
####-------------!------------------------------######----tt------------------S@S--------------------------S----------SS----------SS------#--#--SS------#--##---------------S------------########------
####-----------------------------------tt------#######----tt-----------------------------------------------------------------------------##--##--------##--###------tt------------------#########------
####-------------------------tt--------tt-----########----tt--------------------------------------------------------------------t-------###--###------###--####-----tt--------------tt-##########-----F
###M----------------g--------tt--------tt---g-########-g--tt---------------------------------gg---------kt-------------------g--t------####--###-----####--#####----tt------g-------tt###########-----#
##XXXXXXXXXXXXXXXXXXXXXXXXXXXXXXXXXXXXXXXXXXXXXXXXXXXXXXXXXXXXXXXXXXXX--XXXXXXXXXXXXXX----XXXXXXXXXXXXXXttXXXXXXXXXXXXXXXXXXXXXXXXXXXXXXXXXXXXXXXXXXXXXXX--XXXXXXXXXXXXXXXXXXXXXXXXXXX#######XXXXXXXXXX
##XXXXXXXXXXXXXXXXXXXXXXXXXXXXXXXXXXXXXXXXXXXXXXXXXXXXXXXXXXXXXXXXXXXX--XXXXXXXXXXXXXX----XXXXXXXXXXXXXXttXXXXXXXXXXXXXXXXXXXXXXXXXXXXXXXXXXXXXXXXXXXXXXX--XXXXXXXXXXXXXXXXXXXXXXXXXXXXXXXXXXXXXXXXXXXX
