---####--------####--#------####--####-####-----SSSSSSS--##---------####----------########---####------#####-#########-------####----###-------------#####SSSS!-------####--####---####----SSSS---SSS!-
--#####-------#####--#-----#####-##########-------------###--------#####---------#########--#####-----################------#####----###------------######-----------#####--####--#####----------------
-######------######--#----#################------------####-------######--------##########-######----#################-----######----###-----------#######----------######--####-######----------------
#######-----#######--#---##################------------####------#######-------##################---##################----#######----###----------########---------#######--###########----------------
#######-tt-########--#t-###################--S@S-------####-----########---tt-###################t-###################tt-########----###---------#########----Stt-########--###########--------------C-
#######-tt#########--#t####################------------####-----########---tt####################t####################tt#########----###--------##########-----tt#########--###########----------------
XXXXXXXXXXXXXXXXXXXXXXXXXXXXXXXXXXXXXXXXXXXX-----------####-----XXXXXXXXXXXXXXXXXXXXXXXXXXXXXXXXXXXXXXXXXXX#XXXXX##XXXXXXXXXXXXXXXXXXXXX----tt-##########X-----XXXXXXXXXXXXXXXXXXXXXXXXXXXX------------
XXXXXXXXXXXXXXXXXXXXXXXXXXXXXXXXXXXXXXXXXXXX-----------####-----XXXXXXXXXXXXXXXXXXXXXXXXXXXXXXXXXXXXXXXXXXX#XXXXXXXXXXXXXXXXXXXXXXXXXXXX----tt###########X-----XXXXXXXXXXXXXXXXXXXXXXXXXXXX------------
####----------------------------------------------###--------------------------------------------------------------------------------------------------------------------------------------#######-----
####-------------1-------------------------------####-----------------------1----------------------------------1--------------------------------------------------------------------------########-----
####-----------------SU-------------------------#####-----tt#------------------!S--------------C-----------!---------SS!S---------!S-----##-#----------##--#------------------------t----#########-----
####-----------------------------------tt------######-----tt##--------------------------------------------------------------------------###-##--------###--##-------#---------------t---##########-----
####-------------------------tt--------tt-----#######-----tt###-----------------------------------------------------------------tt-----####-###------####--###------##--------------tt-###########----F
###M-------------------------tt--------tt--t-########-----tt###-----------------------------------------------------------------tt----#####-####----#####--####----####-------------tt############----#
XXXXXXXXXXXXXXXXXXXXXXXXXXXXXXXXXXXXXXXXXXXt#########----XXXX##XXXXXX---XXXXXXXXXXXXXX----XXXXXXXXXXXXXXXXXXXXXXXXXXXXXXXXXXXXXXXXXXX######XXXXXXXXXXXXXX--XXXXXXXXXXXXXXXXXXXXXXXXXXXXXXXXXXXXXXXXXXXX
XXXXXXXXXXXXXXXXXXXXXXXXXXXXXXXXXXXXXXXXXXXXXXXXXXXXXXXXXXXXXXXXXXXXX---XXXXXXXXXXXXXX----XXXXXXXXXXXXXXXXXXXXXXXXXXXXXXXXXXXXXXXXXXX######XXXXXXXXXXXXXX--XXXXXXXXXXXXXXXXXXXXXXXXXXXXXXXXXXXXXXXXXXXX
