XXXXXXXXXXXXt######------######-------#####----SS---SSSSSSSS---SSS!XXXXXXXXXXX------------------------#####---------######XXXXXXXXXXXXXX####------######--XXXXXXXXXXXX---tt###############SSSSSSS--SSS-
XXXXXXXXXXXXt######-----#######------######------------------------XXXXXXXXXXX------------------------#####--------#######--------------####-----#######--XXXXXXXXXXXXXXXXXXXXXXXXXX######-------------
------------X######-tt-########-----#######-----------------------------------------------------------#####-------########--------------####-tt-########--------------XXXXXXXXXXXXXX######-------------
------------X######-tt#########-tt-########-----------------------------------------------------------#####---tt-#########--------------####-tt#########-----------------------------------------------
-------------XXXXXXXXXXXXXXXXXXXtt#########-----------------------C-------------##-----SSSSSSSS---SSS!#####---tt##########--------------####XXXXXXXXXXXXX----------------------------------------------
-------------XXXXXXXXXXXXXXXXXXXXXXXXXXXXXXXXXX--------------------------------###--------------------XXXXXXXXXXXXXXXXXXX#--------------####XXXXXXXXXXXXX----------------------------------------------
--##--------SSSS--SSSSSSSSS----SXXXXXXXXXXXXXXX--------------------SSSS---SSS!####--------------------XXXXXXXXXXXXXXXXXXX#SSS----S!!S-----------!!S-------------------S!SSSSSSSS!S------------##-------
-###--------------------------------------------------------------------------####-----------------------------------------------------------------------------------------------------------###-------
####----------------------------------------------XX--------------------------####-------------------C--------------------------------------------------------------------------------------####---X---
####----------------------------------------------XX--------------------------####----------------------------------------------------------##---------------------------------------------#####---X---
####------------@S-----------------------------#####-------tt----------------C####-------------------------C----------SS----------SS-------###--SS------#--#-----------S--------S---------######-------
####-----------------------------------tt------#####t------tt-----------------####--------------------------------------------------------####---------##--##-------------------------#--#######-------
####-----------------------------------tt------#####t------tt----------------------------------------------------------------------------#####--------###--###-----tt----------------##-########------F
###M-----------------------------------tt---g--####gt--g---tt---------------------------------g----------------------------------------#######-------####--####----tt---------------############------#
XXXXXXXXXXXXXXXXXXXXXXXXXXXXXXXXXXXXXXXXXXXXXXX#####XXXXXXXXXXXXXXXXX---XXXXXXXXXXXXXX----XXXXXXXXXXXXXXXXXXXXXXXXXXXXXXXXXXXXXXXXXXXXXX######--XXXXXXXXX--XXXXXXXXXXXXXXXXXXXXXXXXXXXXXXXXXXXXXXXXXXXX
XXXXXXXXXXXXXXXXXXXXXXXXXXXXXXXXXXXXXXXXXXXXXXXXXXXXXXXXXXXXXXXXXXXXX---XXXXXXXXXXXXXX----XXXXXXXXXXXXXXXXXXXXXXXXXXXXXXXXXXXXXXXXXXXXXX######--XXXXXXXXX--XXXXXXXXXXXXXXXXXXXXXXXXXXXXXXXXXXXXXXXXXXXX
