XXXXXXXXXXXXXXXXXXXXXX------####-------##------SSS-----------------###----####----####-----####-------####-----------####----####-----##-----------####------------######-####-------####SSSSS----SSSS-
---------------------------#####------###------------------SSSSSSSS###---#####---#####----#####------#####----------#####---#####----###----------#####-----------############------#####--------------
--------------------------######-----####---------SSSSSSSS---------###--######--######---######-----######---------######--######---####---------######----------#############-----######--------------
-------------------------#######----#####--------------------------###-#######-#######---######----#######--------#######-#######--#####--------#######---------##############----#######--------------
----------------------t-########---######--------------------------###-###############---######tt-########----tt-########-#######-######-------########--------###############tt-########--------------
----------------------t#########--#######--------------------------###-################--######tt#########----tt#########-##############-------########-------################tt#########--------------
--##--------SSS----S!!XXXXXXXXXX-########--------------------------XXX-XXXXXXXXXXXXXXXX--XXXXXXXXXXXXXXXXXXXXXXXXXXXXXXXXXXXXXXXX#######-------XXXXXXXX---tt-########XXXXXXXXXXXXXXXXXXXX-----XX-------
-###------------------XXXXXXXXXX#########--------------------------XXX-XXXXXXXXXXXXXXXX--XXXXXXXXXXXXXXXXXXXXXXXXXXXXXXXXXXXXXXXX#######-------XXXXXXXX---tt#########XXXXXXXXXXXXXXXXXXXX-----XX-------
####----------------------------------------------###----------------------------------------------------------------------------------------##----------------------------------------------####------
####---------------------------------------------####-------------------------g-------------------------------------------------------------###---------------------------------------------#####------
####----------------SSC----------!--------------#####-------##-!S------------S@S---------------------------!-----S-----S-------------------####--------##--#-----------------------------#-######------
####-----------------------------------tt------######------###----------------------------------------------------------------------------#####-------###--##-------#-------------------#########------
####-----------------------------------tt-----#######-----####------------------------------------------------------------------tt----tt-######-------###--###-----t##---------------tt##########-----F
###M---------------g-------------------tt---g########-gg-######------------------------------ggg--------k-------------------gg-gtt----tt########----tt###--####----t###-----g--------tt##########-----#
XXXXXXXXXXXXXXXXXXXXXXXXXXXXXXXXXXXXXXXXXXXX#########---XXXXXX#XXXXXX---XXXXXXXXXXXXXX----XXXXXXXXXXXXXXXXXXXXXXXXXXXXXXXXXXXXXXXXXXXXXXXXXXXXXXXXXXttXXX--XXXXXXXXXXXXXXXXXXXXXXXXXXtt###XXXXXXXXXXXXX
XXXXXXXXXXXXXXXXXXXXXXXXXXXXXXXXXXXXXXXXXXXXXXXXXXXXXXXXXXXXXX#XXXXXX---XXXXXXXXXXXXXX----XXXXXXXXXXXXXXXXXXXXXXXXXXXXXXXXXXXXXXXXXXXXXXXXXXXXXXXXXXttXXX--XXXXXXXXXXXXXXXXXXXXXXXXXXXXXXXXXXXXXXXXXXXX
