-------------------------------------------------------------------------------------------------------------------------------------------------------------------------------------------------------
-------------------------------------------------------------------------------------------------------------------------------------------------------------------------------------------------------
-------------------------------------------------------------------------------------------------------------------------------------------------------------------------------------------------------
-------------------------------------------------------------------------------------------------------------------------------------------------------------------------------------------------------
-------------------------------------------------------------------------------------------------------------------------------------------------------------------------------------------------------
-------------------------------------------------------------------------------------------------------------------------------------------------------------------------------------------------------
-##SSS----S!!SSS----S!!SSSSSSS-----------------------------------SSSSSS---SSS----SSSSSS-----SSS----S!!S-SSS!------SSSSSSSSSSS----S!-----------------------------SSS----SSS----S!!S-----------##-----@--
###-----------------------------------------------------------------------------------------------------------------------------------------------------------------------------------------###--------
###------------------------------------------------------------------------------------------------------------------------------------------#---------------------------------------------####--------
###-----------------------------------------------------------------------------------------------------------------------------------------##--------------------------------------------#####--------
###--------SS--------SS-------------------------tt---------tt-----------------S@S-------------------SS-----C-----S----------------S--------###---------##--#-------------------SS--------######-----!--
###------------------------------------tt-------tt---------ttt----------------------------------------------------------------------------####--------###--##-------------------------#-#######--------
###---------------------------t--------tt-------tt---------ttt------------------------------------------------------------------------tt-######------####--###------#----------------##########-------F
###M----------------g---------t--------tt-g-----tt-----g---ttt-------------------------------gg------------------------------g--------tt########----#####--####----##-------g-------###########-------#
XXXXXXXXXXXXXXXXXXXXXXXXXXXXXXXXXXXXXXXXXXXXXXXXXXXXXXXXXXXXXXXXXXXXX---XXXXXXXXXXXXXXX---XXXXXXXXXXXXXXXXXXXXXXXXXXXXXXXXXXXXXXXXXXXXXXXXXXXXXXXXXXXXXXX--XXXXXXXXXXXXXXXXXXXXXXXXXXXXXXXXXXXXXXXXXXXX
XXXXXXXXXXXXXXXXXXXXXXXXXXXXXXXXXXXXXXXXXXXXXXXXXXXXXXXXXXXXXXXXXXXXX---XXXXXXXXXXXXXXX---XXXXXXXXXXXXXXXXXXXXXXXXXXXXXXXXXXXXXXXXXXXXXXXXXXXXXXXXXXXXXXX--XXXXXXXXXXXXXXXXXXXXXXXXXXXXXXXXXXXXXXXXXXXX
