-------------------------------------------------------------------------------------------------------------------------------------------------------------------------------------------------------
-------------------------------------------------------------------------------------------------------------------------------------------------------------------------------------------------------
-------------------------------------------------------------------------------------------------------------------------------------------------------------------------------------------------------
-------------------------------------------------------------------------------------------------------------------------------------------------------------------------------------------------------
-------------------------------------------------------------------------------------------------------------------------------------------------------------------------------------------------------
-------------------------------------------------------------------------------------------------------------------------------------------------------------------------------------------------------
--##------SSSSSSSSSSSSSS---SSS!----------------------------------SSSSS----SSSSS--SSSSSS-----SSS!SSSSSSSSSSSSSSSSSSSSSS---SSS----S!!!S-------------------------------SSS----S!!S--------------##--------
-###----------------------------------------------------------------------------------------------------------------------------------------------------------------------------------------###--------
####---------------------------------------------------------------------------------------------------------------------------------------------------------------------------------------####--------
####--------------------------------------------------------------------------------------------------------------------------------------------------------------------------------------#####--------
####--------------------------C----------------tt----------tt--SS--------------@S--------------C----------------------S----------SSS--------#----------##--#----------------SS-----------#######-------
####-----------------------------------tt------tt----------tt#---------------------------------------------------------------------------#--##--------###--##---------------------------#########------
####-----------------------------------tt------tt----------tt#--------------------------------------------------------------------------##--###------####--###-----t----------------tt-###########----F
###M---------------g-------------------tt------tt-----gg---tt#-----------------------------gggg---------kk----------------g--g-g-------###--####----#####--####----t--------g-------tt#############---#
XXXXXXXXXXXXXXXXXXXXXX---XXXXXXXXXXXXXXXXXXXXXXXXXXXXXXXXXXXXXXXXXXXX---XXXXXXXXXXXXXXX---XXXXXXXXXXXXXXXXXXXXXXXXXXXXXXXXXXXXXXXXXXXXXXXXXXXXXXXXXXXXXXX--XXXXXXXXXXXXXXXXXXXXXXXXXXXXXXXXXXXXXXXXXXXX
XXXXXXXXXXXXXXXXXXXXXX---XXXXXXXXXXXXXXXXXXXXXXXXXXXXXXXXXXXXXXXXXXXX---XXXXXXXXXXXXXXX---XXXXXXXXXXXXXXXXXXXXXXXXXXXXXXXXXXXXXXXXXXXXXXXXXXXXXXXXXXXXXXX--XXXXXXXXXXXXXXXXXXXXXXXXXXXXXXXXXXXXXXXXXXXX
