-------------------------------------------------------------------------------------------------------------------------------------------------------------------------------------------------------
-------------------------------------------------------------------------------------------------------------------------------------------------------------------------------------------------------
-------------------------------------------------------------------------------------------------------------------------------------------------------------------------------------------------------
-------------------------------------------------------------------------------------------------------------------------------------------------------------------------------------------------------
-------------------------------------------------------------------------------------------------------------------------------------------------------------------------------------------------------
-------------------------------------------------------------------------------------------------------------------------------------------------------------------------------------------------------
--##-----------SSS----S!!S----SS----SSS------------------------SSSSSSSS---SSS!-SSSSSSSSSS----SSS----S!!S-S!!S---S----S!!S-SSS----S---------------------------------------------SSSSSS--------##--------
-###----------------------------------------------------------------------------------------------------------------------------------------------------------------------------------------###--------
####---------------------------------------------------------------------------------------------------------------------------------------------------------------------------------------####--------
####----------------------------------------------------------------------------------------------------------------------------------------#---------------------------------------------#####--------
####--------S----------SS--------S--------------tt--------tt#@S--------------CS----------------------SS---SS----------SS-------------------##----------##--##------------SS!S------------######--------
####--------------------------------------------tt--------tt#-----------------------------------------------------------------------------####--------###--###--------------------------#######--------
####-------------------------#------------------tt--------tt#-------------------------------------------------------------------------tt-######------####--####-----tt---------------t-########-------F
###M------------------------##------------------tt--------tt#--------------------------------------------------#----------------------tt########----#####--#####----tt---------------t#########-------#
XXXXXXXXXXXXXXXXXXXXXXXXXXXXXXXXXXXXXXXXXXXXXXXXXXXXXXXXXXXXXXXXXXXXX---XXXXXXXXXXXXX-----XXXXXXXXXXXXXXXXXXXXXXXXXXXXXXXXXXXXXXXXXXXXXXXXXXXXXXXXXXXXXXX--XXXXXXXXXXXXXXXXXXXXXXXXXXXXXXXXXXXXXXXXXXXX
XXXXXXXXXXXXXXXXXXXXXXXXXXXXXXXXXXXXXXXXXXXXXXXXXXXXXXXXXXXXXXXXXXXXX---XXXXXXXXXXXXX-----XXXXXXXXXXXXXXXXXXXXXXXXXXXXXXXXXXXXXXXXXXXXXXXXXXXXXXXXXXXXXXX--XXXXXXXXXXXXXXXXXXXXXXXXXXXXXXXXXXXXXXXXXXXX
