-------------------------------------------------------------------------------------------------------------------------------------------------------------------------------------------------------
-------------------------------------------------------------------------------------------------------------------------------------------------------------------------------------------------------
-------------------------------------------------------------------------------------------------------------------------------------------------------------------------------------------------------
-------------------------------------------------------------------------------------------------------------------------------------------------------------------------------------------------------
-------------------------------------------------------------------------------------------------------------------------------------------------------------------------------------------------------
-------------------------------------------------------------------------------------------------------------------------------------------------------------------------------------------------------
#-##----SSSSSSSS---SSS!SSS--------------------------------------SSSSSSS-SSS----S!!SSSSSSS---------SSS----S!!S-SSSSSS-----SSS----S!!SSSSS----------------------------------SSS----S!!S--------##--------
####----------------------------------------------------------------------------------------------------------------------------------------------------------------------------------------###--------
####---------------------------------------------------------------------------------------------------------------------------------------------------------------------------------------####--------
####--------------------------------------------------------------------------------------------------------------------------------------------------------------------------------------#####--------
####------------------C------------------------tt---------tt--------------------SS-------------S----------SS----------S----------SS-------#--#---------##--#------------S---------SS-----######--------
####-----------------------------------tt------tt---------tt-----------------------------------------------------------------------------##--##--------##--##---------------------------#######--------
####-------------------------tt--------tt------tt---------tt----------------------------------------------------------------------------###--###------###--###-----tt----------------t-########-------F
###M-------------------------tt--------tt------ttg-----g--tt----------------------------------gg----------------------------------------###--####----####--####----tt----------------t#########-------#
XXXXXXXXXXXXXX---XXXXXXXXXXXXXXXXXXXXXXXXXXXXXXXXXXXXXXXXXXXXXXXXXXXX--XXXXXXXXXXXXXXXX---XXXXXXXXXXXXXXXXXXXXXXXXXXXXXXXXXXXXXXXXXXXXXXXXXXXXXXXXXXXXXXX--XXXXXXXXXXXXXXXXXXXXXXXXXXXXXXXXXXXXXXXXXXXX
XXXXXXXXXXXXXX---XXXXXXXXXXXXXXXXXXXXXXXXXXXXXXXXXXXXXXXXXXXXXXXXXXXX--XXXXXXXXXXXXXXXX---XXXXXXXXXXXXXXXXXXXXXXXXXXXXXXXXXXXXXXXXXXXXXXXXXXXXXXXXXXXXXXX--XXXXXXXXXXXXXXXXXXXXXXXXXXXXXXXXXXXXXXXXXXXX
