-------------------------------------------------------------------------------------------------------------------------------------------------------------------------------------------------------
-------------------------------------------------------------------------------------------------------------------------------------------------------------------------------------------------------
-------------------------------------------------------------------------------------------------------------------------------------------------------------------------------------------------------
-------------------------------------------------------------------------------------------------------------------------------------------------------------------------------------------------------
-------------------------------------------------------------------------------------------------------------------------------------------------------------------------------------------------------
-------------------------------------------------------------------------------------------------------------------------------------------------------------------------------------------------------
----SSSSSSSS---SSS!----!-----------------------------------------SSSSSS---SSS!-----SSSSSS---SSS!--------------SSS----S!-SSSSSSSSS!!S---------------------------------------------------------##--------
--------------------------------------------------------------------------------------------------------------------------------------------------------------------------------------------###--------
-------------------------------------------------------------------------------------------------------------------------------------------------------------------------------------------####--------
------------------------------------------------------------------------------------------------------------------------------------------------------------------------------------------#####--------
-S@S--------------C----S!S---------------------tt---------#------------------C-----------------C-----SU----S----------SS---------SS------#--#----------##--##------------SS!S------------#######-------
---------------------------------------tt------tt---------##----------------------------------------------------------------------------##--##--------###--###--------------------------#########------
-----------------------------tt--------tt------tt---------###--------------------------------------------------------------------------###--###------####--####-----tt--------------tt-###########----F
---M-------------------------tt--------tt------tt---------####------------------------------------------------------------------------####--####----#####--#####----tt--------------tt#############---#
XXXXXXXXXX---XXXXXXXXXXXXXXXXXXXXXXXXXXXXXXXXXXXXXXXXXXXXXXXXXXXXXXXX---XXXXXXXXXXXXXXX---XXXXXXXXXXXXXXXXXXXXXXXXXXXXXXXXXXXX--XXXXXXXXXXXXXXXXXXXXXXXXX--XXXXXXXXXXXXXXXXXXXXXXXXXXXXXXXXXXXXXXXXXXXX
XXXXXXXXXX---XXXXXXXXXXXXXXXXXXXXXXXXXXXXXXXXXXXXXXXXXXXXXXXXXXXXXXXX---XXXXXXXXXXXXXXX---XXXXXXXXXXXXXXXXXXXXXXXXXXXXXXXXXXXX--XXXXXXXXXXXXXXXXXXXXXXXXX--XXXXXXXXXXXXXXXXXXXXXXXXXXXXXXXXXXXXXXXXXXXX
