-------------------------------------------------------------------------------------------------------------------------------------------------------------------------------------------------------
-------------------------------------------------------------------------------------------------------------------------------------------------------------------------------------------------------
-------------------------------------------------------------------------------------------------------------------------------------------------------------------------------------------------------
-------------------------------------------------------------------------------------------------------------------------------------------------------------------------------------------------------
-------------------------------------------------------------------------------------------------------------------------------------------------------------------------------------------------------
-------------------------------------------------------------------------------------------------------------------------------------------------------------------------------------------------------
-##-------------SSS----S!!S---SS----S!!S-----------------------------------------SSSSSSSS---SSS!--------------------SSS----S!!S--S!!S-------------------------------------SSSSSS-------------##--------
###-----------------------------------------------------------------------------------------------------------------------------------------------------------------------------------------###--------
###----------------------------------------------------------------------------------------------------------------------------------------------------------------------------------------####--------
###---------------------------------------------------------------------------------------------------------------------------------------------------------------------------------------#####--------
###---------------------SS-----------SS--------tt----------tt-----------------S@S--------------C-----SU----!-----S----------SS----SS------#--#---------##--#-----------S@S---------------######--------
###-------------------------------------t------tt----------tt----------------------------------------------------------------------------##--#--------###--##---------------------------#######-#------
###-------------------------------------t------tt----------tt---------------------------------------------------------------------------###--##------####--###------#---------------tt-########-##----F
###M-------------------------#----------t------ttg-----g---tt---------------------------------gg---------------------------------------####--###----#####--####----##---------------tt#########-###---#
XXXXXXXXXXXXXXXXXXXXXXXXXXXXXXXXXXXXXXXXXXXXXXXXXXXXXXXXXXXXXXXXXXXXXX--XXXXXXXXXXXXXXX---XXXXXXXXXXXXXXXXXXXXXXXXXXXXXXXXXXXXXXXXXXXXXXXXXXXXXXXXXXXXXXX--XXXXXXXXXXXXXXXXXXXXXXXXXXXXXXXXXXXXXXXXXXXX
XXXXXXXXXXXXXXXXXXXXXXXXXXXXXXXXXXXXXXXXXXXXXXXXXXXXXXXXXXXXXXXXXXXXXX--XXXXXXXXXXXXXXX---XXXXXXXXXXXXXXXXXXXXXXXXXXXXXXXXXXXXXXXXXXXXXXXXXXXXXXXXXXXXXXX--XXXXXXXXXXXXXXXXXXXXXXXXXXXXXXXXXXXXXXXXXXXX
