-------------------------------------------------------------------------------------------------------------------------------------------------------------------------------------------------------
-------------------------------------------------------------------------------------------------------------------------------------------------------------------------------------------------------
-------------------------------------------------------------------------------------------------------------------------------------------------------------------------------------------------------
-------------------------------------------------------------------------------------------------------------------------------------------------------------------------------------------------------
-------------------------------------------------------------------------------------------------------------------------------------------------------------------------------------------------------
-------------------------------------------------------------------------------------------------------------------------------------------------------------------------------------------------------
#---SSSSSSSS---SSS!-----SSS!---------------------------------------------SS----S!SSSSSS-----------SSS----S!!SS@-----------SSS----S!!SSSS-------------------------------SSS----S!!S-----------##--------
#-------------------------------------------------------------------------------------------------------------------------------------------------------------------------------------------###--------
#------------------------------------------------------------------------------------------------------------------------------------------------------------------------------------------####--------
#---------------------------------------------------1------------1------------------------------------------------------------------------------------------------------------------------#####--------
#S@S--------------C--------C-----SU------------tt---------tt--------------------S--------!-----S----------SS--!--!-----S----------SS-----#--#----------##--#-------------------SS--------######--------
#--------------------------------------tt------tt---------tt----------------------------------------------------------------------------##--##--------###--##-------------------------#-#######--------
#--------------------------------------tt------tt---------tt----------------------------------------------------------------------------##--###------####--###-----tt----------------##########--#----F
#--M----------------g------------------tt-g----tt------g--tt---------------------------------gg------------------------------g----------##--####----#####--####----tt-------g-------###########--##---#
XXXXXXXXXX---XXXXXXXXXXXXXXXXXXXXXXXXXXXXXXXXXXXXXXXXXXXXXXXXXXXXXXXXX--XXXXXXXXXXXXXX---XXXXXXXXXXXXXXXXXXXXXXXXXXXXXXXXXXXXXXXXXXXXXXXXXXXXXXXXXXXXXXXX--XXXXXXXXXXXXXXXXXXXXXXXXXXXXXXXXXXXXXXXXXXXX
XXXXXXXXXX---XXXXXXXXXXXXXXXXXXXXXXXXXXXXXXXXXXXXXXXXXXXXXXXXXXXXXXXXX--XXXXXXXXXXXXXX---XXXXXXXXXXXXXXXXXXXXXXXXXXXXXXXXXXXXXXXXXXXXXXXXXXXXXXXXXXXXXXXX--XXXXXXXXXXXXXXXXXXXXXXXXXXXXXXXXXXXXXXXXXXXX
