-------------------------------------------------------------------------------------------------------------------------------------------------------------------------------------------------------
-------------------------------------------------------------------------------------------------------------------------------------------------------------------------------------------------------
-------------------------------------------------------------------------------------------------------------------------------------------------------------------------------------------------------
-------------------------------------------------------------------------------------------------------------------------------------------------------------------------------------------------------
-------------------------------------------------------------------------------------------------------------------------------------------------------------------------------------------------------
-------------------------------------------------------------------------------------------------------------------------------------------------------------------------------------------------------
-##--SSSSSSSSSSSSSS---SSS!----------SS--------------------------SSSSSS----SSS!---SSSSSS--S-SSS----S!!S---SSS----S!!SSSS----S!!S--S!!S--------------------------------SSS----S!!S-------------##--------
###-----------------------------------------------------------------------------------------------------------------------------------------------------------------------------------------###--------
###----------------------------------------------------------------------------------------------------------------------------------------------------------------------------------------####--------
###---------------------------------------------------------------------------------------------------------------------------------------------------------------------------------------#####--------
###----------------------C-----S-S-------------tt---------#------------------C---------------------SS------------SS---------SS----SS--------#----------##--#------S----------SS----------######--------
###------------------------------------tt------tt---------##-----------------------------------------------------------------------------#--##--------###--##---------------------------#######--------
###------------------------------------tt------tt---------###---------------------------------------------------------------------------##--###------####--###----------------------tt-########-------F
###M---------------g-------------------tt------tt-----gg--####-----------------------------gggg---------kk----------------g--g-g-------###--####----#####--####-------------g-------tt#########-------#
XXXXXXXXXXXXXXXXX---XXXXXXXXXXXXXXXXXXXXXXXXXXXXXXXXXXXXXXXXXXXXXXXXX---XXXXXXXXXXXXXX----XXXXXXXXXXXXXXXXXXXXXXXXXXXXXXXXXXXXXXXXXXXXXXXXXXXXXXXXXXXXXXX--XXXXXXXXXXXXXXXXXXXXXXXXXXXXXXXXXXXXXXXXXXXX
XXXXXXXXXXXXXXXXX---XXXXXXXXXXXXXXXXXXXXXXXXXXXXXXXXXXXXXXXXXXXXXXXXX---XXXXXXXXXXXXXX----XXXXXXXXXXXXXXXXXXXXXXXXXXXXXXXXXXXXXXXXXXXXXXXXXXXXXXXXXXXXXXX--XXXXXXXXXXXXXXXXXXXXXXXXXXXXXXXXXXXXXXXXXXXX
