-------------------------------------------------------------------------------------------------------------------------------------------------------------------------------------------------------
-------------------------------------------------------------------------------------------------------------------------------------------------------------------------------------------------------
-------------------------------------------------------------------------------------------------------------------------------------------------------------------------------------------------------
-------------------------------------------------------------------------------------------------------------------------------------------------------------------------------------------------------
-------------------------------------------------------------------------------------------------------------------------------------------------------------------------------------------------------
-------------------------------------------------------------------------------------------------------------------------------------------------------------------------------------------------------
@-----------SSS----S!!S---SS-----------------------------------------------------SSSSSS-----SSSSSSSSS---SSS!--SSS----S!!S--SSSSS-S!!S-------------------------------------SSS----S!!---------##--------
--------------------------------------------------------------------------------------------------------------------------------------------------------------------------------------------###--------
-------------------------------------------------------------------------------------------------------------------------------------------------------------------------------------------####--------
------------------------------------------------------------------------------------------------------------------------------------------------------------------------------------------#####--------
!--!-----S----------SS--------------------------tt---------tt---!-------------S@S--------------------------C----------SS----------SS-----#--#----------##--#-----------S----------SS-----######--------
---------------------------------------t--------tt---------tt---------------------------------------------------------------------------##--##--------###--##---------------------------#######--------
-----------------------------tt--------t--------tt---------tt--------------------------------------------------------------------------###--###------####--###----------------------tt-########-------F
---M----------------g----#---tt--------t--g-----tt-----g---tt--------------------------------gg------------------------------g--------####--####----#####--####-------------g-------tt#########-------#
XXXXXXXXXXXXXXXXXXXXXXXXXXXXXXXXXXXXXXXXXXXXXXXXXXXXXXXXXXXXXXXXXXXXXX--XXXXXXXXXXXXXXX---XXXXXXXXX---XXXXXXXXXXXXXXXXXXXXXXXXXXXXXXXXXXXXXXXXXXXXXXXXXXX--XXXXXXXXXXXXXXXXXXXXXXXXXXXXXXXXXXXXXXXXXXXX
XXXXXXXXXXXXXXXXXXXXXXXXXXXXXXXXXXXXXXXXXXXXXXXXXXXXXXXXXXXXXXXXXXXXXX--XXXXXXXXXXXXXXX---XXXXXXXXX---XXXXXXXXXXXXXXXXXXXXXXXXXXXXXXXXXXXXXXXXXXXXXXXXXXX--XXXXXXXXXXXXXXXXXXXXXXXXXXXXXXXXXXXXXXXXXXXX
