-------------------------------------------------------------------------------------------------------------------------------------------------------------------------------------------------------
-------------------------------------------------------------------------------------------------------------------------------------------------------------------------------------------------------
-------------------------------------------------------------------------------------------------------------------------------------------------------------------------------------------------------
-------------------------------------------------------------------------------------------------------------------------------------------------------------------------------------------------------
-------------------------------------------------------------------------------------------------------------------------------------------------------------------------------------------------------
-------------------------------------------------------------------------------------------------------------------------------------------------------------------------------------------------------
--##SS-@-----------SSS----S!!S------SSS---------------------------------SSS----S!!S-SSSS---SSS----SSS----S!!S-----------SSSSSSSS-S!!S--------------------------------------------------------##--------
-###----------------------------------------------------------------------------------------------------------------------------------------------------------------------------------------###--------
####---------------------------------------------------------------------------------------------------------------------------------------------------------------------------------------####--------
####-------------------------------------------------------------1------------------------------------------------------------------------------------------------------------------------#####--------
####---!--!-----S----------SS----S-------------tt---------tt--------------------SS-------------S----------SS---------S@S----------SS-----#--#----------##--#------------SS!!S------------######--------
####------------------------------------t------tt---------tt----------------------------------------------------------------------------##--##--------###--##---------------------------#######-#------
####------------------------------------t------tt---------tt----------------------------------------------------------------------------##--###------####--###-----tt---------------tt-########-##----F
###M------------------------------------t------tt---------tt---------------------------------------------------#-----------------------###--####----#####--####----tt---------------tt#########-###---#
XXXXXXXXXXXXXXXXXXXXXXXXXXXXXXXXXXXXXXXXXXXXXXXXXXXXXXXXXXXXXXXXXXXXXX-XXXXXXXXXXXXXXX---XXXXXXXXXXXXXXXXXXXXXXXXXXXXXXXXXXXXXXXXXXXXXXXXXXXXXXXXXXXXXXXX--XXXXXXXXXXXXXXXXXXXXXXXXXXXXXXXXXXXXXXXXXXXX
XXXXXXXXXXXXXXXXXXXXXXXXXXXXXXXXXXXXXXXXXXXXXXXXXXXXXXXXXXXXXXXXXXXXXX-XXXXXXXXXXXXXXX---XXXXXXXXXXXXXXXXXXXXXXXXXXXXXXXXXXXXXXXXXXXXXXXXXXXXXXXXXXXXXXXX--XXXXXXXXXXXXXXXXXXXXXXXXXXXXXXXXXXXXXXXXXXXX
