-------------------------------------------------------------------------------------------------------------------------------------------------------------------------------------------------------
-------------------------------------------------------------------------------------------------------------------------------------------------------------------------------------------------------
-------------------------------------------------------------------------------------------------------------------------------------------------------------------------------------------------------
-------------------------------------------------------------------------------------------------------------------------------------------------------------------------------------------------------
-------------------------------------------------------------------------------------------------------------------------------------------------------------------------------------------------------
-------------------------------------------------------------------------------------------------------------------------------------------------------------------------------------------------------
--##-------------@-----------SSS----S!!S--------------------------SSSS-----------SSSSSS---SSS----S!!S---------SSS----S!!SSSS----S!!S--------------S------------------------------------------##--------
-###----------------------------------------------------------------------------------------------------------------------------------------------------------------------------------------###--------
####---------------------------------------------------------------------------------------------------------------------------------------------------------------------------------------####--------
####--------------------------------------------------------------------------------------------------------------------------------------------------------------------------------------#####--------
####-------------!--!-----S----------SS--------tt---------tt---S@S------------S@S-----------------SS-------S----------SS---------SS------#--#-----------#--#-------------SS!S------------######--------
####-------------------------------------------tt---------tt----------------------------------------------------------------------------##--##---------##--##---------------------------#######--------
####-------------------------------------------tt---------tt---------------------------------------------------------------------------###--###-------###--###-----tt---------------tt-########--#----F
###M---------------g---------------------------tt-----gg--tt-------------------------------gggg---------kk----------------g--g-g------####--####-----####--####----tt#------g-------tt#########--##---#
XXXXXXXXXXXXXXXXXXXXXXXXXXXXXXXXXXXXXXXXXXXXXXXXXXXXXXXXXXXXXXXXXXXXXX--XXXXXXXXXXXXXXX--XXXXXXXXXXXXXXXXXXXXXXXXXXXXXXXXXXXXXXXXXXXXXXXXXXXXXXXXXXXXXXXX--XXXXXXXXXXXXXXXXXXXXXXXXXXXXXXXXXXXXXXXXXXXX
XXXXXXXXXXXXXXXXXXXXXXXXXXXXXXXXXXXXXXXXXXXXXXXXXXXXXXXXXXXXXXXXXXXXXX--XXXXXXXXXXXXXXX--XXXXXXXXXXXXXXXXXXXXXXXXXXXXXXXXXXXXXXXXXXXXXXXXXXXXXXXXXXXXXXXX--XXXXXXXXXXXXXXXXXXXXXXXXXXXXXXXXXXXXXXXXXXXX
