-------------------------------------------------------------------------------------------------------------------------------------------------------------------------------------------------------
-------------------------------------------------------------------------------------------------------------------------------------------------------------------------------------------------------
-------------------------------------------------------------------------------------------------------------------------------------------------------------------------------------------------------
-------------------------------------------------------------------------------------------------------------------------------------------------------------------------------------------------------
-------------------------------------------------------------------------------------------------------------------------------------------------------------------------------------------------------
-------------------------------------------------------------------------------------------------------------------------------------------------------------------------------------------------------
-##-------------SSS----S!!S---------S-------------------------------------------SSSSSSSSS---SSSSSS----S!-SSS----S!--------SSS----S!!S---------------------------SS----------------------------##-------
###-----------------------------------------------------------------------------------------------------------------------------------------------------------------------------------------####-------
###----------------------------------------------------------------------------------------------------------------------------------------------------------------------------------------#####-------
###-------------------------------------------------------------1-------------------------------------------------------------------------------------------------------------------------######-------
###----------S----------SS-------S-------------ttt---------tt----------------S@S-----------------------S---------S-----S----------SS------#------------##--#-------------SS!S------------#######-------
###------------------------------------tt------ttt---------tt----------------------------------------------------------------------------##--#--------###--##---------------------------########-------
###---------------------------#--------tt------ttt---------tt---------------------------------------------------------------------------###--##------####--###------tt--------------tt-#########------F
###M-------------------------##--------tt------ttg-----g---tt---------------------------------gg---------------------------------------####--###----#####--####-----tt--------------tt##########------#
XXXXXXXXXXXXXXXXXXXXXXXXXXXXXXXXXXXXXXXXXXXXXXXXXXXXXXXXXXXXXXXXXXXXX--XXXXXXXXXXXXXXX----XXXXXXXXXXXXXXXXXXXXXXXXXXXXXXXXXXXXXXXXXXXXXXXXXXXXXXXXXXXXXXX--XXXXXXXXXXXXXXXXXXXXXXXXXXXXXXXXXXXXXXXXXXXX
XXXXXXXXXXXXXXXXXXXXXXXXXXXXXXXXXXXXXXXXXXXXXXXXXXXXXXXXXXXXXXXXXXXXX--XXXXXXXXXXXXXXX----XXXXXXXXXXXXXXXXXXXXXXXXXXXXXXXXXXXXXXXXXXXXXXXXXXXXXXXXXXXXXXX--XXXXXXXXXXXXXXXXXXXXXXXXXXXXXXXXXXXXXXXXXXXX
