-------------------------------------------------------------------------------------------------------------------------------------------------------------------------------------------------------
-------------------------------------------------------------------------------------------------------------------------------------------------------------------------------------------------------
-------------------------------------------------------------------------------------------------------------------------------------------------------------------------------------------------------
-------------------------------------------------------------------------------------------------------------------------------------------------------------------------------------------------------
-------------------------------------------------------------------------------------------------------------------------------------------------------------------------------------------------------
-------------------------------------------------------------------------------------------------------------------------------------------------------------------------------------------------------
--##----SSS----S!!S--SSS----S-------SSS------------------------------------------SSSSSSSS----SSSSSSSS---SSS!--------------SSS----S!!S---------------------------SSSSSS-----------------------##-----!--
-###----------------------------------------------------------------------------------------------------------------------------------------------------------------------------------------###--------
####---------------------------------------------------------------------------------------------------------------------------------------------------------------------------------------####--------
####-------------------------------------------------------------1------------------------------------------------------------------------------------------------------------------------#####--------
####------------SS---------------S-------------tt---------tt------------------S@S----------@S--------------C-----SU----S----------SS------#--#---------##--#--@S---------SS!S------------######-----C--
####-----------------------------------tt------tt---------tt-----------------------------------------------------------------------------##--##-------###--##---------------------------#######--------
####-------------------------t---------tt------tt---------tt----------------------------------------------------------------------------###--##------####--###----------------------tt-########-------F
###M-------------------------t#--------tt------tt---------tt---------------------------------------------------------------------------####--###----#####--###----------------------tt#########-------#
XXXXXXXXXXXXXXXXXXXXXXXXXXXXXXXXXXXXXXXXXXXXXXXXXXXXXXXXXXXXXXXXXXXXXX--XXXXXXXXXXXXXXX---XXXXXXXXX---XXXXXXXXXXXXXXXXXXXXXXXXXXXXXXXXXXXXXXXXXXXXXXXXXXX--XXXXXXXXXXXXXXXXXXXXXXXXXXXXXXXXXXXXXXXXXXXX
XXXXXXXXXXXXXXXXXXXXXXXXXXXXXXXXXXXXXXXXXXXXXXXXXXXXXXXXXXXXXXXXXXXXXX--XXXXXXXXXXXXXXX---XXXXXXXXX---XXXXXXXXXXXXXXXXXXXXXXXXXXXXXXXXXXXXXXXXXXXXXXXXXXX--XXXXXXXXXXXXXXXXXXXXXXXXXXXXXXXXXXXXXXXXXXXX
