-------------------------------------------------------------------------------------------------------------------------------------------------------------------------------------------------------
-------------------------------------------------------------------------------------------------------------------------------------------------------------------------------------------------------
-------------------------------------------------------------------------------------------------------------------------------------------------------------------------------------------------------
-------------------------------------------------------------------------------------------------------------------------------------------------------------------------------------------------------
-------------------------------------------------------------------------------------------------------------------------------------------------------------------------------------------------------
-------------------------------------------------------------------------------------------------------------------------------------------------------------------------------------------------------
----SSSSSSSS---SSS!----------SSS----S!-------------------------------------------SSSSSS-----SSS!----SS----S!!S-----------SSSSSS-S!!S----------------------------------------------------------##-------
---------------------------------------------------------------------------------------------------------------------------------------------------------------------------------------------###-------
--------------------------------------------------------------------------------------------------------------------------------------------------------------------------------------------####-------
-----------------------------------------------------------------1-------------------------------------------------------------------------------------------------------------------------#####-------
-S@S--------------C-------S----------S---------tt---------tt------------------S@S--------------C-----------SS---------S@S--------SS------#--#----------##--#------------SS!S-------------#######-------
---------------------------------------tt------tt---------tt----------------------------------------------------------------------------##--##--------###--##---------------------------########-------
---------------------------------------tt------tt---------tt---------------------------------------------------------------------------###--###------####--###-----tt---------------tt-#########------F
---M---------------g-------------------tt------tt-----gg--tt-------------------------------gggg---------kk----------------g--g-g------####--####----#####--####----tt-------g-------tt##########------#
XXXXXXXXXX---XXXXXXXXXXXXXXXXXXXXXXXXXXXXXXXXXXXXXXXXXXXXXXXXXXXXXXXXX--XXXXXXXXXXXXXXX---XXXXXXXXXXXXXXXXXXXXXXXXXXXXXXXXXXXXXXXXXXXXXXXXXXXXXXXXXXXXXXX--XXXXXXXXXXXXXXXXXXXXXXXXXXXXXXXXXXXXXXXXXXXX
XXXXXXXXXX---XXXXXXXXXXXXXXXXXXXXXXXXXXXXXXXXXXXXXXXXXXXXXXXXXXXXXXXXX--XXXXXXXXXXXXXXX---XXXXXXXXXXXXXXXXXXXXXXXXXXXXXXXXXXXXXXXXXXXXXXXXXXXXXXXXXXXXXXX--XXXXXXXXXXXXXXXXXXXXXXXXXXXXXXXXXXXXXXXXXXXX
