-------------------------------------------------------------------------------------------------------------------------------------------------------------------------------------------------------
-------------------------------------------------------------------------------------------------------------------------------------------------------------------------------------------------------
-------------------------------------------------------------------------------------------------------------------------------------------------------------------------------------------------------
-------------------------------------------------------------------------------------------------------------------------------------------------------------------------------------------------------
-------------------------------------------------------------------------------------------------------------------------------------------------------------------------------------------------------
-------------------------------------------------------------------------------------------------------------------------------------------------------------------------------------------------------
-##------------SSSSSSSS---SSS!----------------------------------------S---S------SSSSSSSS---SSS!--------@-----------SSS----S!!S-S!!S-----------------------------------------------------------##------
###-----------------------------------------------------------------------------------------------------------------------------------------------------------------------------------------#-###------
###----------------------------------------------------------------------------------------------------------------------------------------------------------------------------------------######------
###---------------------------------------------------------------------------------------------------------------------------------------------------------------------------------------#######------
###--------------------------C-----S-----------tt----------tt-----------------S@S--------------C-----SU-!--!-----S----------SS---SS------#--#----------##--#-------------SS!S------------########------
###------------------------------------tt------tt----------tt---------------------------------------------------------------------------##--##--------###--##---------------------------#########------
###------------------------------------tt------tt----------tt--------------------------------------------------------------------------###--###------####--###------tt--------------tt-##########-----F
###M-----------------------------------tt------ttg-----g---tt---------------------------------gg--------------------------------------####--####----#####--####----#tt--------------tt###########-----#
XXXXXXXXXXXXXXXXXXXXX---XXXXXXXXXXXXXXXXXXXXXXXXXXXXXXXXXXXXXXXXXXXXXX--XXXXXXXXXXXXXXX---XXXXXXXXXXXXXXXXXXXXXXXXXXXXXXXXXXXXXXXXXXXXXXXXXXXXXXXXXXXXXXX--XXXXXXXXXXXXXXXXXXXXXXXXXXXXXXXXXXXXXXXXXXXX
XXXXXXXXXXXXXXXXXXXXX---XXXXXXXXXXXXXXXXXXXXXXXXXXXXXXXXXXXXXXXXXXXXXX--XXXXXXXXXXXXXXX---XXXXXXXXXXXXXXXXXXXXXXXXXXXXXXXXXXXXXXXXXXXXXXXXXXXXXXXXXXXXXXX--XXXXXXXXXXXXXXXXXXXXXXXXXXXXXXXXXXXXXXXXXXXX
