-------------------------------------------------------------------------------------------------------------------------------------------------------------------------------------------------------
-------------------------------------------------------------------------------------------------------------------------------------------------------------------------------------------------------
-------------------------------------------------------------------------------------------------------------------------------------------------------------------------------------------------------
-------------------------------------------------------------------------------------------------------------------------------------------------------------------------------------------------------
-------------------------------------------------------------------------------------------------------------------------------------------------------------------------------------------------------
-------------------------------------------------------------------------------------------------------------------------------------------------------------------------------------------------------
---SSSSSSSS---SSS!-----------SSS----S!!S---------------S---------SSSSSS---SSS!-----SSSS----S-SSSSSSSS---SSS!--------------SSS----S!!S--------------------------------------------------------##--------
--------------------------------------------------------------------------------------------------------------------------------------------------------------------------------------------###--------
-------------------------------------------------------------------------------------------------------------------------------------------------------------------------------------------####--------
------------------------------------------------------------------------------------------------------------------------------------------------------------------------------------------#####--------
S@S--------------C--!-----S----------SS--------tt------------#--S------------C--------------S--------------C-----SU----S----------SS------#--#---------##--#------------SS!S-------------######--------
-----------------------------------------------tt-----------##---------------------------------------------------------------------------##--#--------###--##---------------------------#######--------
-----------------------------------------------tt----------###--------------------------------------------------------------------------###--##------####--###-----tt--------------tt--########-------F
---M----------------g---------------------g----tt------g--####-------------------------------gg------------------------------g---------####--###----#####--####----tt-------g------tt##########-------#
XXXXXXXXX---XXXXXXXXXXXXXXXXXXXXXXXXXXXXXXXXXXXXXXXXXXXXXXXXXXXXXXXXX---XXXXXXXXXXXXXX---XXXXXXXXXX---XXXXXXXXXXXXXXXXXXXXXXXXXXXXXXXXXXXXXXXXXXXXXXXXXXX--XXXXXXXXXXXXXXXXXXXXXXXXXXXXXXXXXXXXXXXXXXXX
XXXXXXXXX---XXXXXXXXXXXXXXXXXXXXXXXXXXXXXXXXXXXXXXXXXXXXXXXXXXXXXXXXX---XXXXXXXXXXXXXX---XXXXXXXXXX---XXXXXXXXXXXXXXXXXXXXXXXXXXXXXXXXXXXXXXXXXXXXXXXXXXX--XXXXXXXXXXXXXXXXXXXXXXXXXXXXXXXXXXXXXXXXXXXX
