XXXXXXXXXXXXXXXXXXXXXXX---------------XXXXX-----------#######------###-#######tt----###--##-#######-----##########--#######----#######---#tXXXXXXXXXXXXXXXXXXXXXXXXXXXXXXXX---tt-########tt---------tt-
XXXXXXXXXXXXXXXXXXXXXXX---##----------XXXXX----------########--tt-####-#######tttt-####--##########-tt-###########-########tt-########---#tXXXXXXXXXXXXXXXXXXXXXXXXXXXXXXXX---tt#########tt---------tt-
-------------------------###------------------------#########--tt#####-#######tttt#####--##########-tt#####################tt#########---#t--------------------------------XXXXXXXXXXXXXXtt---------tt-
------------------------####------------------------XXXXXXXXXXXXXXXXXX-XXXXXXXXXXXXXXXX--XXXXXXXXXXXXXXXXXXXXXXXXXXXXXXXXXXXXXXXXXXXXXXXX#X--------------------------------XXXXXXXXXXXXXXtt---------tt-
-----------------------#####SSSSSSSS----------------XXXXXXXXXXXXXXXXXX-XXXXXXXXXXXXXXXX--XXXXXXXXXXXXXXXXXXXXXXXXXXXXXXXXXXXXXXXXXXXXXXXXXX------------------------------------------------------------
-----------------------#####---------------------------------------------------------------------------------------------------------------------------------------------------------------------------
-##-SSSSSSSS---SSS-SSSS#####---------------------------SSS--------------SSS----S!!SSSSS----SSS----S!!S--SSS----S!!SSSS!!SSSS----S!!S---------------------------------SSSSSS-SSS----S---------##-----@--
###--------------------#####----------------------------------------------------------------------------------------------------------------------------------------------------------------###--------
###--------------------#####---------------------------------------------------------------------------------------------------------------------------------------------------------------####--------
###---------------1----XXXXX------------------------1------------1------------------------------------------------------------------------------------------------------------------------#####--------
###S-------------------XXXXX--------------------tt--------tt--------------------SS-----------------SS-----------SS----CS---------SS-------#-#-----------#--#-----------------------------######-----!--
###---------------------------------------------tt--------tt-----------------------------------------------------------------------------##-##---------##--##---------------------------#######--------
###--------------------------tt--------tt-------tt--------tt---------------------------------------------------------------------------####-###------####--###-----tt---------------tt-########-------F
###M---------------g---------tt--------tt-------tt----gg--tt-------------------------------gggg---------kk----------------g--g-g------#####-####----#####--####----tt-------g-------tt#########-------#
XXXXXXXXXX---XXXXXXXXXXXXXXXXXXXXXXXXXXXXXXXXXXXXXXXXXXXXXXXXXXXXXXXXX--XXXXXXXXXXXXXXX---XXXXXXXXXXXXXXXXXXXXXXXXXXXXXXXXXXXXXXXXXXXXXXXXXXXXXXXXXXXXXXX--XXXXXXXXXXXXXXXXXXXXXXXXXXXXXXXXXXXXXXXXXXXt
XXXXXXXXXX---XXXXXXXXXXXXXXXXXXXXXXXXXXXXXXXXXXXXXXXXXXXXXXXXXXXXXXXXX--XXXXXXXXXXXXXXX---XXXXXXXXXXXXXXXXXXXXXXXXXXXXXXXXXXXXXXXXXXXXXXXXXXXXXXXXXXXXXXX--XXXXXXXXXXXXXXXXXXXXXXXXXXXXXXXXXXXXXXXXXXXX
