XXXXXXXXXXXXXXXXSXXXXXXXXXXXXXXXXXXXXXXXXXXXXXXXXXXXXXXXXXXXXXXXXXXXXXXXXXXXXXXXXXXXXXXXXXXXXXXXXXXXXXXXXXXXXXXXXXXXXXXXXXXXXXXXXXXXXXXXXXXXXXXXXXXXXXXXXXXXXXXXXXXXXXXXXXXXXXXXXXXXXXXXXXXXXXXXXXXXXX-
-------------------------------------------------------------------------------------------------------------------------------------------------------------------------------------------------------
-------------------------------------------------------------------------------------------------------------------------------------------------------------------------------------------------------
-------------------------------------------------------------------------------------------------------------------------------------------------------------------------------------------------------
-------------------------------------------------------------------------------------------------------------------------------------------------------------------------------------------------------
-------------------------------------------------------------------------------------------------------------------------------------------------------------------------------------------------------
-##---SSS----S!!S--SSSSSSSSSSS------------------------------------SSSSS---SSS!--SSSSSSSS---SSS-SSSSSSS--SSS----S!!S-SS--SSSSSSSSSSSS----------------------------SSS----S!!SSSSSSSSS----------#---------
###-------------------------------------------------------------------------------------------------------------------------------------------#---------------------------------------------##---------
###------------------------------------------------------------------------------------------------------------------------------------------##--------------------------------------------###---------
###-----------------------------------------------------------------------------------------------------------------------------------------###-------------------------------------------####---------
###-----------SS-------------------------------ttt--------#----S@S-----------C----------------S-----------------SS----@S-------------------####--------##--#-S----------SS---------------######--------
###------------------------------------tt------ttt--------##------------------------------------------------------------------------------#####-------###--##---------------------------########-------
###------------------------------------tt------ttt--------###-------------------------------------------------------------------------tt-######------####--##-----------------------tt-##########-----F
###M-----------------------------------tt------ttg-----g--####--------------------------------gg--------------------------------------tt#######t----#####--##-----------------------tt############----#
XXXXXXXXXXXXXXXXXXXXXXXXX--XXXXXXXXXXXXXXXXXXXXXXXXXXXXXXXXXXXXXXXXXX---XXXXXXXXXXXXXX---XXXXXXXXXXXX-XXXXXXXXXXXXXXXXXXXXXXXXXXXXXXXXXXXXXXXXXtXXXXXXXXX--XXXXXXXXXXXXXXXXXXXXXX--XXXXXXXXXXXXXXXXXXXX
XXXXXXXXXXXXXXXXXXXXXXXXX--XXXXXXXXXXXXXXXXXXXXXXXXXXXXXXXXXXXXXXXXXX---XXXXXXXXXXXXXX---XXXXXXXXXXXX-XXXXXXXXXXXXXXXXXXXXXXXXXXXXXXXXXXXXXXXXXXXXXXXXXXX--XXXXXXXXXXXXXXXXXXXXXX--XXXXXXXXXXXXXXXXXXXX
