##----------##-----------##------------##---------------------------------##---##----------------------------------------------------------------------------------------------------------------------
##---------###----------###-----------###--------------------------------###--###----------------------------------------------------------------------------------------------------------------------
##--------####---------####--SSSSSSSS####-SSSSSSS---SSSSSSSSS-----------####-####---------#-----------------##-##----##-##-----------------------------SSSS-------------------##---##------------------
##-------#####--------#####----------####------------------------------##########---------#----------------######---######--------------SSSSSSSS---SSS!----------------------###--###------------------
##------######-------######----------####-----------------------------###########---------#----SSSSSSSS---#######--#######-SSSSSSSS---SS----------------------SSS----S!!S---####--###------------------
##-----#######------#######----------####----------------------------############-SSSSSSSS#--------------########-########-------------------------------------------------#####--###------------------
##-tt-########---t-########@S--------####------------------------tt-#############---------#-------------##################-------------------------------------------------#####--###--------##-----@--
##-tt#########---t#########----------####------------------------tt##############---------#------------###################----------------------------C--------------------#####--###-------###--------
XXXXXXXXXXXXXXXXXXXXXXXXXXX----------XXXXX--------------------XXXXXXXXXXXXXXXXXXX---------#-S@S--------###################S--------------------------------#----------SS---#####--###------####--------
XXXXXXXXXXXXXXXXXXXXXXXXXXX----------XXXXX--------------------XXXXXXXXXXXXXXXXXXXS--------#------------###################---------------------------------#---------------#####--###-----#####--------
###------------------------------!-------------###--------tt----U------------C------------X------------XXXXXXXXXXXXXXXXXXX-----------------------------XX--X---------------XXXXXXXXXX----######-----!--
###--------------------------------------------###--------tt------------------------------X------------XXXXXXXXXXXXXXXXXXX--------------XXXXXX---XXXXXXXX--X---------------XXXXXXXXXX---#######--------
###------------------------------------tt------###--------tt---------------------------------------------------------------------------###--###------####--###-----tt---------------t#############----F
###M-----------------------------------tt------###--------tt--------------------------------------------------------------------------####--####----#####--####----tt---------------t#############----#
XXXXXXXXXXXXXXXXXXXXXXXXXXXXXXXXXXXXXXXXXXXXXXXXXXXXXXXXXXXXXXXXXXXXX---XXXXXXXXXXXXXX---XXXXXXXXXXXXXXXXXXXXXXXXXXXXXXXXXXXXXXXXXXXXXXXXXXXXXXXXXXXXXXXX--XXXXXXXXXXXXXXXXXXXXXXXXXX#####XXXXXXXXXXXXX
XXXXXXXXXXXXXXXXXXXXXXXXXXXXXXXXXXXXXXXXXXXXXXXXXXXXXXXXXXXXXXXXXXXXX---XXXXXXXXXXXXXX---XXXXXXXXXXXXXXXXXXXXXXXXXXXXXXXXXXXXXXXXXXXXXXXXXXXXXXXXXXXXXXXX--XXXXXXXXXXXXXXXXXXXXXXXXXX#####XXXXXXXXXXXXX
