XXXXXXXXXXXXXXXXXXXXXXXXXXXXXXXXXXXXXXXXXXXXXXXXXXXXXXXXXXXXXXXXXXXXXXXXXXXXXXXXXXXXXXX--XXXXXXXXXXXXXXXXXXXXXXXXXXXXXXXXXXXXXXXXXXXXXXXXXXXXXXXXXXXXXXXX-XXXXXXXXXXXXXXXXXXXXXXXXXXXXXXXXtt--------tt-
XXXXXXXXXXXXXXXXXXXXXXXXXXXXXXXXXXXXXXXXXXXXXXXXXXXXXXXXXXXXXXXXXXXXXXXXXXXXXXXXXXXXXXX--XXXXXXXXXXXXXXXXXXXXXXXXXXXXXXXXXXXXXXXXXXXXXXXXXXXXXXXXXXXXXXXX-XXXXXXXXXXXXXXXXXXXXXXXXXXXXXXXXtt--------tt-
-------------------------------------------------------------------------------------------------------------------------------------------------------------------------------------------------------
-------------------------------------------------------------------------------------------------------------------------------------------------------------------------------------------------------
-------------------------------------------------------------------------------------------------------------------------------------------------------------------------------------------------------
-------------------------------------------------------------------------------------------------------------------------------------------------------------------------------------------------------
--##--------SSS----S!!SSSSSS-SSS----SSS-------------------------SSSSSSS---SSS!-SSSSSSSS--SSSSSSSSSSSS----S!!S---SSSSS-----SSS----S!!---------------------------------SSS----S!!SSSSSS--------##--------
-###----------------------------------------------------------------------------------------------------------------------------------------------------------------------------------------###--------
####-----------------------------------------------------------------------------------------------------------------------------------------#---------------------------------------------####--------
####----------------------------------------------------------------------------------------------------------------------------------------##--------------------------------------------#####--------
####----------------SS-------------------------tt---------tt-----------------CS---------------------------SS-----------S----------SS-------###---------##--#-----------------SS----------######--------
####-----------------------------------tt------tt---------tt#-----------------------------------------------------------------------------####--------###--###--------------------------#######--------
####-----------------------------------tt------tt---------tt##------------------------------------------------------------------------tt-######------####--####-----t----------------t-########--#----F
###M----------------g------------------tt-g----tt------g--tt###------------------------------gg----------------#-------------g--------tt########----#####--#####----t-------g--------t#########--##---#
XXXXXXXXXXXXXXXXXXXXXXXXXXXXXXXXXXXXXXXXXXXXXXXXXXXXXXXXXXXXXXXXXXXXX---XXXXXXXXXXXXXX---XXXXXXXXXX-XXXXXXXXXXXXXXXXXXXXXXXXXXXXXXXXXXXXXXXXXXXXXXXXXXXXX--XXXXXXXXXXXXXXXXXXXXXXXXXXtXXXXXXXXXXXXXXXXX
XXXXXXXXXXXXXXXXXXXXXXXXXXXXXXXXXXXXXXXXXXXXXXXXXXXXXXXXXXXXXXXXXXXXX---XXXXXXXXXXXXXX---XXXXXXXXXX-XXXXXXXXXXXXXXXXXXXXXXXXXXXXXXXXXXXXXXXXXXXXXXXXXXXXX--XXXXXXXXXXXXXXXXXXXXXXXXXXtXXXXXXXXXXXXXXXXX
