-------------------------------------------------------------------------------------------------------------------------------------------------------------------------------------------------------
-------------------------------------------------------------------------------------------------------------------------------------------------------------------------------------------------------
-------------------------------------------------------------------------------------------------------------------------------------------------------------------------------------------------------
-------------------------------------------------------------------------------------------------------------------------------------------------------------------------------------------------------
-------------------------------------------------------------------------------------------------------------------------------------------------------------------------------------------------------
-------------------------------------------------------------------------------------------------------------------------------------------------------------------------------------------------------
-##----------SSSSSSS-SSS----S!!S-----------------------SS---------SSSSS---SSS!------SSSSS--SS----S!!SS----S!!S--SS----S!!SSSS----S!!S-------------------------------------SSS----S!!S---------##-------
###-----------------------------------------------------------------------------------------------------------------------------------------------------------------------------------------####-------
###----------------------------------------------------------------------------------------------------------------------------------------------------------------------------------------#####-------
###---------------------------------------------------------------------------------------------------------------------------------------------------------------------------------------######-------
###--------------------------SS----------------t----------#tt--S@S-----------C-----S--------------SS-------SS----------SS---------SS------#--#---------##--#-----------S----------SS-----#######-------
###------------------------------------tt------t----------#tt----------------------------------------------------------------------------##--##-------###--##---------------------------########-------
###------------------------------------tt------ttt--------#tt---------------------------------------------------------------------------###--###------###--###-----------------------t-#########------F
###M----------------g------------------tt------ttt-----g--#tt---------------------------------g--------------------------g----g--------####--####----####--####----------------------t##########------#
XXXXXXXXXXXXXXXXXXXXXXXXXXXXXXXXXXXXXXXXXXXXXXXXXXXXXXXXXXXXXXXXXXXXX---XXXXXXXXXXXXXXX---XXXXXXXXXXXXXXXXXXXXXXXXXXXXXXXXXXXXXXXXXXXXXXXXXXXXXXXXXXXXXXX--XXXXXXXXXXXXXXXXXXXXXXXXXXXXXXXXXXXXXXXXXXXX
XXXXXXXXXXXXXXXXXXXXXXXXXXXXXXXXXXXXXXXXXXXXXXXXXXXXXXXXXXXXXXXXXXXXX---XXXXXXXXXXXXXXX---XXXXXXXXXXXXXXXXXXXXXXXXXXXXXXXXXXXXXXXXXXXXXXXXXXXXXXXXXXXXXXX--XXXXXXXXXXXXXXXXXXXXXXXXXXXXXXXXXXXXXXXXXXXX
