-------------------------------------------------------------------------------------------------------------------------------------------------------------------------------------------------------
-------------------------------------------------------------------------------------------------------------------------------------------------------------------------------------------------------
-------------------------------------------------------------------------------------------------------------------------------------------------------------------------------------------------------
-------------------------------------------------------------------------------------------------------------------------------------------------------------------------------------------------------
-------------------------------------------------------------------------------------------------------------------------------------------------------------------------------------------------------
-------------------------------------------------------------------------------------------------------------------------------------------------------------------------------------------------------
--##------SSSSSSSSSSSSSSS---SSS!----SS----------------------------------SSS----S!!S-SSSSS---SSS!----SS----S!!SSSSS----S!!S--SS----S!!S--------------------------------SSS----S!!S------------##--------
-###----------------------------------------------------------------------------------------------------------------------------------------------------------------------------------------###--------
####---------------------------------------------------------------------------------------------------------------------------------------------------------------------------------------####--------
####--------------------------------------------------------------1-----------------------------------------------------------------------------------------------------------------------#####--------
####-----S---------------------C---------------tt---------#tt-------------------SS-------------C-----------SS----------SS----------SS----#--#-----------#--#------------------SS---------######--------
####-------------------------------------------tt---------#tt---------------------------------------------------------------------------##--##---------##--##------------------------#--#######--------
####-----------------------------------tt------tt---------#tt--------------------------------------------------------------------------###--###-------###--###----------------------##-########-------F
###M-----------------------------------tt------tt---------#tt-------------------------------------------------------------------------####--####----#####--####----#---------------############-------#
XXXXXXXXXXXXXXXX-XXXXXX---XXXXXXXXXXXXXXXXXXXXXXXXXXXXXXXXXXXXXXXXXXXXX-XXXXXXXXXXXXXXX---XXXXXXXXXXXXXXXXXXXXXXXXXXXXXXXXXXXXXXXXXXXXXXXXXXXXXXXXXXXXXXXXXXXXXXXXXXXXXXXXXXXXXXXXXXXXXXXXXXXXXXXXXXXXX
XXXXXXXXXXXXXXXX-XXXXXX---XXXXXXXXXXXXXXXXXXXXXXXXXXXXXXXXXXXXXXXXXXXXX-XXXXXXXXXXXXXXX---XXXXXXXXXXXXXXXXXXXXXXXXXXXXXXXXXXXXXXXXXXXXXXXXXXXXXXXXXXXXXXXXXXXXXXXXXXXXXXXXXXXXXXXXXXXXXXXXXXXXXXXXXXXXX
