-------------------------------------------------------------------------------------------------------------------------------------------------------------------------------------------------------
-------------------------------------------------------------------------------------------------------------------------------------------------------------------------------------------------------
-------------------------------------------------------------------------------------------------------------------------------------------------------------------------------------------------------
-------------------------------------------------------------------------------------------------------------------------------------------------------------------------------------------------------
-------------------------------------------------------------------------------------------------------------------------------------------------------------------------------------------------------
-------------------------------------------------------------------------------------------------------------------------------------------------------------------------------------------------------
---SSSSSSSS---SSS!-#---------SSS----S!!---------------------------SSSSS---SSS!---SSSSSS-----SSS---SSS----S!!S--SSS----S!!S----SSSSSSS---------------------------------SSSSSS--S!!S-----------##--------
-------------------#------------------------------------------------------------------------------------------------------------------------------------------------------------------------###--------
-------------------#-----------------------------------------------------------------------------------------------------------------------------------------------------------------------####--------
-------------------#-----------------------------------------------------------g----------------------------------------------------------------------------------------------------------#####--------
S@S--------------C-#!-----S----------SS--------tt---------#------------------C-----------------S----------SS-----------SS----S-----------#--#----------##--#---------S---------SS--------######--------
-------------------#-------------------tt------tt---------##----------------------------------------------------------------------------##--##--------###--##-------------------------#-#######--------
-------------------#-------------------tt------tt---------###--------------------------------------------------------------------------###--###------####--###-----tt----------------##########-------F
---M---------------#-------------------tt------tt------g--####-------------------------------gg--------------------------g--#g--------####--####----#####--####----tt-------g-------###########-------#
XXXXXXXXX---XXXXXXXXXXXXXXXXXXXXXXXXXXXXXXXXXXXXXXXXXXXXXXXXXXXXXXXXX---XXXXXXXXXXXXXX----XXXXXXXXXXXXXXXXXXXXXXXXXXXXXXXXXXXXXXXXXX-XXXXXXXXXXXXXXXXXXXX--XXXXXXXXXXXXXXXXXXXXXXXXXXXXXXXXXXXXXXXXXXXX
XXXXXXXXX---XXXXXXXXXXXXXXXXXXXXXXXXXXXXXXXXXXXXXXXXXXXXXXXXXXXXXXXXX---XXXXXXXXXXXXXX----XXXXXXXXXXXXXXXXXXXXXXXXXXXXXXXXXXXXXXXXXX-XXXXXXXXXXXXXXXXXXXX--XXXXXXXXXXXXXXXXXXXXXXXXXXXXXXXXXXXXXXXXXXXX
