-------------------------------------------------------------------------------------------------------------------------------------------------------------------------------------------------------
-------------------------------------------------------------------------------------------------------------------------------------------------------------------------------------------------------
-------------------------------------------------------------------------------------------------------------------------------------------------------------------------------------------------------
-------------------------------------------------------------------------------------------------------------------------------------------------------------------------------------------------------
-------------------------------------------------------------------------------------------------------------------------------------------------------------------------------------------------------
-------------------------------------------------------------------------------------------------------------------------------------------------------------------------------------------------------
--##----------SSSSSSSS---SSS!-------SSS----------------------------SSS----SSS!--SSSSSSS----SSS!----SSS----S---SSS----S!!S-SSS----S!!S------------SSSSS--------------SSS!------S!!S-----------##--------
-###----------------------------------------------------------------------------------------------------------------------------------------------------------------------------------------###--------
####---------------------------------------------------------------------------------------------------------------------------------------------------------------------------------------####--------
####--------------------------------------------------------------------------------------------------------------------------------------------------------------------------------------#####--------
####------------------------C----S-------------------------tt----------------C@S--------------C------------S----------SS----------SS--------#----------##--#-----------C-------SS--------######--------
####-------------------------------------------tt----------tt----------------------------------------------------------------------------#--##--------###--##-------------------------#-#######--------
####-----------------------------------tt------tt----------tt---------------------------------------------------------------------------##--###-------###--###-----------------------##########-------F
###M---------------g-------------------tt------tt-----gg---tt------------------------------gggg--------kk-----------------g--g-g-------###--####------###--####-------------g-------###########-------#
XXXXXXXXXXXXXXXXXXXX---XXXXXXXXXXXXXXXXXXXXXXXXXXXXXXXXXXXXXXXXXXXXXX---XXXXXXXXXXXXXX---XXXXXXXXXXXXXXXXXXXXXXXXXXXXXXXXXXXXXXXXXXXXXXXXXXXXXXXXXXXXXXXX--XXXXXXXXXXXXXXXXXXXXXXXXXXXXXXXXXXXXXXXXXXXX
XXXXXXXXXXXXXXXXXXXX---XXXXXXXXXXXXXXXXXXXXXXXXXXXXXXXXXXXXXXXXXXXXXX---XXXXXXXXXXXXXX---XXXXXXXXXXXXXXXXXXXXXXXXXXXXXXXXXXXXXXXXXXXXXXXXXXXXXXXXXXXXXXXX--XXXXXXXXXXXXXXXXXXXXXXXXXXXXXXXXXXXXXXXXXXXX
