-------------------------------------------------------------------------------------------------------------------------------------------------------------------------------------------------------
-------------------------------------------------------------------------------------------------------------------------------------------------------------------------------------------------------
-------------------------------------------------------------------------------------------------------------------------------------------------------------------------------------------------------
-------------------------------------------------------------------------------------------------------------------------------------------------------------------------------------------------------
-------------------------------------------------------------------------------------------------------------------------------------------------------------------------------------------------------
-------------------------------------------------------------------------------------------------------------------------------------------------------------------------------------------------------
##--SSSSSSSS---SSS!----------SSS----S!!S------------------------------S---SSSSS-SSSSSSS----SSS!--SSSSSSSSSSS----S!!S------SSS----S!!S-----------SSS---------------------SSSSSSSSSSSSS--------##--------
##------------------------------------------------------------------------------------------------------------------------------------------------------------------------------------------###--------
##-----------------------------------------------------------------------------------------------------------------------------------------------------------------------------------------####--------
##-----------------------------------------------------------------------------g----------------------------------------------------------------------------------------------------------#####--------
##@S--------------C-------S----------SS--------tt----------tt------------------S--------------C------------------SS----S----------SS------#--#---------##--#-----------S-----------------######--------
##---------------------------------------------tt----------tt----------------------------------------------------------------------------##--#--------###--##---------------------------#######--------
##---------------------------------------------tt----------tt---------------------------------------------------------------------------###--#-------####--###-----tt----------------t-########-------F
##-M--------------------------------------#----tt------g---tt--------------------------------gg--------------------------g---g---------####--#------#####--####----tt-------g--------t#########-------#
XXXXXXXXXX---XXXXXXXXXXXXXXXXXXXXXXXXXXXXXXXXXXXXXXXXXXXXXXXXXXXXXXXXX--XXXXXXXXXXXXXX---XXXXXXXXXXXXXX--XXXXXXXXXXXXXXXXXXXXXXXXXXXXXXXXXXXXXXXXXXXXXXXX--XXXXXXXXXXXXXXXXXXX-XXXXXXXXXXXXXXXXXXXXXXXX
XXXXXXXXXX---XXXXXXXXXXXXXXXXXXXXXXXXXXXXXXXXXXXXXXXXXXXXXXXXXXXXXXXXX--XXXXXXXXXXXXXX---XXXXXXXXXXXXXX--XXXXXXXXXXXXXXXXXXXXXXXXXXXXXXXXXXXXXXXXXXXXXXXX--XXXXXXXXXXXXXXXXXXX-XXXXXXXXXXXXXXXXXXXXXXXX
