-------------------------------------------------------------------------------------------------------------------------------------------------------------------------------------------------------
-------------------------------------------------------------------------------------------------------------------------------------------------------------------------------------------------------
-------------------------------------------------------------------------------------------------------------------------------------------------------------------------------------------------------
-------------------------------------------------------------------------------------------------------------------------------------------------------------------------------------------------------
-------------------------------------------------------------------------------------------------------------------------------------------------------------------------------------------------------
-------------------------------------------------------------------------------------------------------------------------------------------------------------------------------------------------------
--##-SSSSSSSS---SSS!-------SSS---------------------------------------S----SSS!--SSSSSSS----SSSSSSSSSS---SSS!--------SSS----S!!S-----------------------------------SSSSSSSS---SSS!------------##--------
-###----------------------------------------------------------------------------------------------------------------------------------------------------------------------------------------###--------
####---------------------------------------------------------------------------------------------------------------------------------------------------------------------------------------####--------
####-------------------------------------------------------------1---------------------------------------------------------------------------#--------------------------------------------#####--------
####---------------C---------------------------#----------tt-----------------C@S---------------------------C-----SU---------SS--------------##---------##--#--------------------C--------######--------
####-----------------------------------tt------##---------tt-------------------------------------------------------------------------------###--------###--##---------------------------#######--------
####-----------------------------------tt------###--------tt---------------------------------------------------------------------------tt-#####------####--###----------------------tt-########-------F
###M---------------g-------------------tt------###----gg--tt-------------------------------gggg--------kk-----------------g--g-g-------tt#######----#####--####-------------g-------tt#########-------#
XXXXXXXXXXX---XXXXXXXXXXXXXXXXXXXXXXXXXXXXXXXXXXXXXXXXXXXXXXXXXXXXXXX---XXXXXXXXXXXXXX---XXXXXXXXXX---XXXXXXXXXXXXXXXXXXXXXXXXXXXXXXXXXXXXXXXXXXXXXXXXXXX--XXXXXXXXXXXXX---XXXXXXXXXXXXXXXXXXXXXXXXXXXX
XXXXXXXXXXX---XXXXXXXXXXXXXXXXXXXXXXXXXXXXXXXXXXXXXXXXXXXXXXXXXXXXXXX---XXXXXXXXXXXXXX---XXXXXXXXXX---XXXXXXXXXXXXXXXXXXXXXXXXXXXXXXXXXXXXXXXXXXXXXXXXXXX--XXXXXXXXXXXXX---XXXXXXXXXXXXXXXXXXXXXXXXXXXX
