-------------------------------------------------------------------------------------------------------------------------------------------------------------------------------------------------------
-------------------------------------------------------------------------------------------------------------------------------------------------------------------------------------------------------
-------------------------------------------------------------------------------------------------------------------------------------------------------------------------------------------------------
-------------------------------------------------------------------------------------------------------------------------------------------------------------------------------------------------------
-------------------------------------------------------------------------------------------------------------------------------------------------------------------------------------------------------
-------------------------------------------------------------------------------------------------------------------------------------------------------------------------------------------------------
--##----------SSSSSSSS-!-------------------------------------------------SSSSSS-SSSSSSSSS---SSS!--------SSS----S!!SSS--SSS----S!!S----------------------------------SSS----S!!SSSSSSS---------##-------
-###-----------------------------------------------------------------------------------------------------------------------------------------------------------------------------------------###-------
####---------------------------------------------------------------------------------------------------------------------------------------------------------------------------------------#####-------
####-------------------------------------------------------------1------------------------------------------------------------------------------------------------------------------------######-------
####------------------@S!S--------------------------------tt------------S------S---------------C-----S----------SS-------------SS---------###----------##--#-----S----------SS-----------#######-------
####-----------------------------------tt------tt---------tt-----------------------------------------------------------------------------#####--------###--##---------------------------########-------
####-------------------------tt--------tt------tt---------tt---------------------------------------------------------------------------tt######------####--##------------------------t-#########------F
###M----------------g--------tt--------tt------tt------g--tt----------------------------------g--------------------------g----g--------tt#######----#####--##------------------------t##########------#
XXXXXXXXXXXXXXXXXXXXXXXXXXXXXXXXXXXXXXXXXXXXXXXXXXXXXXXXXXXXXXXXXXXXXX--XXXXXXXXXXXXXX----XXXXXXXXXXXXXXXXXXXXXXXXXXXXXXXXXXXXXXXXXXXXXXXXXXXXXXXXXXXXXXX--XXXXXXXXXXXXXXXXXXXXXXXXXXXXXXXXXXXXXXXXXXXX
XXXXXXXXXXXXXXXXXXXXXXXXXXXXXXXXXXXXXXXXXXXXXXXXXXXXXXXXXXXXXXXXXXXXXX--XXXXXXXXXXXXXX----XXXXXXXXXXXXXXXXXXXXXXXXXXXXXXXXXXXXXXXXXXXXXXXXXXXXXXXXXXXXXXX--XXXXXXXXXXXXXXXXXXXXXXXXXXXXXXXXXXXXXXXXXXXX
