-------------------------------------------------------------------------------------------------------------------------------------------------------------------------------------------------------
-------------------------------------------------------------------------------------------------------------------------------------------------------------------------------------------------------
-------------------------------------------------------------------------------------------------------------------------------------------------------------------------------------------------------
-------------------------------------------------------------------------------------------------------------------------------------------------------------------------------------------------------
-------------------------------------------------------------------------------------------------------------------------------------------------------------------------------------------------------
-------------------------------------------------------------------------------------------------------------------------------------------------------------------------------------------------------
-##--SSS----S!!S-S-SSS----S!!S----------------------------------------S---SSSSSSSSSSSSSSS---SSS!--------SSS----S!!S-------SSS----S!!S---------------------------------------------------------##-------
###------------------------------------------------------------------------------------------------------------------------------------------------------------------------------------------###-------
###----------------------------------------------------------------------------------------------------------------------------------------------------------------------------------------#####-------
###--------------------------------------------------------------1------------------------------------------------------------------------------------------------------------------------######-------
###----------SS------------SS------------------#----------tt-----------------------------------C-----S----------SS-----S----------SS--------#----------##--#------------SSS!S------------#######-------
###------------------------------------tt------##---------tt-----------------------------------------------------------------------------#--##--------###--##---------------------------########-------
###------------------------------------tt------##---------tt----------------------------------------------------------------------------##--###------####--###-----tt---------------tt-#########------F
###M-----------------------------------tt------##---------tt---------------------------------------------------------------------------###--####----#####--####----tt---------------tt##########------#
XXXXXXXXXXXXXXXXXXXXXXXXXXXXXXXXXXXXXXXXXXXXXXXXXXXXXXXXXXXXXXXXXXXXXX--XXXXXXXXXXXXXXX---XXXXXXXXXXXXXXXXXXXXXXXXXXXXXXXXXXXXXXXXXXXXXXXXXXXXXXXXXXXXXXX--XXXXXXXXXXXXXXXXXXXXXXXXXXXXXXXXXXXXXXXXXXXX
XXXXXXXXXXXXXXXXXXXXXXXXXXXXXXXXXXXXXXXXXXXXXXXXXXXXXXXXXXXXXXXXXXXXXX--XXXXXXXXXXXXXXX---XXXXXXXXXXXXXXXXXXXXXXXXXXXXXXXXXXXXXXXXXXXXXXXXXXXXXXXXXXXXXXX--XXXXXXXXXXXXXXXXXXXXXXXXXXXXXXXXXXXXXXXXXXXX
