-------------------------------------------------------------------------------------------------------------------------------------------------------------------------------------------------------
-------------------------------------------------------------------------------------------------------------------------------------------------------------------------------------------------------
-------------------------------------------------------------------------------------------------------------------------------------------------------------------------------------------------------
-------------------------------------------------------------------------------------------------------------------------------------------------------------------------------------------------------
-------------------------------------------------------------------------------------------------------------------------------------------------------------------------------------------------------
-------------------------------------------------------------------------------------------------------------------------------------------------------------------------------------------------------
--##---------------SSS----S!!S------S-----------------------------SSSSS---SSS!--------SS---SSSS----S!SSSSSS---SSS!------SSSSSSSSSSSS---------------------------------SSS----S!!S--------------##-------
-###-----------------------------------------------------------------------------------------------------------------------------------------------------------------------------------------###-------
####----------------------------------------------------------------------------------------------------------------------------------------------------------------------------------------####-------
####-------------------------------------------------------------1------------------------------------------------------------------------------------------------------------------------######-------
####------!-----S----------SS------------------tt---------tt-----------------C-----SU---------------S------------C-----S-----------------#--#----------##--#------S----------SS----------#######-------
####-------------------------------------------tt---------tt----------------------------------------------------------------------------##--##--------###--##---------------------------########-------
####-----------------------------------tt------tt---------tt---------------------------------------------------------------------------###--###------####--###----------------------tt-#########------F
###M----------------g------------------tt------tt------g--tt----------------------------------g--------------------------g----g-------####--####----#####--###----------------------tt##########------#
XXXXXXXXXXXXXXXXXXXXXXXXXXXXXXXXXXXXXXXXXXXXXXXXXXXXXXXXXXXXXXXXXXXXX---XXXXXXXXXXXXXX---XXXXXXXXXXXXXXXX---XXXXXXXXXXXXXXXXXXXXXXXXXXXXXXXXXXXXXXXXXXXXX--XXXXXXXXXXXXXXXXXXXXXXXXXXXXXXXXXXXXXXXXXXXX
XXXXXXXXXXXXXXXXXXXXXXXXXXXXXXXXXXXXXXXXXXXXXXXXXXXXXXXXXXXXXXXXXXXXX---XXXXXXXXXXXXXX---XXXXXXXXXXXXXXXX---XXXXXXXXXXXXXXXXXXXXXXXXXXXXXXXXXXXXXXXXXXXXX--XXXXXXXXXXXXXXXXXXXXXXXXXXXXXXXXXXXXXXXXXXXX
