-------------------------------------------------------------------------------------------------------------------------------------------------------------------------------------------------------
-------------------------------------------------------------------------------------------------------------------------------------------------------------------------------------------------------
-------------------------------------------------------------------------------------------------------------------------------------------------------------------------------------------------------
-------------------------------------------------------------------------------------------------------------------------------------------------------------------------------------------------------
-------------------------------------------------------------------------------------------------------------------------------------------------------------------------------------------------------
-------------------------------------------------------------------------------------------------------------------------------------------------------------------------------------------------------
----SSSSSSSS---SSS!----------SSS------------------------------------------------SSSSSSS----SSSSSSSSSS---SSS!------SSSSSSSSSSS----S!!S----------------------------------SSS----S!!S-----------##--------
--------------------------------------------------------------------------------------------------------------------------------------------------------------------------------------------###--------
-------------------------------------------------------------------------------------------------------------------------------------------------------------------------------------------####--------
-----------------------------------------------------------------1-------------g----------------------------------------------------------------------------------------------------------#####--------
-S@S--------------C-------S--------------------tt---------tt-----------------S@S---------------------------C-----S----------------SS------#------------##--#-------------------SS------#-######--------
---------------------------------------tt------tt---------tt-----------------------------------------------------------------------------##--#--------###--##-------------------------##t######--------
---------------------------------------tt------tt---------tt----------------------------------------------------------------------------###--##------####--###-----tt----------------###t######-------F
---M-----------------------------------tt------tt------g--tt---------------------------------gg--------------------------g---g---------####--###----#####--####----tt-------g-------####t######-------#
XXXXXXXXXX---XXXXXXXXXXXXXXXXXXXXXXXXXXXXXXXXXXXXXXXXXXXXXXXXXXXXXXXXX--XXXXXXXXXXXXXX---XXXXXXXXXX---XXXXXXXXXXXXXXXXXX--XXXXXXXXXXXXXXXXXXXXXXXXXXXXXXX--XXXXXXXXXXXXXXXXXXXXXXXXXXXXXXXXXXXXXXXXXXXX
XXXXXXXXXX---XXXXXXXXXXXXXXXXXXXXXXXXXXXXXXXXXXXXXXXXXXXXXXXXXXXXXXXXX--XXXXXXXXXXXXXX---XXXXXXXXXX---XXXXXXXXXXXXXXXXXX--XXXXXXXXXXXXXXXXXXXXXXXXXXXXXXX--XXXXXXXXXXXXXXXXXXXXXXXXXXXXXXXXXXXXXXXXXXXX
