-------------------------------------------------------------------------------------------------------------------------------------------------------------------------------------------------------
-------------------------------------------------------------------------------------------------------------------------------------------------------------------------------------------------------
-------------------------------------------------------------------------------------------------------------------------------------------------------------------------------------------------------
-------------------------------------------------------------------------------------------------------------------------------------------------------------------------------------------------------
-------------------------------------------------------------------------------------------------------------------------------------------------------------------------------------------------------
-------------------------------------------------------------------------------------------------------------------------------------------------------------------------------------------------------
####------------SSS----S!!S-----------------------------------------SS----SSSS--SSSSSSS----S-SSS----S!!SSSS----S!!S--SSS----S!!S-S!!S--------------------------------SS!SS--------------------##-------
####-----------------------------------------------------------------------------------------------------------------------------------------------------------------------------------------###-------
####----------------------------------------------------------------------------------------------------------------------------------------------------------------------------------------####-------
####-------------------------------------------------------------1------------------------------------------------------------------------------------------------------------------------######-------
####---!-----S----------SS---------------------tt---------tt------------------@S---------------------SS---------SS-----------SS---SS--------#----------##--#-----------C--S!S------------#######-------
####-----------------------------------tt------tt---------tt-----------------------------------------------------------------------------#--##--------###--##---------------------------########-------
####--------------------------t--------tt------tt---------tt----------------------------------------------------------------------------##--###------####--###-----tt---------------tt-#########------F
###M---------------g---------#t--------tt------tt-----gg--tt-------------------------------gggg--------kk-----------------g--g-g-------###--####----#####--####----tt-------g-------tt##########------#
XXXXXXXXXXXXXXXXXXXXXXXXXXXXXXXXXXXXXXXXXXXXXXXXXXXXXXXXXXXXXXXXXXXXX---XXXXXXXXXXXXXX---XXXXXXXXXXXXXXXXXXXXXXXXXXXXXXXXXXXXXXXXXXXXXXXXXXXXXXXXXXXXXXXX--XXXXXXXXXXXXXXXXXXXXXXXXXXXXXXXXXXXXXXXXXXXX
XXXXXXXXXXXXXXXXXXXXXXXXXXXXXXXXXXXXXXXXXXXXXXXXXXXXXXXXXXXXXXXXXXXXX---XXXXXXXXXXXXXX---XXXXXXXXXXXXXXXXXXXXXXXXXXXXXXXXXXXXXXXXXXXXXXXXXXXXXXXXXXXXXXXX--XXXXXXXXXXXXXXXXXXXXXXXXXXXXXXXXXXXXXXXXXXXX
