-------------------------------------------------------------------------------------------------------------------------------------------------------------------------------------------------------
-------------------------------------------------------------------------------------------------------------------------------------------------------------------------------------------------------
-------------------------------------------------------------------------------------------------------------------------------------------------------------------------------------------------------
-------------------------------------------------------------------------------------------------------------------------------------------------------------------------------------------------------
-------------------------------------------------------------------------------------------------------------------------------------------------------------------------------------------------------
-------------------------------------------------------------------------------------------------------------------------------------------------------------------------------------------------------
-##--SSSSSSSSSSSSS---SSS!-------------------------------------------------------SSSSSSSSS---SSS!--SSSSSS-SSS----S!!S------SSS----S!!S--------------------------------SSSSSSSS---SSS----------##--------
###-----------------------------------------------------------------------------------------------------------------------------------------------------------------------------------------###--------
###----------------------------------------------------------------------------------------------------------------------------------------------------------------------------------------####--------
###-------------------------------------------------------------1-------------------------------------------------------------------------------------------------------------------------#####--------
###---------------------C-----SU---------------ttt---------tt----------------S@S---------------C-----------------SS----S----------SS-----#--#----------##--#-----------------------------######--------
###------------------------------------tt------ttt---------tt----------------------------------------------------------------------------#--##--------###--##---------------------------#######--------
###------------------------------------tt------ttt---------tt---------------------------------------------------------------------------##--###------####--###-----tt---------------tt-########-------F
###M-----------------------------------tt------ttt---------tt---------------------------------------------------------#----------------###--####----#####--####----tt---------------tt#########-------#
XXXXXXXXXXXXXXXX---XXXXXXXXXXXXXXXXXXXXXXXXXXXXXXXXXXXXXXXXXXXXXXXXXX--XXXXXXXXXXXXXXX----XXXXXXXXXXXXXXXXXXXXXXXXXXXXXXXXXXXXXXXXXXXXXXXXXXXXXXXXXXXXXXX--XXXXXXXXXXXXXXXX---XXXXXXXXXXXXXXXXXXXXXXXXX
XXXXXXXXXXXXXXXX---XXXXXXXXXXXXXXXXXXXXXXXXXXXXXXXXXXXXXXXXXXXXXXXXXX--XXXXXXXXXXXXXXX----XXXXXXXXXXXXXXXXXXXXXXXXXXXXXXXXXXXXXXXXXXXXXXXXXXXXXXXXXXXXXXX--XXXXXXXXXXXXXXXX---XXXXXXXXXXXXXXXXXXXXXXXXX
