-------------------------------------------------------------------------------------------------------------------------------------------------------------------------------------------------------
-------------------------------------------------------------------------------------------------------------------------------------------------------------------------------------------------------
-------------------------------------------------------------------------------------------------------------------------------------------------------------------------------------------------------
-------------------------------------------------------------------------------------------------------------------------------------------------------------------------------------------------------
-------------------------------------------------------------------------------------------------------------------------------------------------------------------------------------------------------
-------------------------------------------------------------------------------------------------------------------------------------------------------------------------------------------------------
-##--------------SSS----S!!S--------------------------------------SSSS----SSS!-----SSSS-----SSS!------SSS----S!!S-SSSSSSSS---SSS-S!!S----------------------------SSSSSSSS---SSS!-------------##--------
###-----------------------------------------------------------------------------------------------------------------------------------------------------------------------------------------###--------
###----------------------------------------------------------------------------------------------------------------------------------------------------------------------------------------####--------
###---------------------------------------------------------------------------------------------------------------------------------------------------------------------------------------#####--------
###-----!-----S----------SS--------------------tt----------tt----------------C-----------------C-----S--------SS-S----------------SS------#--#---------##--#-------------------C---------######--------
###------------------------------------tt------tt----------tt----------------------------------------------------------------------------##--##--------##--##---------------------------#######--------
###------------------------------------tt------tt----------tt---------------------------------------------------------------------------###--###------###--###----------------------tt-########-------F
###M---------------g----------#--------tt------tt-----gg---tt------------------------------gggg--------kk-----------------g--g-g-------####--####----####--####-------------g-------tt#########-------#
XXXXXXXXXXXXXXXXXXXXXXXXXXXXXXXXXXXXXXXXXXXXXXXXXXXXXXXXXXXXXXXXXXXXX---XXXXXXXXXXXXXXX---XXXXXXXXXXXXXXXXXXXXXXXXXXXXXX---XXXXXXXXXXXXXXXXXXXXXXXXXXXXXX--XXXXXXXXXXXX---XXXXXXXXXXXXXXXXXXXXXXXXXXXXX
XXXXXXXXXXXXXXXXXXXXXXXXXXXXXXXXXXXXXXXXXXXXXXXXXXXXXXXXXXXXXXXXXXXXX---XXXXXXXXXXXXXXX---XXXXXXXXXXXXXXXXXXXXXXXXXXXXXX---XXXXXXXXXXXXXXXXXXXXXXXXXXXXXX--XXXXXXXXXXXX---XXXXXXXXXXXXXXXXXXXXXXXXXXXXX
