-------------------------------------------------------------------------------------------------------------------------------------------------------------------------------------------------------
-------------------------------------------------------------------------------------------------------------------------------------------------------------------------------------------------------
-------------------------------------------------------------------------------------------------------------------------------------------------------------------------------------------------------
-------------------------------------------------------------------------------------------------------------------------------------------------------------------------------------------------------
-------------------------------------------------------------------------------------------------------------------------------------------------------------------------------------------------------
-------------------------------------------------------------------------------------------------------------------------------------------------------------------------------------------------------
---SSSSSSSS---SSS!-----------------------------------------------SSSSSSSS---SSS!-----SS-----SSS!--------@-----------SSS----S!!S--S!!S---------------------------SSS-SSS!---------------------##--------
--------------------------------------------------------------------------------------------------------------------------------------------------------------------------------------------###--------
-------------------------------------------------------------------------------------------------------------------------------------------------------------------------------------------####--------
-------------------------------------------------------------------------------g----------------------------------------------------------------------------------------------------------#####--------
S@S--------------C-----SU----------------------tt---------tt---@S--------------C---------------C-----!--!--!-----S----------SS----SS--------#----------##--#-----------C----S------------######--------
---------------------------------------tt------tt---------tt-----------------------------------------------------------------------------#--##--------###--##---------------------------#######--------
-----------------------------tt--------tt------tt---------tt----------------------------------------------------------------------------##--###------####--###----------------------tt-########-------F
---M-------------------------tt--------tt------tt------g--tt---------------------------------gg--------------------------g---g---------###--####----#####--####-------------g-------tt#########-------#
XXXXXXXXX---XXXXXXXXXXXXXXXXXXXXXXXXXXXXXXXXXXXXXXXXXXXXXXXXXXXXXXXXXXX---XXXXXXXXXXXXX---XXXXXXXXXXXXXXXXXXXXXXXXXXXXXXXXXXXXXXXXXXXXXXXXXXXXXXXXXXXXXXX--XXXXXXXXXXXXXXXXXXXXXXXXXXXXXXXXXXXXXXXXXXXX
XXXXXXXXX---XXXXXXXXXXXXXXXXXXXXXXXXXXXXXXXXXXXXXXXXXXXXXXXXXXXXXXXXXXX---XXXXXXXXXXXXX---XXXXXXXXXXXXXXXXXXXXXXXXXXXXXXXXXXXXXXXXXXXXXXXXXXXXXXXXXXXXXXX--XXXXXXXXXXXXXXXXXXXXXXXXXXXXXXXXXXXXXXXXXXXX
