-------------------------------------------------------------------------------------------------------------------------------------------------------------------------------------------------------
-------------------------------------------------------------------------------------------------------------------------------------------------------------------------------------------------------
-------------------------------------------------------------------------------------------------------------------------------------------------------------------------------------------------------
-------------------------------------------------------------------------------------------------------------------------------------------------------------------------------------------------------
-------------------------------------------------------------------------------------------------------------------------------------------------------------------------------------------------------
-------------------------------------------------------------------------------------------------------------------------------------------------------------------------------------------------------
--##-----------SSSSSSSS---SSS!------SSS!-------------------------------SSSSSS---SSSSSSSS---SSSSSSSSSS---SSS!--@-----------SSS----S!!S--------------------------------------------------------##--------
-###----------------------------------------------------------------------------------------------------------------------------------------------------------------------------------------###--------
####---------------------------------------------------------------------------------------------------------------------------------------------------------------------------------------####--------
####-------------------------------------------------------------1------------------------------------------------------------------------------------------------------------------------#####--------
####--------S@S--------------C---------C-------tt---------tt-----------------S@S---------------------------C--!--!-----S----------SS-----#--#----------##--#-------------SS!S------------######--------
####-------------------------------------------tt---------tt----------------------------------------------------------------------------##--##--------###--##---------------------------#######--------
####------------------------------------t------tt---------tt---------------------------------------------------------------------------###--###------####--###------tt--------------tt-########--#----F
###M----------------g-------------------t------tt------g--tt----------------------------------g--------------------------g----g--------###--####----#####--####-----tt--------------tt#########--##---#
XXXXXXXXXXXXXXXXXXXXX---XXXXXXXXXXXXXXXXXXXXXXXXXXXXXXXXXXXXXXXXXXXXXX-XXXXXXXXXXXXXXX---XXXXXXXXXX---XXXXXXXXXXXXXXXXXXXXXXXXXXXXXXXXXXXXXXXXXXXXXXXXXXX--XXXXXXXXXXXXXXXXXXXXXXXXXXXXXXXXXXXXXXXXXXXX
XXXXXXXXXXXXXXXXXXXXX---XXXXXXXXXXXXXXXXXXXXXXXXXXXXXXXXXXXXXXXXXXXXXX-XXXXXXXXXXXXXXX---XXXXXXXXXX---XXXXXXXXXXXXXXXXXXXXXXXXXXXXXXXXXXXXXXXXXXXXXXXXXXX--XXXXXXXXXXXXXXXXXXXXXXXXXXXXXXXXXXXXXXXXXXXX
