-------------------------------------------------------------------------------------------------------------------------------------------------------------------------------------------------------
-------------------------------------------------------------------------------------------------------------------------------------------------------------------------------------------------------
-------------------------------------------------------------------------------------------------------------------------------------------------------------------------------------------------------
-------------------------------------------------------------------------------------------------------------------------------------------------------------------------------------------------------
-------------------------------------------------------------------------------------------------------------------------------------------------------------------------------------------------------
-------------------------------------------------------------------------------------------------------------------------------------------------------------------------------------------------------
---SSSSSSSS---SSS!---------SSSSSS------------------------------------------------SSSSSSSS--SSSSSSSSSSSSSSSS---SSS!--------------@S!!S--------------------------------------------------------##--------
--------------------------------------------------------------------------------------------------------------------------------------------------------------------------------------------###--------
-------------------------------------------------------------------------------------------------------------------------------------------------------------------------------------------####--------
-----------------------------------------------------------------1------------------------------------------------------------------------------------------------------------------------#####--------
S@S--------------C-----SU----------------------tt---------tt------------------S@S--------------------------------C-----SU----!--!-SS------#--#---------##--#------------SS!SS------------######--------
---------------------------------------tt------tt---------tt-----------------------------------------------------------------------------##--##-------###--##---------------------------#######--------
---------------------------------------tt------tt---------tt----------------------------------------------------------------------------###--###-----####--###-----tt---------------tt-########-------F
---M-----------------------------------tt------tt---------tt---------------------------------------------------------------------------####--###----#####--####----tt---------------tt#########-------#
XXXXXXXXX---XXXXXXXXXXXXXXXXXXXXXXXXXXXXXXXXXXXXXXXXXXXXXXXXXXXXXXXXXX--XXXXXXXXXXXXXXX---XXXXXXX--XXXXXX---XXXXXXXXXXXXXXXXXXXXXXXXXXXXXXXXXXXXXXXXXXXXX--XXXXXXXXXXXXXXXXXXXXXXXXXXXXXXXXXXXXXXXXXXXX
XXXXXXXXX---XXXXXXXXXXXXXXXXXXXXXXXXXXXXXXXXXXXXXXXXXXXXXXXXXXXXXXXXXX--XXXXXXXXXXXXXXX---XXXXXXX--XXXXXX---XXXXXXXXXXXXXXXXXXXXXXXXXXXXXXXXXXXXXXXXXXXXX--XXXXXXXXXXXXXXXXXXXXXXXXXXXXXXXXXXXXXXXXXXXX
