--######----######---######-----######-##--####---------######----######--------######-#----######-----######---------######------######---#######-######-----######----########----####-------SSSSSSS-
-#######---#######--#######----#######-##-#####---------######---#######-------#######-#---#######----#######--------#######-----#######--###############----#######---#########---#####---------------
########t-########-########tt-########-########---------######t-########---tt-########-#t-########tt-########----tt-########-tt-########-################tt-########t-##########--######---------------
########t##################tt#########-########---------######t#########---tt#########-#t#########tt#########----tt#########-tt#########-################tt#########t###########-#######---------------
XXXXXXXXXXXXXXXXXXXXXXXXXXXXXXXXXXXXXXXXX######---------XXXXXXXXXXXXXXXXXXXXXXXXXXXXXXX#XXXXXXXXXXXXXXXXXXXXXXXXXXXXXXXXXXXXXXXXXXXXXXXXXXXXXXXXX#XXXXXXXXXXXXXXXXXXXXXXXXXXXXXX########---------------
XXXXXXXXXXXXXXXXXXXXXXXXXXXXXXXXXXXXXXXXX######---------XXXXXXXXXXXXXXXXXXXXXXXXXXXXXXX#XXXXXXXXXXXXXXXXXXXXXXXXXXXXXXXXXXXXXXXXXXXXXXXXXXXXXXXXXXXXXXXXXXXXXXXXXXXXXXXXXXXXXXXX########---------------
--##--------SSSSSSSS---SSS!SSS----------------------------------------S---S-----SSSSSSSS--SSS----S!!S-SSS----S!!S-------SSSSSSSSS----SS-----------------------------SSS!---SSSSSSSS-----------##-------
-###-------------------------------------------------------------------------------------S---------------------------------------------------------------------------------------------------###-------
####---------------------------------------------------------------------------------------------------------------------------------------------------------------------------------------#####-------
####--------------------------------------------------------------------------------------------------------------------------------------------------------------------------------------######-------
####----------------------C--------------------t-----------tt----------------S@S------------------SS----------SS-----S@S------------------#--#-------------#-----------C-----------------#######-------
####-----------------------------------tt------t----------ttt----------------------------------------------------------------------------##--##--------##--##---------------------------########-------
####--------------------------t--------tt------ttt--------ttt--------------------------------------------------------------------------tt##--###------###--###----------------------tt-#########------F
###M--------------------------t--------tt------ttt--------ttt--------------------------------------------------------------------------tt##--####----####--####---------------------tt##########------#
XXXXXXXXXXXXXXXXXX---XXXXXXXXXXXXXXXXXXXXXXXXXXXXXXXXXXXXXXXXXXXXXXXXX--XXXXXXXXXXXXXX----XXXXXXXXXXXXXXXXXXXXXXXXXXXXXXXXXXXXXXXXXXXXXXXXXXXXXXXXXXXXX##--XXXXXXXXXXXXXXXXXXXXXXX-XXXXXXXXXXXXXXXXXXXX
XXXXXXXXXXXXXXXXXX---XXXXXXXXXXXXXXXXXXXXXXXXXXXXXXXXXXXXXXXXXXXXXXXXX--XXXXXXXXXXXXXX----XXXXXXXXXXXXXXXXXXXXXXXXXXXXXXXXXXXXXXXXXXXXXXXXXXXXXXXXXXXXXXX--XXXXXXXXXXXXXXXXXXXXXXX-XXXXXXXXXXXXXXXXXXXX
