-------------------------------------------------------------------###-##-#############--#####tt-########---tt-############--tt-########-########-###########---tt-########tt###tt-########-!---S@S!S--
-------------------------------------------------------------------###-################--#####tt#########---tt#############--tt#########-####################---tt#########tt###tt#########------------
-------------------------------------------------------------------XXX-XXXXXXXXXXXXXXXX--XXXXXXXXXXXXXXXXXXXXXXXXXXXXXX####XXXXXXXXXXXXXXXXXXXXXXXXXXXXXXXXXXXXXXXXXXXXXXXXXX###XXXXXXXXXXXX-----------
-------------------------------------------------------------------XXX-XXXXXXXXXXXXXXXX--XXXXXXXXXXXXXXXXXXXXXXXXXXXXXX####XXXXXXXXXXXXXXXXXXXXXXXXXXXXXXXXXXXXXXXXXXXXXXXXXX###XXXXXXXXXXXX-----------
--##-------------------------------------SS------------------------------------------------------------------------------------------------------------------------------------------------------------
-###---------------------------------------------------------------------------------------------------------------------------------------------------------------------------------------------------
####-SSSSSSSSSSSSSS---SSSSSSSSSSS---SSS!--------------------------SSSS----SSSSSSSSSSSSS----SSSSSSSSSSS----S!!S--SSSSSSSSSSSS-SSSSSSS--------------SSS-----------SSS-SSS----S!!S-SSS----------#---------
####----------------------------------------------------------------------------------------------------------------------------------------------------------------------------------------##---------
####----------------------------------------------------------------------------------------------------------------------------------------#----------------------------------------------###---------
####---------------------------------------------------------------------------------------------------------------------------------------##---------------------------------------------####---------
####-----------------------------------C------------------tt---S-------------------------------------------SS---------------S-------------###----------##--#----------------SS-----------######--------
####-------------------------------------------tt---------tt-----------------------------------------------------------------------------#####--------###--##---------------------------########-------
XXXXX------------------------------------------tt---------ttXX--------------------------------------------------------------------------#######------####--###----------------------tt-##########-----F
XXXMX--------------g---------------------------tt-----gg--ttXX-----------------------------gggg--------kk-----------------g--g-g-------#########-----####--####-------------g-------tt############----#
XXXXXXXXXXXXXXXXXXXXtttXXXXXXXXXXXXXXXXXXXXXXXXXXXXXXXXXXXXXXXXXXXXXX---XXXXXXXXXXXXXX---XXXXXXXXXXXXXXXXXXXXXXXXXXXXXXXXXXXXXXXXXX-t-#######XXXXXXXXXXXX--XXXXXXXXXXXXXXXXXXXXXXXXXXXXXXXXXXXXXXXXXXXX
XXXXXXXXXXXXXXXXXXXXtttXXXXXXXXXXXXXXXXXXXXXXXXXXXXXXXXXXXXXXXXXXXXXX---XXXXXXXXXXXXXX---XXXXXXXXXXXXXXXXXXXXXXXXXXXXXXXXXXXXXXXXXX-t########XXXXXXXXXXXX--XXXXXXXXXXXXXXXXXXXXXXXXXXXXXXXXXXXXXXXXXXXX
