----------------------------------------------------------------------###-----###----###--------###-----------###--------------###------------------###-----------------###-------###------------------
---------------------------------------------------------------------####----####---####-------####----------####-------------####----##-----------####----------------####------####------------------
--------------------------------------------------------------------#####---#####--#####------#####---------#####------------#####---###----------#####-SSSSSS--------#####-----#####--SSSS------------
--------------##-----------------------SSSS------------------SSS---######--######-######-----######--------######-----------######--####---------######--------------######----######------------------
--------------##--------------------------------------------------#######-##############----#######-------#######----------#######-#####--------#######-------------#######---#######------------------
--##----------##---SSSSSSSS---SSS---SSS--------------------------#######################tt-########---tt-########------tt-##############-------########---------tt-########t-########------------------
-###----------##-------------------------------------------------#######################tt#########---tt#########------tt###############-------########S--------tt#########t#########--------##--------
####----------##-------------------------------------------------XXXXXXXXXXXXXXXXXXXXXXXXXXXXXXXXXXXXXXXXXXXXXXXXXXXXXXXXXXXXXXXXX######-------XXXXXXXX-------XXXXXXXXXXXXXXXXXXXXXXXXX-----###--------
####----------##-------------------------------------------------XXXXXXXXXXXXXXXXXXXXXXXXXXXXXXXXXXXXXXXXXXXXXXXXXXXXXXXXXXXXXXXXX######-------XXXXXXXX-------XXXXXXXXXXXXXXXXXXXXXXXXX----####--------
####----------##S@S-----------------------------------------------------------------------11-----------------1---1--------------------------#---------------------------------------------#######------
####----------##-------------------------------------------##----------------S@S---------------------------!-----------S-------------------##----------##--#-----------S-----------------########------
####----------XX-----------------------XX------tt---------###X----------------------------------------------------------------------------####--------###--##---------------------------#########------
####----------XX-----------------------XX------tt--------####X------------------------------------------------------------------------tt-######------####--###----------------------tt-##########-----F
###M----------------g--------tt--------tt-------tt-----g--####--#-----------------------------g--------------------------g----g-------tt########----#####--####---------------------tt###########-----#
XXXXXXXXXXXXXXXXXXXXXXXXXXXXXXXXXXXXXXXXXXXXXXXXXXXXXXXXXXXXXXXXXXXXX---XXXXXXXXXXXXXX---XXXXXXXXXXXXXXXXXXXXXXXXXXXXXXXXXXXXXXXXXXXXXXXXXXXXXXXXXXXXXXXX--XXXXXXXXXXXXXXXXXXXXXXXXXXXXXXXXXXXXXXXXXXXX
XXXXXXXXXXXXXXXXXXXXXXXXXXXXXXXXXXXXXXXXXXXXXXXXXXXXXXXXXXXXXXXXXXXXX---XXXXXXXXXXXXXX---XXXXXXXXXXXXXXXXXXXXXXXXXXXXXXXXXXXXXXXXXXXXXXXXXXXXXXXXXXXXXXXX--XXXXXXXXXXXXXXXXXXXXXXXXXXXXXXXXXXXXXXXXXXXX
