---------------------------------------------------------XXXXXXXXXXXXXXXXXXXXXXXXXXXXXX--XXXXXXXXXXXXXXXXXXXXXXXXXXXXXXXXXXXXXXXXXXXXXXXXXXXXXXXXXXXXXXXXXXXXXXXXXX-tt#########---tt#########--SSSSSSS-
-------------------------------------------------------------------------------------------------------------------------------------------------------------------XXXXXXXXXXXXXXXXXXXXXXXXXXX---------
----##-----------------##------------------------------------------------------------------------------------------------------------------------------------------XXXXXXXXXXXXXXXXXXXXXXXXXXX---------
---###----------------###------------------------------------------------------------------------------------------------------------------------------------------------------------------------------
--####SSSSS---SSS!---####--------SSSSSSSSS---SSS------SSS----------------------------------------------------------------------------------------------------------------------------------------------
-#####--------------#####-SSSSSSS----------------------------------------------------------------------------------------------------------------------------------------------------------------------
######-------------######-------------------------------------------SSS-SSSSSSSSSSSSSSS-----SSS!----SS----S!!S------SSS----S!!SSSSSS--------------SSSS------------------SSSSSS---------------#---------
######------------#######-------------------------------------------------------------------------------------------------------------------------------------------------------------------##---------
######-----------C#######--------------------------S---------------------------------------------------------------------------------------------------------------------------------------###---------
######------------#######------------------------------------------------------g----------------------------------------------------------------------------------------------------------####---------
XXXXXX------------XXXXXXXX--------------------------------tt-----------------------------------C-----------SS----S----------SS-----------#--#----------##--#---------S@S-----------------######--------
XXXXXX------------XXXXXXXX--------------------------------tt----------------------------------------------------------------------------##--##--------###--##---------------------------########-------
###--------------------------tt--------tt-------tt--------tt---------------------------------------------------------------------------###--###-------###--###----------------------tt-##########-----F
###M-------------------------tt--------tt-------tt-----g--tt---------------------------------gg--------------------------g---g--------####--####------###--####-------------g-------tt############----#
XXXXXXXXXXXXXXXXXXXXXXXXXXXXXXXXXXXXXXXXXXXXXXXXXXXXXXXXXXXXXXXXXXXXX---XXXXXXX-XXXXXX----XXXXXXXXXXXXXXXXXXXXXXXXXXXXXXXXXXXXXXXXXXXXXXXXXXXXXXXXXXXXXXX--XXXXXXXXXXXXXXXXXXXXXXXXXXXXXXXXXXXXXXXXXXXX
XXXXXXXXXXXXXXXXXXXXXXXXXXXXXXXXXXXXXXXXXXXXXXXXXXXXXXXXXXXXXXXXXXXXX---XXXXXXX-XXXXXX----XXXXXXXXXXXXXXXXXXXXXXXXXXXXXXXXXXXXXXXXXXXXXXXXXXXXXXXXXXXXXXX--XXXXXXXXXXXXXXXXXXXXXXXXXXXXXXXXXXXXXXXXXXXX
