wwwwwwwwwwwww
w...gw.ww.w.w
w..www.ww.w.w
w.......w.w.w
w...2..wwwwww
w....3.ww+.ww
w...w..ww...w
wA..w.......w
wwwwwwwwwww.w
