wwwwwwwwwwwww
w...gw...w.ww
w..www...w.ww
w........w.ww
w.3.2.wwwwwww
w.....2w.+.ww
w...w.2w...ww
wA..w......ww
wwwwwwwwwwwww
