wwwwwwwwwwwww
w..wg..ww...w
w..www.www..w
w........w..w
w...2..wwwwww
w.....2..+..w
w...w.2w....w
wA..w.......w
wwwwwwwwwwwww
