wwwwwwwwwwwww
w...gw..w.w.w
w..www..w.w.w
w.......w.w.w
w......wwwwww
ww....www+..w
w..ww.....www
wA..w......ww
wwwwwwwwwwwww
