wwwwwwwwwwwww
w...gw....w..
w..www..www..
w............
w.3.2...wwwww
w.....2.w+..w
w...w.2.w...w
wA..w.......w
wwwwwwwwwwwww
