wwwww...www.w
w...gwwww.www
w..ww...w.w.w
w.......w.w.w
w.......www.w
w....wwww+www
ww..w...w...w
wA..w.......w
w.wwwwwwwwwww
