wwwwwwwwwwwww
w...gw.....w.
w..www...www.
w...........w
w..w2..wwwwww
w....3.ww+..w
w......ww...w
wA..........w
wwwwwwwwwwwww
