wwwwwwwwwwwww
w...gw...w.ww
w..www...w.ww
w........w.ww
w...2wwwwwwww
w.....2.w+.ww
w...w.2.w...w
wA..w.......w
wwwwwwwwwww.w
