wwwwwwww.wwww
w...gw..w22ww
w..www....2.w
w...........w
w.3...w.wwwww
ww3...w2w+w..
w...w...w..w.
wA..w......w.
wwwwwwwwwwwww
