wwwwwwwwwwwww
w...g.ww..2.w
w..www....2.w
w...........w
w.3...w2wwwww
ww....w.w+www
w...w...w..ww
wA..w......ww
wwwwwwwwwwwww
