wwwwwwwwww..w
w...gw..wwwww
w..ww.......w
w...........w
w.....w.wwwww
ww....w.w+www
w.......w..ww
wA..w......ww
wwwwwwwwwwwww
