wwwwwwww..w.w
w...gwwwww2ww
w..www...2..w
w...........w
w.....w.wwww.
ww....w.w+.ww
ww..w...w...w
wA..w......ww
wwwwwwwwwwwww
