wwwwwwwwww.ww
w...g.w..wwww
w...ww......w
w...........w
w.......wwwww
ww......w+..w
ww..w...w...w
wA..w......ww
wwwwwwwwwww.w
