wwwwwww..wwww
w...gwwwww2.w
w..www...2..w
w...........w
w.......wwwww
w........+.ww
w...w......ww
wA..w......ww
wwwwwwwwwwwww
