wwwwwwwwww...
w...gw.ww22ww
w..www....2.w
w...........w
w.3......wwww
w.3....2w+..w
w...w...w...w
wA..w......w.
wwwwwwwwwwwww
