wwwwwwwwwwwww
w...gw....2.w
w..www...2..w
w..........ww
w.......wwwww
w.......w+.ww
w...w...w..ww
wA..w......ww
wwwwwwwwwwwww
