wwwwwwwwwwwww
w...g..w.w2..
w..www....2.w
w...........w
w.3....2wwwww
w.......w+..w
w...w...w...w
wA..w.......w
wwwwwwwwwwwww
