wwwwwwwww...w
w...gw...22ww
w..www....2.w
w...........w
w.3.....wwwww
w.3....2w+..w
w...w...w...w
wA..w.......w
wwwwwwwwwwwww
