wwwwwwwwwwwww
w...gwwwww..w
w..www......w
w....w......w
w.........www
w.......w+..w
w...w...w...w
wA..w.......w
wwwwwwwwwwwww
