wwwwwwwwwwwww
w...gw....2.w
w..www....2.w
w...........w
w.3....2wwwww
w.......w+..w
w...w...w...w
wA..w.......w
wwwwwwwwwwwww
