wwwwwwwwwwwww
w...gw.2.22ww
w..www....2.w
w...........w
w.3.....wwwww
w.3.....w+.ww
w2..w2..w..ww
wA..w......ww
wwwwwwwwwwwww
