wwwwwwwwwwwww
w...gw...w2ww
w..www......w
w...........w
w.3.....wwwww
w....2..w+.ww
ww..w...w..ww
wA..w......ww
wwwwwwwwwwwww
