wwwwwwwwwwwww
w...gw...wwww
w..www......w
w...........w
w.......wwwww
w.......w+.ww
ww..w...w..ww
wA..w......ww
wwwwwwwwwwwww
