wwwwwwwwwwwww
w...gw....w.w
w..www......w
w...........w
w.......wwwww
w.......w+.ww
ww..w...w..ww
wA..w.......w
wwwwwwwwwwwww
