wwwwwwwwwwwww
w...gw....2.w
w..www......w
w...........w
w.3.....wwwww
w....2..w+.ww
w...w...w..w.
wA..w......w.
wwwwwwwwwwwww
