wwwwwwwwwwwww
w...gw....w.w
w..www......w
w...........w
w.......wwwww
w.......w+..w
www.w...w...w
wA..w.......w
wwwwwwwwwwwww
