wwwwwwwww...w
w...gw...w2ww
w..www......w
w...........w
w.3.....wwwww
w....2..w+..w
w...w...w...w
wA..w.......w
wwwwwwwwwwwww
