wwwwwwwwwwwww
w...gw...wwww
w..www...w..w
w...........w
w.......wwwww
w.......w+..w
w...w...w...w
wA..w.......w
wwwwwwwwwwwww
