wwwwwwwwwwwww
w...gw...222w
w..www....2.w
w......2.22.w
w.3.....wwwww
w.3...2.w+..w
w2..w......ww
wA..w......ww
wwwwwwwwwwwww
