wwwwwwwwwwwww
w...gw.2.22.w
w..www....2.w
w...........w
w.3.....wwwww
w.3.....w+..w
w2..w2..w...w
wA..w.......w
wwwwwwwwwwwww
