wwwwwwwwwwwww
ww.ww.w.w..Aw
ww...w......w
w.w.....wwwww
w+w2........w
w.w..wwwwwwww
w...2...w.www
w....w.....gw
wwwwwwwwwwwww
