wwwwwwwwwwwww
w.ww.ww....Aw
w.w..w......w
w.w.....wwwww
w+w2........w
w.w..wwwwwwww
w...2...w...w
w....w....wgw
wwwwwwwwwwwww
