wwwwwwwwwwwww
w...www....Aw
w.w..w.....ww
w.w.....www.w
w+w2.......ww
w.w..wwwwwwww
w...2......ww
w....w..wwwgw
wwwwwwwwwwwww
