wwwwwwwwwww.w
w....ww....Aw
w....w.....ww
w.w.....www.w
w+w2.......ww
w.w..wwwwwwww
w...2...wwwww
w....w..w.wgw
wwwwwwwwwwwww
