wwwwwwwwwwwww
w..ww.w....Aw
w.w..w.....ww
w.w.....wwwww
w+w2.......ww
w.w..wwwwwwww
w...2...w..ww
w....w..w.wgw
wwwwwwwwwwwww
