wwwwwwwwwwwww
w...gw...w..w
w..www...w..w
w........w..w
w...2...wwwww
w....3..w+www
w...w...w...w
wA..w.......w
wwwwwwwwww..w
