wwwwwwwwwwwww
w...gww.....w
w..www..w.www
w.......w....
w...2.wwwwwww
w....3..w+w..
w...w...w..w.
wA..w......w.
wwwwwwwwwwwww
