wwwwwww.wwwww
w...gw.ww..ww
w..www..wwwww
w.......w...w
wwww2..wwwwww
ww...3.ww+..w
ww.....ww...w
wA..........w
wwwwwwwwwwwww
