wwwwwwwwwwwww
w..wgwwwwww.w
w..www....www
w.........www
w...2..wwww.w
w....3.w.+www
w...w..w..www
wA..w.....www
wwwwwwwwwwww.
