wwwwww.wwwwww
w...gwwww...w
w..www..w...w
w......w....w
w...2..wwwwww
w....3www+..w
w...w..ww...w
wA..w.......w
wwwwwwwwwwwww
