wwwwwwwwwwwww
w...gw...w..w
w..www...w..w
w........w..w
w...2..wwwwww
w....3..w+..w
wwwww...w...w
wA..w.......w
wwwwwwwwwwwww
