wwwwwwwwwwwww
w..wgw......w
w...ww......w
w.......w...w
w...2...wwwww
w...w3www+www
w..ww...w...w
wA..w.......w
wwwwwwwwwwwww
