wwwwwwwww...w
w...gw..w...w
w..www......w
w.......wwwww
w...2..wwwwww
w....3.w.+..w
w...w..w....w
wA..w.......w
wwwwwwwwwwwww
