wwwwwwwwwwwww
w...gw..w...w
w..www..w...w
w.......w...w
w...2..wwwwww
w....3.ww+..w
w..w...ww...w
wA.w........w
wwwwwwwwwwwww
