wwwwwwwwwwwww
w..wgwwwwww.w
w..w....w.www
w.......w.www
w...2...w.w.w
w....3w.w+w.w
w...w...w.w.w
wA..w......ww
wwwwwwwwwwwww
