wwwwwwwwwwwww
w..wgw....w.w
w..www..wwwww
w.........www
w...2.wwwwwww
w....3w..+w.w
w...w.w...w.w
wA..w.......w
wwwwwwwwwwwww
