wwwwwwwwwwwww
w...gw......w
w..www....www
w.......wwwww
w...2..wwwwww
w....3.ww+..w
w..ww..ww...w
wA..........w
wwwwwwwwwwwww
