wwwwwwwwwwwww
w..wgw.....ww
w..w.w.....ww
w..........ww
w..w2wwwwwwww
ww...3.ww+..w
w..w...ww...w
wA.w........w
wwwwwwwwwwwww
