wwwwwwwwwwwww
w...gw....w.w
w..www..wwwww
w.......w...w
w...2...wwwww
w....3..w+..w
w...w..ww...w
wA..w...w...w
wwwwwwwwwwwww
