wwwwwwwwwwwww
w...gw.ww....
w..www..w..ww
w.......w....
w...2..wwwwww
w....3.w.+..w
w...w..w....w
wA..w.......w
wwwwwwwwwwwww
