wwwwwwwwwwwww
w...gw..w..w.
w..www..wwww.
w...........w
w...2..www..w
ww...3.w.+www
w...w..w....w
wA..w.......w
wwwwwwwwwwwww
