wwwwwwwwwwwww
w...g...w...w
w..w....w...w
w.......w...w
wwww2wwwwwwww
w....3.w.+.ww
w...w..w...ww
wA..w......ww
wwwwwwwwwwwww
