wwwwwwwwwwwww
w...gw..w...w
w..www..w...w
w...........w
w...2.wwwwwww
ww...3www+www
w...w..ww...w
wA..w.......w
wwwwwwwwwwwww
