wwwwwwwwwwwww
w...gw......w
w..www..ww..w
w...........w
w.ww2.wwwwwww
w....3w..+www
ww.....wwwwww
wA..w.......w
wwwwwwwwwwwww
