wwwwwwwwwwwww
w..wgwww....w
w..w.w..wwwww
w....w..w...w
w.ww2...w...w
ww...3.w.+..w
w...w..w....w
wA..w.......w
wwwwwwwwwwwww
