wwwwwwwwwwwww
w...gw..ww...
w..www..ww..w
w.......ww...
w...2..wwwwww
ww...3..w+..w
w...w..ww.www
wA..w........
wwwwwwwwwwwww
