wwwwwwwwwwwww
w...g..ww.w..
w..ww.....www
w.........w.w
w...2.wwwwwww
w....3w..+w.w
w...w..w....w
wA..w.......w
wwwwwwwwwwwww
