wwwwwwwwwwwww
w...gw.....ww
w..www...wwww
w...........w
w...2.wwwwwww
w....3ww.+.ww
w...w..w...ww
wA..w......ww
wwwwwwwwwwwww
