wwwwww.wwwwww
w...gwwww...w
w..www..w...w
w...........w
w...2..wwwwww
w....3.w.+..w
w...w..w....w
wA..w.......w
wwwwwwwwwwwww
