wwwwwwwwwwwww
...wgw....w.w
w..www....w.w
w.........w.w
w...2..wwwwww
w....3.w.+www
w...w..w....w
wA..w.......w
wwwwwwwwww..w
