wwwwww.wwwwww
w...gwwww...w
w..www..w...w
w...........w
w...2..wwwwww
w....3.ww+www
ww..w..ww...w
wA..w.......w
wwwwwwwwwwwww
