wwwwwwwwwwwww
w...gw.....ww
w..www...wwww
w...........w
w...2..wwwwww
w....3.w.+.ww
w...w..w...ww
wA..w......ww
wwwwwwwwwwwww
