wwwwwwwwwwwww
w...gwww...ww
w..www....www
w.........w.w
w...2.wwwww.w
w....3w..+w.w
w...w.....www
wA..w......ww
wwwwwwwwwwwww
