wwwwwwwwwwwww
w...gw...w..w
w..www...w..w
w........w..w
w...2wwwwwwww
w....3.w.+w.w
w......w..w.w
wA.........ww
wwwwwwwwwww.w
