wwwwwwwwwwwww
w...gw.wwwwww
w...ww.....ww
w..........ww
wwww2.w....ww
ww...3www+www
w...w..w..www
wA..w......ww
wwwwwwwwwwwww
